border_size=1
usage=map

Xu, Xu, Xu, Xu, Xu, Xu, Xu, Xu, Uu, Uu, Uu, Uu, Ur, Uu, Uu^Uf, Uh, Uh, Xu, Xu, Xu, Xu, Xu, Xu, Xu, Xu, Xu, Xu, Xu, Xu, Xu, Xu, Xu, Xu, Xu, Xu, Xu
Xu, Xu, Xu, Xu, Xu, Xu, Xu, Xu, Uu^Vu, Uu, Uu, Uu, Ur, Uu, Uu^Uf, Uh, Uh, Xu, Xu, Xu, Xu, Xu, Xu, Xu, Xu, Xu, Xu, Xu, Xu, Xu, Xu, Xu, Xu, Xu, Xu, Xu
Xu, Xu, Xu, Xu, Xu, Xu, Xu, Xu, Uu^Uf, Uu^Uf, Uu^Uf, Uu, Cud, Uu, Uu^Uf, Uh, Uu^Uf, Xu, Xu, Xu, Xu, Xu, Xu, Xu, Xu, Xu, Xu, Xu, Xu, Xu, Xu, Xu, Xu, Xu, Xu, Xu
Xu, Xu, Xu, Xu, Xu, Xu, Xu, Xu, Uu^Uf, Uh, Uu^Uf, Cud, 2 Kud, Cud, Uu, Uu^Uf, Uu^Vu, Xu, Xu, Xu, Xu, Xu, Xu, Xu, Xu, Xu, Xu, Xu, Xu, Xu, Xu, Xu, Xu, Xu, Xu, Xu
Xu, Xu, Xu, Xu, Xu, Xu, Xu, Xu, Uh, Uu^Uf, Uu, Cud, Cud, Cud, Ur, Uu, Uu, Xu, Xu, Xu, Xu, Xu, Xu, Xu, Xu, Xu, Xu, Xu, Xu, Xu, Xu, Xu, Xu, Xu, Xu, Xu
Xu, Xu, Xu, Xu, Xu, Xu, Xu, Uh, Uu, Uu, Ur, Ur, Uu^Uf, Uu, Uu, Ur, Uu^Vu, Xu, Xu, Xu, Xu, Xu, Xu, Xu, Xu, Xu, Xu, Xu, Xu, Xu, Xu, Xu, Xu, Xu, Xu, Xu
Xu, Xu, Xu, Xu, Xu, Xu, Uu^Uf, Uu, Ur, Ur, Uu^Vu, Uu^Uf, Uh, Uu^Uf, Uu, Ur, Ur, Ur, Ur, Uh, Uh, Xu, Xu, Xu, Xu, Xu, Xu, Xu, Xu, Xu, Xu, Xu, Xu, Xu, Xu, Xu
Xu, Xu, Xu, Xu, Xu, Uu^Uf, Ur, Ur, Uu^Uf, Ur, Ur, Uu^Uf, Xu, Xu, Xu, Uu, Uu, Uu, Uu^Uf, Ur, Ur, Xu, Xu, Xu, Xu, Xu, Xu, Xu, Xu, Xu, Xu, Xu, Xu, Xu, Xu, Xu
Xu, Xu, Xu, Xu, Ur, Ur, Xu, Uh, Xu, Xu, Ur, Uu, Xu, Xu, Xu, Xu, Uu, Uu^Uf, Uh, Xu, Xu, Ur, Xu, Xu, Xu, Xu, Xu, Xu, Xu, Xu, Xu, Xu, Xu, Xu, Xu, Xu
Xu, Xu, Uh, Uu^Vu, Ur, Uh, Xu, Xu, Xu, Xu, Ur, Uu, Xu, Xu, Xu, Xu, Uu, Uu^Uf, Xu, Xu, Xu, Ur, Ur, Xu, Xu, Xu, Xu, Xu, Xu, Xu, Xu, Xu, Xu, Xu, Xu, Xu
Xu, Xu, Uh, Uu, Ur, Xu, Xu, Xu, Uh, Uh, Ur, Uu, Uh, Xu, Xu, Xu, Uu, Uu, Uu^Vu, Xu, Wwg, Xu, Xu, Ur, Ur, Xu, Xu, Xu, Xu, Xu, Xu, Xu, Xu, Xu, Xu, Xu
Xu, Uh, Uu^Uf, Uu, Ur, Uu^Uf, Qxu, Qxu, Qxu, Uu^Uf, Uu, Ur, Uu^Uf, Xu, Xu, Xu, Xu, Uu, Uu, Xu, Xu, Wwg, Xu, Xu, Uu, Ur, Uu, Xu, Uh, Xu, Xu, Xu, Xu, Xu, Xu, Xu
Xu, Xu, Qxu, Uu^Uf, Qxu, Qxu^Bs\, Qxu^Bs\, Qxu, Qxu, Qxu, Qxu, Ur, Cud, Uh, Xu, Xu, Xu, Uu, Uu, Uu, Xu, Wwg, Uh, Uh, Uu, Ur, Ur, Uu^Uf, Uu^Uf, Uu^Uf, Uu^Uf, Xu, Xu, Xu, Xu, Xu
Xu, Qxu, Xu, Qxu, Qxu, Qxu, Xu, Qxu^Bs\, Qxu^Bs\, Xu, Qxu^Bs/, Ur, Cud, Cud, Xu, Xu, Xu, Xu, Uu, Uu, Uu, Wwg, Uu^Uf, Uu^Uf, Uu, Uu^Vu, Uu, Ur, Ur, Qxu, Uu^Uf, Xu, Xu, Xu, Xu, Xu
Xu, Qxu, Qxu, Qxu, Qxu, Qxu, Qxu, Qxu, Xu, Uu, Xu, Qxu, Qxu, Xu, Xu, Xu, Xu, Uu, Uh, Uu^Uf, Uu^Uf, Wwf, Uu, Uu, Uu, Uu, Xu, Uu^Uf, Uu^Uf, Ur, Ur, Uu^Uf, Xu, Xu, Xu, Xu
Xu, Qxu, Qxu, Xu, Qxu, Qxu, Qxu, Qxu, Qxu, Qxu^Bs|, Qxu, Qxu, Qxu, Xu, Xu, Xu, Wwg, Uu^Uf, Uh, Uh, Uu^Uf, Wwf, Uu, Uu, Xu, Xu, Xu, Uh, Xu, Uu, Ur, Uu, Xu, Xu, Xu, Xu
Uh, Qxu, Uh, Qxu, Uu^Uf, Uh, Uu^Uf, Qxu, Uu^Vu, Qxu^Bs|, Qxu, Qxu, Qxu, Qxu, Xu, Xu, Wwg, Wwf, Uu^Uf, Uu^Uf, Wwf, Wwg, Xu, Xu, Xu, Xu, Xu, Xu, Xu, Xu, Xu, Ur, Ur, Xu, Xu, Xu
Xu, Uh, Uu^Uf, Uu^Uf, Uu, Uu^Uf, Uu, Uu, Uu, Ur, Uu^Uf, Uh, Xu, Wwg, Xu, Uu^Uf, Wwg, Wwg, Wwg, Wwf, Uu, Xu, Xu, Xu, Uh, Xu, Uu, Uu^Vu, Uh, Uh, Uu^Uf, Uh, Ur, Xu, Xu, Xu
Xu, Xu, Uu, Uu, Xu, Xu, Xu, Xu, Ur, Ur, Xu, Xu, Xu, Wwg, Xu, Xu, Wwg, Wwg, Uu, Uu, Uu, Xu, Uh, Uu^Uf, Uu, Uu, Uu^Uf, Uu, Uu, Uu, Uu, Uu, Ur, Xu, Xu, Xu
Xu, Xu, Xu, Uu, Xu, Xu, Xu, Cud, Ur, Uu^Vu, Xu, Xu, Xu, Wwg, Wwg, Wwg, Xu, Xu, Cud, Cud, Uu, Xu, Uu, Uu, Xu, Uh, Xu, Uh, Uh, Uh, Uu^Uf, Uu, Ur, Uu^Uf, Xu, Xu
Xu, Xu, Uh, Uu, Uu, Xu, Cud, Cud, Ur, Uu, Qxu, Xu, Wwg, Wwg, Xu, Wwg, Wwg, Xu, Xu, Cud, Uu, Uu, Xu, Xu, Xu, Xu, Xu, Xu, Xu, Xu, Xu, Uu^Uf, Ur, Uh, Uh, Xu
Uh, Uh, Uh, Uu^Uf, Uu^Uf, Uu, Uu, Ur, Qxu^Bs|, Ur, Qxu, Qxu, Qxu, Xu, Xu, Xu, Uu^Uf, Wwg, Wwg, Uu, Uu, Uu, Uh, Xu, Xu, Xu, Xu, Xu, Xu, Xu, Xu, Uu^Uf, Ur, Uh, Xu, Xu
Xu, Uh, Xu, Uu^Uf, Qxu, Uu, Qxu, Ur, Qxu^Bs|, Ur, Qxu, Qxu, Qxu, Qxu, Xu, Uh, Uu, Uu^Vu, Uu, Wwf, Uu^Uf, Uu^Uf, Uh, Xu, Xu, Xu, Xu, Xu, Xu, Xu, Xu, Qxu, Ur, Xu, Xu, Xu
Xu, Xu, Xu, Qxu, Qxu, Qxu, Xu, Qxu^Bs|, Qxu^Bs|, Qxu^Bs|, Xu, Qxu, Uh, Uh, Uu^Uf, Xu, Uu, Uu, Uh, Wwg, Wwg, Uh, Wwg, Xu, Wwg, Wwg, Xu, Xu, Xu, Xu, Xu, Ur, Uh, Uh, Xu, Xu
Wwg, Wwg, Wwg, Xu, Qxu, Qxu, Qxu, Qxu^Bs|, Qxu^Bs|, Qxu^Bs|, Qxu, Qxu, Qxu, Uh, Uu^Uf, Uu^Uf, Cud, Uu, Uh, Xu, Xu, Wwg, Xu, Wwg, Xu, Xu, Xu, Xu, Xu, Xu, Uh, Ur, Uh, Xu, Xu, Xu
Xu, Xu, Xu, Qxu, Xu, Qxu, Xu, Qxu^Bs|, Qxu^Bs|, Qxu^Bs|, Xu, Qxu, Qxu, Uh, Uu^Uf, Cud, Cud, Uu, Uu, Uh, Uu^Uf, Xu, Xu, Xu, Xu, Xu, Xu, Uu^Vu, Uu, Uh, Ur, Ur, Xu, Xu, Xu, Xu
Xu, Xu, Qxu, Qxu, Qxu, Qxu, Qxu, Qxu^Bs|, Qxu^Bs|, Qxu^Bs|, Qxu, Qxu, Xu, Qxu, Qxu, Uu, Uu, Uu, Uu, Uu, Uu^Uf, Uh, Xu, Xu, Xu, Xu, Uu^Uf, Uu^Uf, Ur, Ur, Xu, Xu, Xu, Xu, Xu, Xu
Xu, Xu, Uh, Qxu, Uh, Qxu, Qxu, Qxu^Bs|, Qxu^Bs|, Qxu^Bs|, Xu, Qxu, Qxu, Qxu, Qxu, Qxu, Ur, Ur, Ur, Uu, Uu, Uu^Uf, Xu, Xu, Xu, Xu, Uh, Uu, Ur, Xu, Xu, Xu, Xu, Xu, Xu, Xu
Uh, Uh, Uu^Uf, Uu, Uu, Uh, Uu^Uf, Qxu^Bs|, Qxu^Bs|, Qxu^Bs|, Qxu, Qxu, Uu^Vu, Qxu, Ur, Ur, Uu, Uu^Vu, Uu, Ur, Ur, Uu, Xu, Xu, Xu, Xu, Xu, Uh, Ur, Uh, Xu, Xu, Xu, Xu, Xu, Xu
Uh, Uh, Xu, Uu, Uu, Uu, Uu, Qxu^Bs|, Qxu^Bs|, Qxu^Bs|, Uu^Uf, Uu, Ur, Ur, Uu^Uf, Uu, Uh, Xu, Xu, Uu, Ur, Uu, Xu, Xu, Xu, Xu, Xu, Uh, Ur, Uu^Uf, Uh, Xu, Xu, Xu, Xu, Xu
Xu, Xu, Xu, Xu, Xu, Uu, Uu, Ur, Ur, Ur, Ur, Ur, Xu, Uh, Xu, Uh, Xu, Xu, Uh, Uu, Ur, Uu, Xu, Xu, Xu, Xu, Xu, Xu, Xu, Ur, Ur, Uh, Xu, Xu, Xu, Xu
Xu, Xu, Xu, Xu, Uh, Uh, Uu^Uf, Uu, Ur, Uu^Uf, Xu, Xu, Xu, Xu, Xu, Xu, Xu, Xu, Uh, Uu^Uf, Uu, Ur, Uh, Xu, Xu, Xu, Xu, Xu, Xu, Uu^Vu, Ur, Uu^Uf, Xu, Xu, Xu, Xu
Xu, Xu, Xu, Xu, Xu, Uh, Uu^Uf, Uu, Ur, Uh, Uh, Xu, Xu, Xu, Xu, Xu, Xu, Xu, Xu, Xu, Xu, Ur, Ur, Uu^Uf, Uu^Vu, Xu, Xu, Xu, Xu, Xu, Ur, Uu^Uf, Uh, Xu, Xu, Xu
Xu, Xu, Xu, Xu, Xu, Xu, Xu, Uh, Uh, Ur, Uu^Uf, Xu, Xu, Xu, Xu, Xu, Xu, Xu, Xu, Xu, Xu, Uh, Uu, Ur, Ur, Xu, Uh, Xu, Xu, Uh, Ur, Uu, Uu, Uh, Xu, Xu
Xu, Xu, Xu, Xu, Xu, Xu, Xu, Xu, Uh, Ur, Uu^Uf, Xu, Xu, Xu, Xu, Xu, Xu, Xu, Xu, Xu, Xu, Xu, Uh, Uu, Uu, Ur, Ur, Uh, Uu^Uf, Uu^Uf, Ur^Kov, Uu^Cov, Uu^Cov, Uh, Uh, Xu
Xu, Xu, Xu, Xu, Xu, Xu, Xu, Xu, Uh, Ur, Ur, Uh, Xu, Xu, Xu, Xu, Xu, Xu, Xu, Xu, Xu, Xu, Uh, Uh, Uh, Uu^Uf, Uu^Vu, Ur, Ur, Ur, Ur^Cov, 1 Ur^Kov, Uu^Cov, Uu, Uu^Uf, Xu
Xu, Xu, Xu, Xu, Xu, Xu, Xu, Xu, Xu, Uh, Ur, Uh, Uu^Uf, Xu, Xu, Xu, Xu, Xu, Xu, Xu, Xu, Xu, Xu, Xu, Xu, Xu, Xu, Uh, Uh, Uu, Uu, Ur^Cov, Ur, Uu, Uu, Uu^Uf
Xu, Xu, Xu, Xu, Xu, Xu, Xu, Xu, Xu, Uu^Uf, Uu, Ur, Uu, Uu^Uf, Xu, Xu, Xu, Xu, Xu, Xu, Xu, Xu, Xu, Xu, Xu, Xu, Xu, Xu, Xu, Uu, Uu, Uu, Ur, Uu, Uu, Uu^Uf
