Xur, Xur, Xur, Xur, Xur, Xur, Xur, Xur, Uu, Uu, Uu, Uu, Ur, Uu, Tb, Uh, Uh, Xur, Xur, Xur, Xur, Xur, Xur, Xur, Xur, Xur, Xur, Xur, Xur, Xur, Xur, Xur, Xur, Xur, Xur, Xur
Xur, Xur, Xur, Xur, Xur, Xur, Xur, Xur, Uu^Vu, Uu, Uu, Uu, Ur, Uu, Tb, Uh, Uh, Xur, Xur, Xur, Xur, Xur, Xur, Xur, Xur, Xur, Xur, Xur, Xur, Xur, Xur, Xur, Xur, Xur, Xur, Xur
Xur, Xur, Xur, Xur, Xur, Xur, Xur, Xur, Tb, Tb, Tb, Uu, Cfr, Uu, Tb, Uh, Tb, Xur, Xur, Xur, Xur, Xur, Xur, Xur, Xur, Xur, Xur, Xur, Xur, Xur, Xur, Xur, Xur, Xur, Xur, Xur
Xur, Xur, Xur, Xur, Xur, Xur, Xur, Xur, Tb, Uh, Tb, Cfr, 2 Kfr, Cfr, Uu, Tb, Uu^Vu, Xur, Xur, Xur, Xur, Xur, Xur, Xur, Xur, Xur, Xur, Xur, Xur, Xur, Xur, Xur, Xur, Xur, Xur, Xur
Xur, Xur, Xur, Xur, Xur, Xur, Xur, Xur, Uh, Tb, Uu, Cfr, Cfr, Cfr, Ur, Uu, Uu, Xur, Xur, Xur, Xur, Xur, Xur, Xur, Xur, Xur, Xur, Xur, Xur, Xur, Xur, Xur, Xur, Xur, Xur, Xur
Xur, Xur, Xur, Xur, Xur, Xur, Xur, Uh, Uu, Uu, Ur, Ur, Tb, Uu, Uu, Ur, Uu^Vu, Xur, Xur, Xur, Xur, Xur, Xur, Xur, Xur, Xur, Xur, Xur, Xur, Xur, Xur, Xur, Xur, Xur, Xur, Xur
Xur, Xur, Xur, Xur, Xur, Xur, Tb, Uu, Ur, Ur, Uu^Vu, Tb, Uh, Tb, Uu, Ur, Ur, Ur, Ur, Uh, Uh, Xur, Xur, Xur, Xur, Xur, Xur, Xur, Xur, Xur, Xur, Xur, Xur, Xur, Xur, Xur
Xur, Xur, Xur, Xur, Xur, Tb, Ur, Ur, Tb, Ur, Ur, Tb, Xur, Xur, Xur, Uu, Uu, Uu, Tb, Ur, Ur, Xur, Xur, Xur, Xur, Xur, Xur, Xur, Xur, Xur, Xur, Xur, Xur, Xur, Xur, Xur
Xur, Xur, Xur, Xur, Ur, Ur, Xur, Uh, Xur, Xur, Ur, Uu, Xur, Xur, Xur, Xur, Uu, Tb, Uh, Xur, Xur, Ur, Xur, Xur, Xur, Xur, Xur, Xur, Xur, Xur, Xur, Xur, Xur, Xur, Xur, Xur
Xur, Xur, Uh, Uu^Vu, Ur, Uh, Xur, Xur, Xur, Xur, Ur, Uu, Xur, Xur, Xur, Xur, Uu, Tb, Xur, Xur, Xur, Ur, Ur, Xur, Xur, Xur, Xur, Xur, Xur, Xur, Xur, Xur, Xur, Xur, Xur, Xur
Xur, Xur, Uh, Uu, Ur, Xur, Xur, Xur, Uh, Uh, Ur, Uu, Uh, Xur, Xur, Xur, Uu, Uu, Uu^Vu, Xur, Wwg, Xur, Xur, Ur, Ur, Xur, Xur, Xur, Xur, Xur, Xur, Xur, Xur, Xur, Xur, Xur
Xur, Uh, Tb, Uu, Ur, Tb, Qxu, Qxu, Qxu, Tb, Uu, Ur, Tb, Xur, Xur, Xur, Xur, Uu, Uu, Xur, Xur, Wwg, Xur, Xur, Uu, Ur, Uu, Xur, Uh, Xur, Xur, Xur, Xur, Xur, Xur, Xur
Xur, Xur, Qxu, Tb, Qxu, Qxu^Bs\, Qxu^Bs\, Qxu, Qxu, Qxu, Qxu, Ur, Cud, Uh, Xur, Xur, Xur, Uu, Uu, Uu, Xur, Wwg, Uh, Uh, Uu, Ur, Ur, Tb, Tb, Tb, Tb, Xur, Xur, Xur, Xur, Xur
Xur, Qxu, Xu, Qxu, Qxu, Qxu, Xu, Qxu^Bs\, Qxu^Bs\, Xu, Qxu^Bs/, Ur, Cud, Cud, Xur, Xur, Xur, Xur, Uu, Uu, Uu, Wwg, Tb, Tb, Uu, Uu^Vu, Uu, Ur, Ur, Qxu, Tb, Xur, Xur, Xur, Xur, Xur
Xur, Qxu, Qxu, Qxu, Qxu, Qxu, Qxu, Qxu, Xu, Uu, Xu, Qxu, Qxu, Xur, Xur, Xur, Xur, Uu, Uh, Tb, Tb, Wwf, Uu, Uu, Uu, Uu, Xur, Tb, Tb, Ur, Ur, Tb, Xur, Xur, Xur, Xur
Xur, Qxu, Qxu, Xu, Qxu, Qxu, Qxu, Qxu, Qxu, Qxu^Bs|, Qxu, Qxu, Qxu, Xur, Xur, Xur, Wwg, Tb, Uh, Uh, Tb, Wwf, Uu, Uu, Xur, Xur, Xur, Uh, Xur, Uu, Ur, Uu, Xur, Xur, Xur, Xur
Uh, Qxu, Uh, Qxu, Tb, Uh, Tb, Qxu, Uu^Vu, Qxu^Bs|, Qxu, Qxu, Qxu, Qxu, Xur, Xur, Wwg, Wwf, Tb, Tb, Wwf, Wwg, Xur, Xur, Xur, Xur, Xur, Xur, Xur, Xur, Xur, Ur, Ur, Xur, Xur, Xur
Xur, Uh, Tb, Tb, Uu, Tb, Uu, Uu, Uu, Ur, Tb, Uh, Xur, Wwg, Xur, Tb, Wwg, Wwg, Wwg, Wwf, Uu, Xur, Xur, Xur, Uh, Xur, Uu, Uu^Vu, Uh, Uh, Tb, Uh, Ur, Xur, Xur, Xur
Xur, Xur, Uu, Uu, Xur, Xur, Xur, Xur, Ur, Ur, Xur, Xur, Xur, Wwg, Xur, Xur, Wwg, Wwg, Uu, Uu, Uu, Xur, Uh, Tb, Uu, Uu, Tb, Uu, Uu, Uu, Uu, Uu, Ur, Xur, Xur, Xur
Xur, Xur, Xur, Uu, Xur, Xur, Xur, Cfr, Ur, Uu^Vu, Xur, Xur, Xur, Wwg, Wwg, Wwg, Xur, Xur, Cfr, Cfr, Uu, Xur, Uu, Uu, Xur, Uh, Xur, Uh, Uh, Uh, Tb, Uu, Ur, Tb, Xur, Xur
Xur, Xur, Uh, Uu, Uu, Xur, Cfr, Cfr, Ur, Uu, Qxu, Xur, Wwg, Wwg, Xur, Wwg, Wwg, Xur, Xur, Cfr, Uu, Uu, Xur, Xur, Xur, Xur, Xur, Xur, Xur, Xur, Xur, Tb, Ur, Uh, Uh, Xur
Uh, Uh, Uh, Tb, Tb, Uu, Uu, Ur, Qxu^Bcx|, Ur, Qxu, Qxu, Qxu, Xur, Xur, Xur, Tb, Wwg, Wwg, Uu, Uu, Uu, Uh, Xur, Xur, Xur, Xur, Xur, Xur, Xur, Xur, Tb, Ur, Uh, Xur, Xur
Xur, Uh, Xur, Tb, Qxu, Uu, Qxu, Ur, Qxu^Bcx|, Ur, Qxu, Qxu, Qxu, Qxu, Xur, Uh, Uu, Uu^Vu, Uu, Wwf, Tb, Tb, Uh, Xur, Xur, Xur, Xur, Xur, Xur, Xur, Xur, Qxu, Ur, Xur, Xur, Xur
Xur, Xur, Xur, Qxu, Qxu, Qxu, Xur, Qxu^Bcx|, Qxu, Qxu^Bcx|, Xur, Qxu, Uh, Uh, Tb, Xur, Uu, Uu, Uh, Wwg, Wwg, Uh, Wwg, Xur, Wwg, Wwg, Xur, Xur, Xur, Xur, Xur, Ur, Uh, Uh, Xur, Xur
Wwg, Wwg, Wwg, Xur, Qxu, Qxu, Qxu, Qxu^Bcx|, Qxu^Bcx|, Qxu^Bcx|, Qxu, Qxu, Qxu, Uh, Tb, Tb, Cud, Uu, Uh, Xur, Xur, Wwg, Xur, Wwg, Xur, Xur, Xur, Xur, Xur, Xur, Uh, Ur, Uh, Xur, Xur, Xur
Xur, Xur, Xur, Qxu, Xu, Qxu, Xu, Qxu^Bcx|, Qxu^Bcx|, Qxu, Xur, Qxu, Qxu, Uh, Tb, Cud, Cud, Uu, Uu, Uh, Tb, Xur, Xur, Xur, Xur, Xur, Xur, Uu^Vu, Uu, Uh, Ur, Ur, Xur, Xur, Xur, Xur
Xur, Xur, Qxu, Qxu, Qxu, Qxu, Qxu, Qxu, Qxu^Bcx|, Qxu, Qxu, Qxu, Xu, Qxu, Qxu, Uu, Uu, Uu, Uu, Uu, Tb, Uh, Xur, Xur, Xur, Xur, Tb, Tb, Ur, Ur, Xur, Xur, Xur, Xur, Xur, Xur
Xur, Xur, Uh, Qxu, Uh, Qxu, Qxu, Qxu, Qxu^Bcx|, Qxu^Bcx|, Xu, Qxu, Qxu, Qxu, Qxu, Qxu, Ur, Ur, Ur, Uu, Uu, Tb, Xur, Xur, Xur, Xur, Uh, Uu, Ur, Xur, Xur, Xur, Xur, Xur, Xur, Xur
Uh, Uh, Tb, Uu, Uu, Uh, Tb, Qxu^Bcx|, Qxu^Bcx|, Qxu^Bcx|, Qxu, Qxu, Uu^Vu, Qxu, Ur, Ur, Uu, Uu^Vu, Uu, Ur, Ur, Uu, Xur, Xur, Xur, Xur, Xur, Uh, Ur, Uh, Xur, Xur, Xur, Xur, Xur, Xur
Uh, Uh, Xur, Uu, Uu, Uu, Uu, Qxu^Bcx|, Qxu^Bcx|, Qxu^Bcx|, Tb, Uu, Ur, Ur, Tb, Uu, Uh, Xur, Xur, Uu, Ur, Uu, Xur, Xur, Xur, Xur, Xur, Uh, Ur, Tb, Uh, Xur, Xur, Xur, Xur, Xur
Xur, Xur, Xur, Xur, Xur, Uu, Uu, Ur, Ur, Ur, Ur, Ur, Xur, Uh, Xur, Uh, Xur, Xur, Uh, Uu, Ur, Uu, Xur, Xur, Xur, Xur, Xur, Xur, Xur, Ur, Ur, Uh, Xur, Xur, Xur, Xur
Xur, Xur, Xur, Xur, Uh, Uh, Tb, Uu, Ur, Tb, Xur, Xur, Xur, Xur, Xur, Xur, Xur, Xur, Uh, Tb, Uu, Ur, Uh, Xur, Xur, Xur, Xur, Xur, Xur, Uu^Vu, Ur, Tb, Xur, Xur, Xur, Xur
Xur, Xur, Xur, Xur, Xur, Uh, Tb, Uu, Ur, Uh, Uh, Xur, Xur, Xur, Xur, Xur, Xur, Xur, Xur, Xur, Xur, Ur, Ur, Tb, Uu^Vu, Xur, Xur, Xur, Xur, Xur, Ur, Tb, Uh, Xur, Xur, Xur
Xur, Xur, Xur, Xur, Xur, Xur, Xur, Uh, Uh, Ur, Tb, Xur, Xur, Xur, Xur, Xur, Xur, Xur, Xur, Xur, Xur, Uh, Uu, Ur, Ur, Xur, Uh, Xur, Xur, Uh, Ur, Uu, Uu, Uh, Xur, Xur
Xur, Xur, Xur, Xur, Xur, Xur, Xur, Xur, Uh, Ur, Tb, Xur, Xur, Xur, Xur, Xur, Xur, Xur, Xur, Xur, Xur, Xur, Uh, Uu, Uu, Ur, Ur, Uh, Tb, Tb, Ur^Kov, Uu^Cov, Uu^Cov, Uh, Uh, Xur
Xur, Xur, Xur, Xur, Xur, Xur, Xur, Xur, Uh, Ur, Ur, Uh, Xur, Xur, Xur, Xur, Xur, Xur, Xur, Xur, Xur, Xur, Uh, Uh, Uh, Tb, Uu^Vu, Ur, Ur, Ur, Ur^Cov, 1 Ur^Kov, Uu^Cov, Uu, Tb, Xur
Xur, Xur, Xur, Xur, Xur, Xur, Xur, Xur, Xur, Uh, Ur, Uh, Tb, Xur, Xur, Xur, Xur, Xur, Xur, Xur, Xur, Xur, Xur, Xur, Xur, Xur, Xur, Uh, Uh, Uu, Uu, Ur^Cov, Ur, Uu, Uu, Tb
Xur, Xur, Xur, Xur, Xur, Xur, Xur, Xur, Xur, Tb, Uu, Ur, Uu, Tb, Xur, Xur, Xur, Xur, Xur, Xur, Xur, Xur, Xur, Xur, Xur, Xur, Xur, Xur, Xur, Uu, Uu, Uu, Ur, Uu, Uu, Tb
