border_size=1
usage=map

Xue, Xue, Xue, Xue, Xue, Xue, Xue, Xue, Xue, Xue, Xue, Xue, Xue, Xue, Xue, Xue, Xue, Xue, Xue, Xue, Xue, Xue, Xue, Xue, Xue, Xue, Xue, Xue, Uue^Ii, Uue, Uue^Ii, Xue, Xue, Xue, Xue, Xue, Xue
Xue, Xue, Xue, Xue, Xue, Xue, Xue, Xue, Xue, Xue, Xue, Xue, Xue, Xue, Xue, Xue, Xue, Xue, Xue, Xue, Xue, Xue, Xue, Xue, Xue, Xue, Xue, Xue, Uue^Ii, Uue, Uue^Ii, Xue, Xue, Xue, Xue, Xue, Xue
Xue, Xue, Xue, Xue, Xue, Xue, Xue, Xue, Xue, Xue, Xue, Xue, Xue, Xue, Xue, Xue, Xue, Xue, Xue, Xue, Xue, Xue, Xue, Xue, Xue, Xue, Xue, Xue, Uue^Ii, Uue, Uue^Ii, Xue, Xue, Xue, Xue, Xue, Xue
Xue, Xue, Xue, Xue, Xue, Xue, Xue, Xue, Xue, Xue, Xue, Xue, Xue, Xue, Xue, Xue, Xue, Xue, Xue, Xue, Xue, Xue, Xue, Xue, Xue, Xue, Uue^Ii, Uue^Ii, Hhd, Uue, Hhd, Uue^Ii, Uue^Ii, Xue, Xue, Xue, Xue
Xue, Xue, Xue, Xue, Xue, Xue, Xue, Xue, Xue, Xue, Xue, Xue, Xue, Xue, Xue, Xue, Xue, Xue, Xue, Xue, Xue, Xue, Xue, Xue, Hhd^Ii, Uue^Ii, Hhd, Hhd, Md^Ii, Hhd, Md^Ii, Hhd, Hhd, Uue^Ii, Hhd^Ii, Xue, Xue
Xue, Xue, Xue, Xue, Xue, Xue, Xue, Xue, Xue, Xue, Xue, Xue, Xue, Xue, Xue, Xue, Xue, Xue, Xue, Xue, Xue, Xue, Xue, Xue, Uue^Ii, Uue^Ii, Hhd^Ii, Md^Ii, Md^Xm, Md^Ii, Md^Xm, Md^Ii, Hhd^Ii, Uue^Ii, Uue^Ii, Xue, Xue
Xue, Xue, Xue, Xue, Xue, Xue, Xue, Xue, Xue, Xue, Xue, Xue, Xue, Xue, Xue, Xue, Xue, Xue, Xue, Xue, Xue, Xue, Xue, Xue, Uue^Ii, Hhd, Md^Ii, Md^Ii, Md^Ii, Md, Md, Md^Ii, Md^Ii, Hhd, Uue^Ii, Xue, Xue
Xue, Xue, Xue, Xue, Xue, Xue, Xue, Xue, Xue, Xue, Xue, Xue, Xue, Xue, Xue, Xue, Xue, Xue, Xue, Xue, Xue, Xue, Xue, Xue, Uue^Ii, Hhd, Md^Ii, Md^Xm, Md^Ii, Hhd^Ii, Md^Ii, Md^Xm, Md^Ii, Hhd, Uue^Ii, Xue, Xue
Xue, Xue, Xue, Xue, Xue, Xue, Xue, Xue, Xue, Xue, Xue, Xue, Xue, Xue, Xue, Xue, Xue, Xue, Xue, Xue, Xue, Xue, Xue, Xue, Uue^Ii, Hhd, Hhd, Md^Ii, Hhd^Ii, Hhd^Ii, Hhd^Ii, Md^Ii, Hhd, Hhd, Uue^Ii, Xue, Xue
Xue, Xue, Xue, Xue, Xue, Xue, Xue, Xue, Xue, Xue, Xue, Xue, Xue, Xue, Xue, Xue, Xue, Xue, Xue, Xue, Xue, Xue, Xue, Xue, Hhd^Ii, Uue, Uue^Ii, Hhd^Ii, Uue, Uue^Ii, Uue, Hhd^Ii, Uue^Ii, Uue, Hhd^Ii, Xue, Xue
Xue, Xue, Xue, Xue, Xue, Xue, Xue, Xue, Xue, Xue, Xue, Xue, Xue, Xue, Xue, Xue, Xue, Xue, Xue, Xue, Xue, Xue, Xue, Xue, Hhd^Ii, Uue^Ii, Uue, Uue, Re, Uue^Ii, Re, Uue, Uue, Uue^Ii, Hhd^Ii, Xue, Xue
Xue, Xue, Xue, Xue, Xue, Xue, Xue, Xue, Xue, Xue, Xue, Xue, Xue, Xue, Xue, Xue, Xue, Xue, Xue, Xue, Xue, Xue, Xue, Xue, Xue, Hhd^Ii, Uue^Ii, Re, Uue^Ii, Uue^Ii, Uue^Ii, Re, Uue^Ii, Hhd^Ii, Xue, Xue, Xue
Xue, Xue, Xue, Xue, Xue, Xue, Xue, Xue, Xue, Xue, Xue, Xue, Xue, Xue, Xue, Xue, Xue, Xue, Xue, Xue, Xue, Xue, Xue, Xue, Xue, Xue, Xue, Uue^Ii, Uue^Ii, Re, Uue^Ii, Uue^Ii, Xue, Xue, Xue, Xue, Xue
Xue, Xue, Xue, Xue, Xue, Xue, Xue, Xue, Xue, Xue, Xue, Xue, Xue, Xue, Xue, Xue, Xue, Xue, Xue, Xue, Xue, Xue, Xue, Xue, Xue, Xue, Xue, Xue, Uue^Ii, Re, Uue^Ii, Xue, Xue, Xue, Xue, Xue, Xue
Xue, Xue, Xue, Xue, Xue, Xue, Xue, Xue, Xue, Xue, Xue, Xue, Xue, Xue, Xue, Xue, Xue, Xue, Xue, Xue, Xue, Xue, Xue, Xue, Xue, Xue, Xue, Xue, Uue^Ii, Re, Uue^Ii, Xue, Xue, Xue, Xue, Xue, Xue
Xue, Xue, Xue, Xue, Xue, Xue, Xue, Xue, Xue, Xue, Xue, Xue, Xue, Xue, Xue, Xue, Xue, Xue, Xue, Xue, Xue, Xue, Xue, Xue, Xue, Xue, Uue^Ii, Uue^Ii, Re, Re, Uue^Ii, Xue, Xue, Xue, Xue, Xue, Xue
Xue, Xue, Xue, Xue, Xue, Xue, Xue, Xue, Xue, Xue, Xue, Xue, Xue, Xue, Xue, Xue, Xue, Xue, Xue, Xue, Xue, Xue, Uue^Ii, Uue^Ii, Uue^Ii, Uue^Ii, Re, Re, Uue^Ii, Uue^Ii, Xue, Xue, Xue, Xue, Xue, Xue, Xue
Xue, Xue, Xue, Xue, Xue, Xue, Xue, Xue, Xue, Xue, Xue, Xue, Xue, Xue, Xue, Xue, Xue, Xue, Xue, Xue, Uue^Ii, Re, Qlf^Ii, Qlf^Ii, Qlf^Ii, Re, Re, Uue^Ii, Xue, Xue, Xue, Xue, Xue, Xue, Xue, Xue, Xue
Xue, Xue, Xue, Xue, Xue, Xue, Xue, Xue, Xue, Xue, Xue, Xue, Xue, Xue, Xue, Xue, Xue, Xue, Xue, Uue^Ii, Re, Qlf^Ii, Uu, Qlf^Ii, Uu, Qlf^Ii, Re, Uue^Ii, Xue, Xue, Xue, Xue, Xue, Xue, Xue, Xue, Xue
Xue, Xue, Xue, Xue, Xue, Xue, Xue, Xue, Xue, Xue, Xue, Xue, Xue, Xue, Xue, Xue, Xue, Xue, Xue, Uue^Ii, Qlf^Ii, Uu, Qlf^Ii, Uu, Qlf^Ii, Uu, Qlf^Ii, Uue^Ii, Xue, Xue, Xue, Xue, Xue, Xue, Xue, Xue, Xue
Xue, Xue, Xue, Xue, Xue, Xue, Xue, Xue, Xue, Xue, Xue, Xue, Xue, Xue, Xue, Xue, Xue, Xue, Xue, Re, Qlf^Ii, Uu, Uu, Qlf^Ii, Uu, Uu, Qlf^Ii, Re, Xue, Xue, Xue, Xue, Xue, Xue, Xue, Xue, Xue
Xue, Xue, Xue, Xue, Xue, Xue, Xue, Xue, Xue, Xue, Xue, Xue, Xue, Xue, Xue, Xue, Xue, Xue, Xue, Uue^Ii, Re, Uu^Ii, Uu, Qlf^Ii, Uu, Qlf^Ii, Qlf^Ii, Uue^Ii, Xue, Xue, Xue, Xue, Xue, Xue, Xue, Xue, Xue
Xue, Xue, Xue, Xue, Xue, Xue, Xue, Xue, Xue, Xue, Xue, Xue, Xue, Xue, Xue, Xue, Xue, Xue, Uue^Ii, Uue^Ii, Re, Qlf^Ii, Qlf^Ii, Uu, Qlf^Ii, Qlf^Ii, Uue^Ii, Uue^Ii, Xue, Xue, Xue, Xue, Xue, Xue, Xue, Xue, Xue
Xue, Xue, Xue, Xue, Xue, Xue, Xue, Xue, Xue, Xue, Xue, Xue, Xue, Xue, Xue, Xue, Uue^Ii, Uue^Ii, Re, Re, Uue^Ii, Uue^Ii, Uue^Ii, Uue, Uue^Ii, Re, Xue, Xue, Xue, Xue, Xue, Xue, Xue, Xue, Xue, Xue, Xue
Xue, Xue, Xue, Xue, Xue, Xue, Xue, Xue, Xue, Xue, Qxe, Xue, Xue, Xue, Uue^Ii, Uue^Ii, Re, Re, Uue^Ii, Uue^Ii, Xue, Xue, Xue, Uue^Ii, Xue, Xue, Xue, Xue, Xue, Xue, Xue, Xue, Xue, Xue, Xue, Xue, Xue
Xue, Xue, Xue, Xue, Xue, Xue, Xue, Xue, Qxe, Qxe^Ii, Qxe^Ii, Qxe^Ii, Uue^Ii, Uue^Ii, Re, Re, Uue^Ii, Uue^Ii, Xue, Xue, Xue, Xue, Xue, Xue, Xue, Xue, Xue, Xue, Xue, Xue, Xue, Xue, Xue, Xue, Xue, Xue, Xue
Xue, Xue, Xue, Xue, Xue, Xue, Qxe^Ii, Qxe^Ii, Qxe, Qxe, Qxe^Ii, Qxe, Re, Re, Uue^Ii, Uue^Ii, Xue, Xue, Xue, Xue, Xue, Xue, Xue, Xue, Xue, Xue, Xue, Xue, Xue, Xue, Xue, Xue, Xue, Xue, Xue, Xue, Xue
Xue, Xue, Xue, Xue, Xue, Xue, Qxe^Ii, Qxe^Ii, Qxe^Ii, Uue^Ii, Qxe^Ii, Uue^Ii, Qxe^Ii, Qxe^Ii, Qxe, Xue, Xue, Xue, Xue, Xue, Xue, Xue, Xue, Xue, Xue, Xue, Xue, Xue, Xue, Xue, Xue, Xue, Xue, Xue, Xue, Xue, Xue
Xue, Xue, Xue, Xue, Xue, Xue, Qxe, Qxe, Uue^Ii, Re, Qxe^Ii, Re, Uue^Ii, Qxe^Ii, Qxe, Xue, Xue, Xue, Xue, Xue, Xue, Xue, Xue, Xue, Xue, Xue, Xue, Xue, Xue, Xue, Xue, Xue, Xue, Xue, Xue, Xue, Xue
Xue, Xue, Xue, Xue, Xue, Xue, Qxe^Ii, Qxe^Ii, Re, Qxe, Qxe^Ii, Qxe, Re, Qxe^Ii, Uue^Ii, Xue, Xue, Xue, Xue, Xue, Xue, Xue, Xue, Xue, Xue, Xue, Xue, Xue, Xue, Xue, Xue, Xue, Xue, Xue, Xue, Xue, Xue
Xue, Xue, Xue, Xue, Xue, Xue, Qxe, Qxe^Ii, Qxe^Ii, Uue^Ii, Re, Uue^Ii, Qxe^Ii, Re^Ii, Re, Uue^Ii, Uue^Ii, Xue, Xue, Xue, Xue, Xue, Qxe^Ii, Xue, Xue, Xue, Xue, Xue, Xue, Xue, Xue, Xue, Xue, Xue, Xue, Xue, Xue
Xue, Xue, Xue, Xue, Xue, Xue, Xue, Qxe^Ii, Qxe, Qxe^Ii, Qxe^Ii, Qxe^Ii, Qxe, Uue^Ii, Uue^Ii, Re, Re, Uue^Ii, Uue^Ii, Xue, Qxe^Ii, Qxe, Qxe^Ii, Qxe, Qxe^Ii, Xue, Xue, Xue, Xue, Xue, Xue, Xue, Xue, Xue, Xue, Xue, Xue
Xue, Xue, Xue, Xue, Xue, Xue, Xue, Xue, Xue, Qxe, Qxe^Ii, Qxe, Qxe, Uue^Ii, Xue, Uue^Ii, Uue^Ii, Re, Re, Uue^Ii, Wwt^Ii, Wwt^Ii, Wwt^Ii, Wwt^Ii, Wwt^Ii, Qxe, Qxe^Ii, Xue, Xue, Xue, Xue, Xue, Xue, Xue, Xue, Xue, Xue
Xue, Xue, Xue, Xue, Xue, Xue, Xue, Xue, Xue, Xue, Xue, Qxe^Ii, Xue, Xue, Xue, Xue, Xue, Uue^Ii, Uue^Ii, Re, Wwrt, Wwrt, Wwrt^Ii, Wwrt, Wwrt^Ii, Qxe^Ii, Qxe, Xue, Xue, Xue, Xue, Xue, Xue, Xue, Xue, Xue, Xue
Xue, Xue, Xue, Xue, Xue, Xue, Xue, Xue, Xue, Xue, Xue, Xue, Xue, Xue, Xue, Xue, Xue, Xue, Qxe^Ii, Wwt^Ii, Wwrt, Wwt, Wwt^Ii, Wwt, Wwrt, Wwt^Ii, Qxe^Ii, Xue, Xue, Xue, Xue, Xue, Xue, Xue, Xue, Xue, Xue
Xue, Xue, Xue, Xue, Xue, Xue, Xue, Xue, Xue, Xue, Xue, Xue, Xue, Xue, Xue, Xue, Xue, Xue, Qxe, Wwt^Ii, Wwrt^Ii, Wwt^Ii, Wwrt, Wwt^Ii, Wwrt^Ii, Wwt^Ii, Qxe, Xue, Xue, Xue, Xue, Xue, Xue, Xue, Xue, Xue, Xue
Xue, Xue, Xue, Xue, Xue, Xue, Xue, Xue, Xue, Xue, Xue, Xue, Xue, Xue, Xue, Xue, Xue, Xue, Qxe^Ii, Qxe^Ii, Wwt^Ii, Wwrt, Wwrt, Wwrt, Wwt^Ii, Qxe^Ii, Qxe^Ii, Xue, Xue, Xue, Xue, Xue, Xue, Xue, Xue, Xue, Xue
Xue, Xue, Xue, Xue, Xue, Xue, Xue, Xue, Xue, Xue, Xue, Xue, Xue, Xue, Xue, Xue, Xue, Xue, Xue, Qxe, Qxe, Wwt^Ii, Re, Wwt^Ii, Qxe, Qxe, Xue, Xue, Xue, Xue, Xue, Xue, Xue, Xue, Xue, Xue, Xue
Xue, Xue, Xue, Xue, Xue, Xue, Xue, Xue, Xue, Xue, Xue, Xue, Xue, Xue, Xue, Xue, Xue, Xue, Xue, Xue, Xue, Uue^Ii, Re, Uue^Ii, Xue, Xue, Xue, Xue, Xue, Xue, Xue, Xue, Xue, Xue, Xue, Xue, Xue
Xue, Xue, Xue, Xue, Xue, Xue, Xue, Xue, Xue, Xue, Xue, Xue, Xue, Xue, Xue, Xue, Xue, Xue, Xue, Xue, Xue, Uue^Ii, Re, Uue^Ii, Xue, Xue, Xue, Xue, Xue, Xue, Xue, Xue, Xue, Xue, Xue, Xue, Xue
Xue, Xue, Xue, Xue, Xue, Xue, Xue, Xue, Xue, Xue, Xue, Xue, Xue, Xue, Xue, Xue, Xue, Xue, Xue, Xue, Xue, Uue^Ii, Re, Uue^Ii, Xue, Xue, Xue, Xue, Xue, Xue, Xue, Xue, Xue, Xue, Xue, Xue, Xue
Xue, Xue, Xue, Xue, Xue, Xue, Xue, Xue, Xue, Xue, Xue, Xue, Xue, Xue, Xue, Xue, Xue, Xue, Xue, Xue, Xue, Uue^Ii, Re, Uue^Ii, Xue, Xue, Xue, Xue, Xue, Xue, Xue, Xue, Xue, Xue, Xue, Xue, Xue
Xue, Xue, Xue, Xue, Xue, Xue, Xue, Xue, Xue, Xue, Xue, Xue, Xue, Xue, Uue, Xue, Uue, Xue, Xue, Xue, Uue^Ii, Uue^Ii, Re, Uue^Ii, Uue, Xue, Xue, Xue, Xue, Xue, Uue, Uue, Uue, Xue, Xue, Xue, Xue
Xue, Xue, Xue, Xue, Xue, Xue, Xue, Xue, Xue, Xue, Xue, Xue, Uue, Uue, Uue, Uue, Uue^Xo, Uue^Xo, Uue, Uue, Uue^Ii, Uue, 1 Re, Uue, Uue^Ii, Uue, Uue, Xue, Uue^Xo, Uue, Uue, Uue, Uue, Xue, Xue, Xue, Xue
Xue, Xue, Xue, Xue, Xue, Xue, Xue, Xue, Xue, Xue, Uue, Uue, Uue, Uue, Xue, Xue, Xue, Uue, Uue, Uue^Ii, Uue, Uue, Re, Uue, Uue, Uue^Ii, Uue^Ii, Uue, Uue^Xo, Uue, Uue, Uue, Uue, Xue, Xue, Xue, Xue
Xue, Xue, Xue, Xue, Xue, Xue, Xue, Xue, Xue, Xue, Uue, Uue, Xue, Xue, Xue, Xue, Xue, Xue, Uue^Ii, Uue^Ii, Uue, Uue, Re, Uue^Ii, Uue, Uue, Uue^Ii, Uue, Xue, Uue, Xue, Uue, Xue, Xue, Xue, Xue, Xue
Xue, Xue, Xue, Xue, Xue, Xue, Xue, Xue, Xue, Xue, Xue, Xue, Xue, Xue, Xue, Xue, Xue, Xue, Uue^Ii, Uue, Uue, Uue^Ii, Re, Uue^Ii, Uue^Ii, Uue^Ii, Uue, Uue, Xue, Xue, Xue, Xue, Xue, Xue, Xue, Xue, Xue
Xue, Xue, Xue, Xue, Xue, Xue, Xue, Xue, Xue, Xue, Xue, Xue, Xue, Xue, Xue, Xue, Xue, Uue, Uue, Uue^Ii, Uue, Uue^Ii, Re, Uue^Ii, Uue, Uue^Ii, Uue, Uue, Xue, Xue, Xue, Xue, Xue, Xue, Xue, Xue, Xue
