Xu, Xu, Xu, Xu, Xu, Xu, Xu, Xu, Xu, Xu, Xu, Xu, Xu, Xu, Xu, Xu, Xu, Xu, Xu, Xu, Uu, Uu, Uu, Ur, Uu, Uu, Uu, Xu, Xu, Xu, Xu, Xu, Xu, Xu, Xu, Xu, Xu, Xu, Xu, Xu, Xu, Xu, Xu
Xu, Xu, Xu, Xu, Xu, Xu, Xu, Xu, Xu, Xu, Xu, Xu, Xu, Xu, Xu, Xu, Xu, Xu, Xu, Xu, Uu, Uu, Uu, Ur, Uu, Uu, Uu, Xu, Xu, Xu, Xu, Xu, Xu, Xu, Xu, Xu, Xu, Xu, Xu, Xu, Xu, Xu, Xu
Uu, Uh, Uh, Xu, Xu, Xu, Xu, Xu, Xu, Xu, Xu, Xu, Xu, Xu, Xu, Xu, Xu, Xu, Xu, Xu, Uu, Uu^Vud, Uu, Ur, Uu, Uu^Vud, Uu, Xu, Xu, Xu, Uu, Xu, Xu, Xu, Xu, Xu, Xu, Xu, Wwg, Wwg, Wwg, Xu, Xu
Uu, Uu^Uf, Uu^Uf, Xu, Xu, Xu, Xu, Xu, Xu, Xu, Xu, Xu, Xu, Xu, Xu, Xu, Xu, Xu, Xu, Uu, Xu, Uu, Uu, Ur, Uu, Uu, Xu, Uu, Uu, Uu, Xu, Uu^Vud, Xu, Xu, Xu, Xu, Xu, Xu, Wwg, Wwg, Wwg, Wwg, Xu
Uu, Uu^Uf, Uu^Uf, Uu^Uf, Xu, Xu, Xu, Xu, Xu, Xu, Xu, Xu, Xu, Xu, Xu, Xu, Xu, Xu, Xu, Uu, Xu, Uu, Uu, Ur, Uu, Uu, Xu, Xu, Uu, Xu, Xu, Uu, Xu, Xu, Xu, Xu, Xu, Xu, Xu, Wwg, Wwg, Wwg, Xu
Uu, Ur, Ur, Uu, Uu, Xu, Xu, Xu, Uu^Uf, Uu^Vu, Uu^Uf, Uu, Uu, Xu, Xu, Xu, Xu, Xu, Xu, Uu, Uu, Uu, Cud, Cud, Cud, Uu, Xu, Uu, Xu, Xu, Uu, Uu, Uh, Xu, Xu, Xu, Xu, Xu, Wwg, Wwg, Xu, Xu, Xu
Uu^Uf, Uu^Uf, Uu^Uf, Ur, Uu, Uh, Uh, Uh, Uu, Uu^Uf, Uh, Uu^Uf, Uu, Uu, Uu, Xu, Xu, Xu, Xu, Xu, Uu, Uu, Cud, 2 Kud, Cud, Uu, Xu, Uu, Xu, Xu, Uu, Uu^Uf, Uu^Uf, Xu, Xu, Xu, Xu, Xu, Wwg, Xu, Xu, Xu, Xu
Xu, Uh, Uh, Uu^Uf, Ur, Uu^Uf, Uu^Uf, Uu^Uf, Uu, Xu, Xu, Xu, Xu, Uu, Uu, Xu, Xu, Xu, Xu, Uu, Uu, Uu, Uu, Cud, Uu, Uu, Uu, Uu, Xu, Xu, Xu, Uu, Uu, Uu, Uu, Uh, Uh, Xu, Wwg, Xu, Xu, Xu, Xu
Xu, Xu, Xu, Uu^Uf, Uu, Ur, Uu, Qxu, Qxu, Uu, Uu, Xu, Xu, Xu, Uu, Uh, Xu, Xu, Xu, Uu, Xu, Xu, Cud, Uu, Cud, Uu, Cud, Cud, Uu, Xu, Xu, Xu, Xu, Uu, Uu, Uu, Uu, Uh, Wwg, Xu, Xu, Xu, Uh
Xu, Xu, Xu, Xu, Uu, Ur, Ur, Qxu, Uu, Uu, Qxu, Uu, Uu, Xu, Xu, Uu, Uu, Xu, Xu, Uu, Xu, Uu, Uu, Cud, Uu, Uu, Uu, Ur, Uu, Uu^Vud, Xu, Xu, Xu, Xu, Xu, Uu^Vud, Wwg, Wwg, Uh, Uu, Uu^Uf, Uh, Uh
Xu, Xu, Xu, Xu, Uu^Uf, Uu, Xu, Ur, Uu, Qxu, Qxu, Uu, Ur, Uu^Vud, Uu, Uu, Qxu, Uu, Uu, Uu, Uu, Uu, Ur, Ur, Uu, Uu, Uu, Ur, Ur, Uu, Uu, Xu, Xu, Xu, Xu, Uh, Wwg, Uh, Uh, Uu, Uu^Uf, Uh, Xu
Xu, Xu, Xu, Uh, Uu^Uf, Uu, Xu, Ur, Ur, Ur, Ur, Ur, Uu, Uu, Ur, Qxu, Ur, Qxu, Qxu, Uu, Ur, Ur, Uu, Uu, Uu, Uu, Uu, Uu, Ur, Uu, Uu^Uf, Uu, Uu, Xu, Wwg, Wwg, Uu, Uu^Uf, Uu, Uu, Xu, Xu, Xu
Xu, Xu, Xu, Xu, Uu, Uu, Xu, Uu, Xu, Uu, Uu, Uu, Uu, Xu, Xu, Ur, Xu, Ur, Uu, Ur, Uu, Xu, Xu, Uu, Xu, Uu, Xu, Xu, Ur, Uh, Uh, Uu^Uf, Uu, Uu, Wwg, Uu, Xu, Uu, Uu, Uu^Uf, Uh, Xu, Xu
Xu, Xu, Xu, Xu, Xu, Uu, Uu, Xu, Xu, Xu, Xu, Uu, Uu, Xu, Xu, Xu, Uu, Ur, Uu, Uu, Qxu, Uu, Uu, Xu, Uu, Xu, Xu, Ur, Ur, Uh, Uh, Uh, Wwg, Wwg, Xu, Xu, Uu^Vu, Uu, Uu, Uu^Uf, Xu, Xu, Xu
Xu, Xu, Xu, Xu, Xu, Xu, Xu, Uu, Uu, Uu^Vu, Xu, Uu, Uu, Uu, Uu, Uu, Uu, Uu, Xu, Ur, Uu^Vu, Qxu, Qxu, Uu, Uu, Uu, Uu, Ur, Ur, Uu^Uf, Wwg, Wwg, Xu, Xu, Xu, Xu, Uu, Uu, Uu^Uf, Uh, Xu, Xu, Xu
Xu, Xu, Xu, Xu, Xu, Xu, Xu, Uu, Uu, Xu, Uu, Uu, Uh, Uh, Uu, Uu, Xu, Xu, Ur, Ur, Uu, Qxu, Uu, Uu, Uu, Uu, Uh, Uu, Wwf, Wwf, Xu, Xu, Xu, Xu, Uu^Uf, Uu, Uu, Uu^Uf, Xu, Xu, Xu, Xu, Xu
Xu, Xu, Xu, Xu, Xu, Xu, Uu^Uf, Uu, Xu, Uu, Uu, Uu, Uu, Uu^Uf, Uu, Xu, Uu, Xu, Ur, Uu, Xu, Uu, Xu, Uu, Uu^Uf, Uh, Wwg, Wwg, Uh, Ur, Xu, Xu, Uh, Uu^Uf, Uu, Uu, Xu, Xu, Xu, Xu, Xu, Xu, Xu
Xu, Xu, Xu, Xu, Xu, Uh, Uu^Uf, Uu^Uf, Xu, Xu, Xu, Xu, Uu, Uu, Qxu, Uu, Uu, Ur, Uu, Xu, Uu^Vud, Xu, Uu, Uu, Uu^Uf, Xu, Wwg, Uh, Uh, Uu, Xu, Xu, Xu, Uu, Uu, Xu, Xu, Xu, Xu, Xu, Xu, Xu, Xu
Xu, Xu, Xu, Xu, Xu, Uh, Uu^Uf, Uu^Uf, Uu, Xu, Xu, Xu, Uu, Uu^Vu, Qxu, Qxu, Qxu, Ur, Ur, Xu, Uu, Uu, Uu, Uu, Wwg, Wwg, Uu^Uf, Uh, Uu, Ur, Uu, Xu, Uh, Uu, Qxu, Uu, Uu, Xu, Xu, Xu, Xu, Xu, Xu
Xu, Xu, Xu, Xu, Xu, Xu, Xu, Uu, Uu, Uu, Uu, Uu, Uu^Uf, Uu, Uu, Qxu, Uu, Uu, Uu, Ur, Wwf, Wwg, Wwg, Wwg, Xu, Xu, Uu, Uu, Xu, Ur, Uu, Uh, Qxu, Qxu, Qxu, Uu^Vu, Uu, Uu, Uu, Uu, Uh, Xu, Uh
Xu, Xu, Xu, Xu, Xu, Xu, Xu, Uh, Uu^Uf, Uu, Uu, Uu^Uf, Uu^Uf, Uu, Xu, Uu, Xu, Uu, Qxu, Wwf, Ur, Xu, Wwg, Uu^Uf, Uu^Uf, Uu, Uu, Xu, Ur, Ur, Qxu, Ur, Ur, Qxu, Uu, Uu, Cte, Uu, Cte, Uu, Uu, Uh, Uu^Uf
Uu, Uu, Uh, Xu, Xu, Xu, Uu^Vud, Uu^Uf, Cud, Uu, Xu, Uu, Uu, Uu, Uu, Xu, Uu, Uu, Uu^Vud, Qxu, Ur, Xu, Uu, Wwg, Uu, Uu, Xu, Xu, Ur, Qxu, Qxu, Qxu, Uh, Ur, Ur, Cte, Uu, Cte, 4 Kte, Cte, Ur, Uu, Uu
Ur, Uu, Uu^Uf, Uh, Uu, Uu, Uu, Cud, Uu, Cud, Uu, Uu, Xu, Uu, Uu, Uu, Uu, Uu, Qxu, Qxu, Ur, Xu, Ur, Wwg, Ur, Xu, Ur, Ur, Qxu, Qxu, Uu^Uf, Uu^Uf, Uh, Uu, Uu, Cte, Cte, Cte, Cte, Cte, Uu, Ur, Ur
Uu, Ur, Ur, Uu, Uu, Cud, Cud, Cud, Cud, Cud, Ur, Uu, Ur, Uu, Uu, Xu, Uu, Wwg, Qxu, Uh, Uu, Ur, Ur, Wwf, Wwg, Ur, Uu, Uu, Uu, Uu^Vu, Uu, Uu, Uu, Uu, Uu, Uu, Cte, Uu, Cte, Uu, Uu^Uf, Uu, Uu
Uu, Uu, Uu, Ur, Ur, Ur, Cud, 3 Kud, Cud, Ur, Uu, Ur, Xu, Ur, Ur, Uu, Xu, Wwg, Wwg, Uu, Xu, Uu, Ur, Xu, Xu, Wwg, Xu, Uu, Qxu, Uu, Xu, Xu, Xu, Uu^Vu, Uu, Ur, Uu, Cte, Uu, Uu^Uf, Uh, Uh, Uh
Xu, Uu^Vud, Uu^Uf, Uu^Uf, Uh, Cud, Uu, Cud, Uu, Cud, Uu, Uu, Uu, Uu, Qxu, Ur, Ur, Uu, Wwg, Xu, Uu, Xu, Ur, Xu, Wwg, Wwg, Xu, Uu, Qxu, Uu, Uu, Uu^Vud, Xu, Uu, Ur, Ur, Xu, Uu, Xu, Uu^Uf, Xu, Uh, Xu
Xu, Xu, Xu, Uh, Xu, Uh, Uu, Cud, Cud, Cud, Xu, Uu, Qxu, Qxu, Uu, Qxu, Uu, Ur, Wwf, Uu, Xu, Uu, Ur, Wwg, Uh, Wwg, Wwg, Uu, Uh, Qxu, Qxu, Uu, Uu, Ur, Xu, Xu, Xu, Xu, Xu, Xu, Xu, Xu, Xu
Xu, Xu, Xu, Xu, Xu, Xu, Xu, Uu, Uu^Uf, Uu^Uf, Uu^Uf, Uu, Uu^Vud, Uu, Xu, Uu, Uu, Wwf, Ur, Uu, Ur, Ur, Xu, Wwg, Wwg, Uh, Wwg, Uu, Xu, Uh, Qxu, Qxu, Qxu, Ur, Uu, Xu, Xu, Xu, Xu, Xu, Xu, Xu, Xu
Xu, Xu, Xu, Xu, Xu, Xu, Xu, Xu, Uh, Uh, Uh, Uu^Uf, Xu, Xu, Xu, Xu, Uu, Wwg, Ur, Ur, Uu, Uu, Uu, Xu, Wwg, Uh, Wwg, Xu, Xu, Uu^Uf, Ur, Qxu, Ur, Ur, Uu, Uu, Uu, Xu, Uu, Xu, Xu, Xu, Xu
Xu, Xu, Xu, Xu, Xu, Xu, Xu, Xu, Xu, Xu, Xu, Xu, Xu, Xu, Xu, Xu, Wwg, Wwg, Ur, Uu, Qxu, Wwg, Wwg, Wwg, Xu, Uu, Uu, Wwg, Uu, Ur, Xu, Uu, Xu, Xu, Xu, Uu, Xu, Uu, Uu, Uu, Xu, Xu, Xu
Xu, Xu, Xu, Xu, Xu, Xu, Xu, Xu, Xu, Xu, Xu, Xu, Xu, Xu, Uu, Uu, Wwg, Xu, Ur, Wwg, Qxu, Qxu, Uu^Vu, Uu, Uu, Xu, Uu, Wwg, Uu, Ur, Uu, Xu, Uu, Uu, Uu, Xu, Xu, Xu, Uu, Uu, Xu, Xu, Xu
Xu, Xu, Xu, Xu, Xu, Xu, Xu, Xu, Uh, Xu, Uu^Uf, Xu, Uu^Vu, Uu, Uu, Wwg, Xu, Uu, Wwf, Wwg, Qxu, Qxu, Qxu, Uu, Uu, Xu, Wwg, Wwg, Qxu, Ur, Ur, Uu, Uu, Ur, Ur, Uu, Uu, Xu, Uu, Uu, Uu, Xu, Uu
Xu, Xu, Xu, Xu, Xu, Xu, Xu, Uh, Uh, Uu^Uf, Uu, Uu, Uu, Uu, Xu, Wwg, Wwg, Wwf, Ur, Uu, Uu, Qxu, Qxu, Uu, Uu, Uu, Qxu, Qxu, Qxu, Qxu, Uu, Ur, Ur, Xu, Uu, Ur, Ur, Uu, Cud, Uu, Uu, Uu^Vu, Ur
Xu, Xu, Xu, Xu, Xu, Xu, Xu, Uu^Uf, Kud, Cud, Uu, Uu, Xu, Uu, Wwg, Wwg, Uu, Uu, Xu, Ur, Uu, Qxu, Uu, Uu, Qxu, Qxu, Qxu, Qxu, Qxu, Qxu, Qxu, Uu, Ur, Uu, Xu, Uu, Uu, Cud, Kud, Ur, Ur, Ur, Uu
Xu, Xu, Xu, Xu, Xu, Xu, Uu, Uu, Uu^Uf, Cud, Uu, Xu, Uu^Uf, Wwg, Xu, Xu, Uu, Uu, Uu, Ur, Ur, Uu, Uu, Uu, Uu, Qxu, Uu, Uu, Uu, Qxu, Ur, Ur, Qxu, Uu, Xu, Uu, Uu, Cud, Uu, Uu, Uu, Uu, Uu
Xu, Xu, Xu, Xu, Uu^Uf, Uu^Vu, Uu^Uf, Uh, Uh, Uu^Uf, Uu, Xu, Wwg, Wwg, Xu, Uu^Uf, Uu, Xu, Uu, Uu, Uu^Uf, Ur, Ur, Uu, Xu, Uu, Xu, Uu, Ur, Ur, Qxu, Qxu, Uu, Uu, Uu, Xu, Uu, Uu, Xu, Uu, Uu, Uu, Xu
Xu, Xu, Xu, Xu, Uu^Uf, Uu, Uu^Uf, Uh, Uu^Uf, Uu, Uu, Uu, Wwg, Xu, Uu^Vud, Uu, Uu, Xu, Uu, Uu^Uf, Uh, Uu^Uf, Ur, Xu, Xu, Xu, Xu, Xu, Ur, Qxu, Uu, Uu, Uu, Uu, Uu, Uu, Uu, Xu, Xu, Xu, Uu, Uu, Xu
Xu, Xu, Xu, Xu, Xu, Uu, Uu, Uu^Uf, Uu, Uu, Xu, Uu, Wwg, Xu, Uu, Uu, Uu, Uu, Xu, Uh, Xu, Uh, Uu^Uf, Ur, Ur, Xu, Xu, Xu, Xu, Ur, Uu^Uf, Xu, Xu, Xu, Uu, Uu, Uu, Xu, Xu, Xu, Uu, Uu, Xu
Xu, Xu, Xu, Xu, Xu, Xu, Xu, Uu^Vud, Uh, Uh, Xu, Uu^Uf, Wwg, Uu^Uf, Uu^Uf, Uu^Uf, Uu^Uf, Uu, Xu, Xu, Xu, Uh, Uu^Uf, Uu, Ur, Xu, Xu, Xu, Ur, Ur, Xu, Xu, Xu, Xu, Xu, Uu, Uu^Vu, Uu, Uu, Uu, Uu^Vu, Xu, Xu
Xu, Xu, Xu, Xu, Xu, Xu, Xu, Xu, Xu, Xu, Xu, Uh, Wwg, Uh, Uh, Uh, Xu, Xu, Xu, Xu, Xu, Uu^Uf, Ur, Ur, Uu, Uu, Uu, Ur, Uu^Vu, Uu, Xu, Xu, Xu, Xu, Xu, Xu, Xu, Xu, Xu, Uu, Xu, Xu, Xu
Xu, Xu, Xu, Xu, Xu, Xu, Xu, Xu, Xu, Xu, Xu, Xu, Wwg, Uh, Xu, Xu, Xu, Xu, Xu, Xu, Uu^Uf, Ur, Xu, Xu, Xu, Xu, Xu, Ur, Ur, Uu, Uh, Xu, Xu, Xu, Xu, Xu, Xu, Xu, Xu, Xu, Xu, Xu, Xu
Xu, Xu, Xu, Xu, Xu, Xu, Xu, Xu, Xu, Xu, Xu, Xu, Wwg, Xu, Xu, Xu, Xu, Xu, Xu, Xu, Uu, Ur, Xu, Xu, Xu, Xu, Xu, Uu, Ur, Uu^Uf, Uh, Xu, Xu, Xu, Xu, Xu, Xu, Xu, Xu, Xu, Xu, Xu, Xu
Xu, Xu, Xu, Xu, Xu, Xu, Xu, Xu, Xu, Xu, Wwg, Wwg, Xu, Xu, Xu, Xu, Xu, Xu, Xu, Uu^Uf, Uu, Ur, Uu, Uu^Vu, Uu, Xu, Xu, Xu, Ur, Uu^Uf, Xu, Xu, Xu, Xu, Xu, Xu, Xu, Xu, Xu, Xu, Xu, Xu, Xu
Xu, Xu, Xu, Xu, Xu, Wwg, Wwg, Xu, Wwg, Wwg, Xu, Xu, Xu, Xu, Xu, Xu, Xu, Xu, Xu, Xu, Xu, Ur, Ur, Uu, Uu^Cov, Uu, Uu, Xu, Ur, Uu, Xu, Xu, Xu, Xu, Xu, Xu, Xu, Xu, Xu, Xu, Xu, Xu, Xu
Xu, Xu, Xu, Xu, Xu, Wwg, Wwg, Wwg, Xu, Xu, Xu, Xu, Xu, Xu, Xu, Xu, Xu, Xu, Xu, Xu, Xu, Uu, Uu, Ur^Kov, 1 Uu^Kov, Uu^Cov, Ur, Ur, Uu, Uu^Vu, Xu, Xu, Xu, Xu, Xu, Xu, Xu, Xu, Xu, Xu, Xu, Xu, Xu
Xu, Xu, Xu, Xu, Xu, Xu, Xu, Wwg, Xu, Xu, Xu, Xu, Xu, Xu, Xu, Xu, Xu, Xu, Xu, Xu, Xu, Uh, Uu, Ur^Cov, Ur^Cov, Ur^Cov, Uu, Uu, Uh, Xu, Xu, Xu, Xu, Xu, Xu, Xu, Xu, Xu, Xu, Xu, Xu, Xu, Xu
Xu, Xu, Xu, Xu, Xu, Xu, Xu, Xu, Xu, Xu, Xu, Xu, Xu, Xu, Xu, Xu, Xu, Xu, Xu, Xu, Uh, Uh, Uu, Uu, Ur, Uu, Uu, Uu, Uh, Xu, Xu, Xu, Xu, Xu, Xu, Xu, Xu, Xu, Xu, Xu, Xu, Xu, Xu
Xu, Xu, Xu, Xu, Xu, Xu, Xu, Xu, Xu, Xu, Xu, Xu, Xu, Xu, Xu, Xu, Xu, Xu, Xu, Xu, Uu, Uh, Uu, Uu, Ur, Uu, Uu, Uh, Uh, Uh, Xu, Xu, Xu, Xu, Xu, Xu, Xu, Xu, Xu, Xu, Xu, Xu, Xu
