Xu, Xoi, Ms^Xm, Ms^Xm, Mm, Hh^Fp, Hh^Fp, Hh^Fp, Hh^Fp, Hh^Fp, Gll^Fp, Aa, Gll, Aa, Aa^Fpa, Hh^Fp, Hh^Fp, Hh^Fp, Hh^Fp, Hh^Fp, Mm, Ms, Ms^Xm, Ms^Xm, Ms^Xm, Ms^Xm, Xu, Xoi, Xoi, Xoi, Xoi, Xoi, Xoi, Xoi, Xoi, Xoi, Xoi
Xoi, Xu, Xu, Ms^Xm, Ms^Xm, Mm, Mm, Mm, Mm, Mm, Aa^Fpa, Aa, Gll, Aa, Gll^Fp, Mm, Mm, Hh^Fp, Mm, Mm, Ms^Xm, Ms^Xm, Xu, Ms^Xm, Xu, Xu, Xoi, Xoi, Xoi, Xoi, Xoi, Xoi, Xoi, Xoi, Xoi, Xoi, Xoi
Xoi, Xoi, Xoi, Xu, Xu, Ms^Xm, Ms^Xm, Ms^Xm, Ms^Xm, Ms^Xm, Gll^Fp, Aa^Fpa, Gll, Aa^Fpa, Aa^Fpa, Ms^Xm, Ms^Xm, Mm, Ms^Xm, Ms^Xm, Xu, Ms^Xm, Xu, Xu, Xoi, Xoi, Xoi, Xoi, Xoi, Xoi, Xoi, Xoi, Xoi, Xoi, Xoi, Xoi, Xoi
Xoi, Xoi, Xoi, Xoi, Xoi, Xu, Xu, Xu, Xu, Xu, Aa, Gll, Gll, Aa, Aa, Xu, Xu, Ms^Xm, Xu, Xu, Xoi, Xu, Xoi, Xoi, Xoi, Xoi, Xoi, Xoi, Xoi, Xu, Xu, Xu, Xu, Xu, Xoi, Xoi, Xoi
Xoi, Xoi, Xoi, Xoi, Xoi, Xoi, Xoi, Xoi, Xoi, Xu, Aa, Uu, Aa, Uu, Gll, Xu, Xoi, Xu, Xoi, Xoi, Xoi, Xoi, Xoi, Xoi, Xoi, Xoi, Xoi, Xoi, Xu, Xu, Wwg, Wwg, Wwg, Xu, Xu, Xoi, Xoi
Xoi, Xoi, Xoi, Xoi, Xoi, Xoi, Xoi, Xoi, Xoi, Xu, Aa, Uu, Irs, Aa, Uue, Xu, Xoi, Xoi, Xoi, Xoi, Xoi, Xoi, Xoi, Xoi, Xoi, Xoi, Xoi, Xu, Xu, Wwg, Wwg, Wwg, Wwg, Wwg, Wwg, Xu, Xoi
Xoi, Xoi, Xoi, Xoi, Xoi, Xoi, Xoi, Xoi, Xoi, Xu, Uue, Aa, Irs, Uue, Uue, Xu, Xoi, Xoi, Xoi, Xoi, Xoi, Xoi, Xoi, Xoi, Xoi, Xoi, Xu, Xu, Xu, Wwg, Wwg, Wwg, Wwg, Wwg, Xu, Xu, Xoi
Xoi, Xoi, Xoi, Xoi, Xoi, Xoi, Xoi, Xoi, Xoi, Xoi, Cud, Uue, Irs, Uue, Cud, Xoi, Xoi, Xoi, Xoi, Xoi, Xoi, Xoi, Xoi, Xoi, Xoi, Xoi, Xu, Xu, Wwg, Wwg, Xu, Wwg, Xu, Xu, Xoi, Xu, Xoi
Xoi, Xoi, Xoi, Xoi, Xoi, Xoi, Xoi, Xoi, Xoi, Xoi, Kud, Uue, Irs, Uue, Kud, Xoi, Xoi, Xoi, Xoi, Xoi, Xoi, Xoi, Xoi, Xoi, Xu, Xu, Wwg, Wwg, Xu, Xu, Xoi, Xu, Xoi, Xoi, Xoi, Xoi, Xoi
Xoi, Xoi, Xoi, Xoi, Xoi, Xoi, Xoi, Xoi, Uue, Cud, Uue, Uue, Irs, Uue, Uue, Cud, Uue, Xoi, Uue, Uue, Uue, Uu^Vud, Xoi, Xoi, Xu, Wwg, Xu, Xu, Xoi, Xoi, Xoi, Xoi, Xoi, Xoi, Xoi, Xoi, Xoi
Xoi, Xoi, Xoi, Xoi, Xoi, Xoi, Uue, Uue, Uue, Uue, Uue, Uue, Irs, Uue, Uue, Uue, Uue, Uue, Xoi, Xoi, Xoi, Uue, Uue, Xoi, Xu, Wwg, Xu, Xoi, Xoi, Xoi, Xoi, Xoi, Xoi, Xoi, Xoi, Xoi, Xoi
Xoi, Xoi, Xoi, Xoi, Uue, Uue, Uue^Ii, Uue, Rb^Gvs, Uu^Vud, Uue^Ii, Uue, Irs, Uue, Uue, Uue, Uue, Xoi, Uue, Uu^Vud, Uue, Xoi, Uue, Uue, Wwg, Wwg, Xu, Xoi, Xoi, Xoi, Xoi, Xoi, Xoi, Xoi, Xoi, Xoi, Xoi
Xoi, Xoi, Xoi, Xoi, Uue, Uue^Ii, Rb^Gvs, Rb^Gvs, Wwg^Ii, Rb^Gvs, Rb^Gvs, Uue^Ii, Irs, Uue, Uue, Uue^Ii, Uue^Ii, Uue, Uue, Uue, Uue, Uue, Uue, Wwg, Wwg, Wwg, Urb, Uu^Vud, Urb, Xoi, Xoi, Xoi, Xoi, Xoi, Xoi, Xoi, Xoi
Xoi, Xoi, Xoi, Xoi, Xoi, Uue^Ii, Rb^Gvs, Wwg^Ii, Wwg^Ii, Wwg^Ii, Rb^Gvs, Uue^Ii, Uue, Irs, Irs, Uue, Uue^Ii, Uue^Ii, Xoi, Xoi, Xoi, Uue, Uue, Wwg, Wwg, Urb, Xoi, Xoi, Urb, Xoi, Xoi, Xoi, Xoi, Xoi, Xoi, Xoi, Xoi
Xoi, Xoi, Xoi, Xoi, Xoi, Uue^Ii, Rb^Gvs, Wwg^Ii, Wwg, Wwg, Wwg^Ii, Rb^Gvs, Uue^Ii, Uue, Uue, Irs, Uue, Uue^Ii, Uue, Xoi, Uue, Uue, Wwg, Wwg, Wwg^Ii, Urb, Urb, Xoi, Urb, Xoi, Xoi, Xoi, Xoi, Xoi, Xoi, Xoi, Xoi
Xoi, Xoi, Xoi, Xoi, Xoi, Rb^Gvs, Wwg^Ii, Wwg, Wwg, Wwg, Wwg^Ii, Rb^Gvs, Uue^Ii, Uue, Uue, Irs, Uue, Uue^Ii, Uue, Uue, Wwg, Wwg, Wwg, Wwg, Urb^Ii, Uu^Ufi, Uu^Uf, Urb, Urb, Xoi, Xoi, Xoi, Xoi, Xoi, Xoi, Xoi, Xoi
Xoi, Xoi, Xoi, Xoi, Xoi, Rb^Gvs, Wwg^Ii, Wwg, Rb^Gvs, Wwg^Ii, Rb^Gvs, Rb^Gvs, Rb^Gvs, Uue^Ii, Uue, Irs, Uue, Uue, Xoi, Xoi, Wwg, Wwg, Urb, Urb, Urb, Uu^Ufi, Urb, Urb, Urb, Xoi, Xoi, Xoi, Xoi, Xoi, Xoi, Xoi, Xoi
Xoi, Xoi, Xoi, Xoi, Xoi, Rb^Gvs, Rb^Gvs, Wwg^Ii, Rb^Gvs, Wwg^Ii, Wwg, Rb^Gvs, Rb^Gvs, Uue^Ii, Uue, Irs, Uue, Uue, Wwg, Wwg, Wwg, Wwg, Uu^Uf, Urb^Ii, Xoi^Efs, Urb, Urb, Xoi^Efs, Xoi, Urb, Xoi, Xoi, Xoi, Xoi, Xoi, Xoi, Xoi
Xoi, Xoi, Xoi, Xoi, Xoi, Uue^Ii, Uue^Ii, Rb^Gvs, Rb^Gvs, Rb^Gvs, Wwg, Rb^Gvs, Rb^Gvs, Uue, Uue, Irs, Wwg^Bsb|, Wwg, Wwg, Wwg, Urb, Uu^Uf, Uu^Ufi, Urb, Urb, Urb, Urb^Ii, Uu^Vud, Xoi, Urb, Xoi, Xoi, Xoi, Xoi, Xoi, Xoi, Xoi
Xoi, Xoi, Xoi, Xoi, Xoi, Uue, Uue^Ii, Rb^Gvs, Wwg, Wwg, Wwg, Wwg^Ii, Wwg, Wwg, Wwg, Wwg, Wwg^Bsb|, Wwg, Urb, Urb, Xoi, Xoi, Urb^Ii, Urb, Xoi^Efs, Uh^Ii, Uu^Ufi, Urb, Xoi^Efs, Urb, Xoi, Xoi, Xoi, Xoi, Xoi, Xoi, Xoi
Xoi, Xoi, Xoi, Xoi, Xoi, Uue, Wwg, Wwg, Wwg, Wwg, Wwg^Ii, Wwg^Ii, Wwg, Wwg, Wwg, Wwg, Irs, Urb, Urb, Xoi^Efs, Xoi^Efs, Uu^Vud, Urb, Urb, Urb, Uh, Urb, Urb^Ii, Urb^Ii, Urb, Urb, Xoi, Xoi, Xoi, Xoi, Xoi, Xoi
Xoi, Xoi, Xoi, Xoi, Xoi, Uue, Wwg, Wwg, Wwg, Xoi, Xoi, Xoi, Urb^Ii, Wwg, Wwg, Wwg, Xoi, Irs, Irs, Uu^Vud, Xoi, Urb, Urb^Ii, Xoi^Efs, Urb, Urb, Xoi, Urb, Urb^Ii, Xoi, Urb, Xoi, Xoi, Xoi, Xoi, Xoi, Xoi
Xoi, Xoi, Xoi, Xoi, Uu^Vud, Uue, Uue, Wwg, Wwg, Wwg, Wwg, Urb, Xoi^Efs, Urb, Wwg, Wwg, Xoi, Xoi, Uh, Irs, Uh, Xoi^Efs, Urb^Ii, Urb, Urb, Uu^Vud, Xoi^Efs, Urb, Urb, Xoi, Urb, Xoi, Xoi, Xoi, Xoi, Xoi, Xoi
Xoi, Xoi, Xoi, Xoi, Uue, Uue, Xoi, Xoi, Xoi, Wwg, Wwg, Urb, Urb, Urb, Wwg, Wwg^Ii, Wwg^Ii, Xoi, Uh, Irs, Irs, Uh, Urb^Ii, Urb, Xoi, Xoi^Efs, Urb, Urb, Urb, Xoi^Efs, Urb, Xoi, Xoi, Xoi, Xoi, Xoi, Xoi
Xoi, Xoi, Xu, Xu, Wwg, Wwg, Wwg, Xoi, Wwg, Wwg, Wwg, Urb, Xoi^Efs, Urb, Urb, Wwg, Wwg^Ii, Wwg^Ii, Wwg^Bsb/, Irs, Urb, Irs, Irs, Urb, Urb^Ii, Urb, Xoi, Uu^Vud, Xoi, Urb, Urb, Xoi, Xoi, Xoi, Xoi, Xoi, Xoi
Xoi, Xu, Wwg, Wwg, Xu, Wwg, Wwg, Wwg, Wwg, Wwg, Uu^Vud, Urb, Urb, Urb, Urb, Xoi^Efs, Urb, Wwg^Bsb/, Wwg^Ii, Wwg^Ii, Wwg, Urb, Irs, Urb^Ii, Urb^Ii, Urb, Urb, Xoi^Efs, Uu^Vud, Xoi, Urb, Xoi, Xoi, Xoi, Xoi, Xoi, Xoi
Xoi, Xu, Wwg, Wwg, Xu, Xu, Urb, Wwg, Xoi, Xoi^Efs, Urb, Urb, Urb^Cov, Urb^Cov, Urb^Kov, Urb, Urb, Xoi^Efs, Wwg, Wwg^Ii, Uu^Vud, Wwg, Wwg, Irs, Irs, Urb, Wwg, Urb, Wwg, Urb, Urb, Xoi, Xoi, Xoi, Xoi, Xoi, Xoi
Xoi, Xu, Wwg, Xu, Xu, Xoi, Uu^Vud, Urb, Urb, Urb, Urb, Urb, Urb^Cov, 1 Urb^Kov, Urb^Cov, Urb, Uu^Vud, Urb, Wwg, Wwg, Uh, Uh, Uh, Wwg, Wwg, Wwg^Bsb\, Cud, Wwg, Cud, Wwg, Wwg, Xoi, Xoi, Xoi, Xoi, Xoi, Xoi
Xoi, Xu, Wwg, Xu, Xu, Xoi, Xoi, Xoi, Xoi, Urb, Uu^Vud, Urb, Urb, Urb^Cov, Urb, Urb, Urb, Xoi^Efs, Wwg, Wwg, Uh, Xoi, Xoi^Efs, Uu^Uf, Wwg, Cud, Uu^Vud, Kud, Uu^Vud, Cud, Wwg, Xoi, Xoi, Xoi, Xoi, Xoi, Xoi
Xoi, Xu, Wwg, Wwg, Wwg, Xu, Xu, Xoi, Xoi, Xoi, Xoi, Urb, Urb, Urb, Urb, Xoi^Efs, Urb, Urb, Wwg, Wwg, Uh, Xoi^Efs, Uu^Uf, Wwg, Cud, Kud, Cud, Cud, Cud, Kud, Cud, Wwg, Uh, Xoi, Xoi, Xoi, Xoi
Xoi, Xu, Wwg, Wwg, Wwg, Wwg, Xu, Xoi, Xoi, Xoi, Xoi, Urb, Urb, Xoi^Efs, Urb, Urb, Wwg, Wwg, Wwg, Wwg, Urb, Uh, Urb, Wwg, Cud, Uu^Vud, Cud, 2 Kud, Cud, Uu^Vud, Cud, Wwg, Uu^Uf, Xoi, Xoi, Xoi, Xoi
Xoi, Xu, Xu, Wwg, Wwg, Wwg, Xu, Xoi, Xoi, Xoi, Xoi, Urb, Urb, Urb, Wwg, Wwg, Wwg, Wwg, Urb, Urb, Urb, Urb, Urb, Wwg, Wwg, Kud, Uu^Vud, Cud, Uu^Vud, Kud, Wwg^Bsb\, Wwg, Urb, Xoi, Xoi, Xoi, Xoi
Xoi, Xu, Xu, Xu, Xu, Xu, Xoi, Xoi, Xoi, Xoi, Xoi, Xoi, Urb, Urb, Wwg, Wwg, Uh, Uh, Uu^Uf, Urb, Uu^Uf, Uh, Uu^Uf, Urb, Wwg, Cud, Cud, Kud, Cud, Cud, Wwg^Bsb\, Irs, Uu^Vud, Xoi, Uh, Xoi, Uue
Xoi, Xoi, Xoi, Xu, Xoi, Xoi, Xoi, Xoi, Xoi, Xoi, Xoi, Xoi, Xoi, Xoi, Xu, Wwg, Uh, Xoi^Efs, Uu^Uf, Urb, Urb, Uu^Uf, Urb, Urb, Urb, Wwg, Wwg, Wwg, Wwg, Wwg^Bsb\, Irs, Irs, Irs, Uu^Uf, Irs, Uu^Uf, Irs
Xoi, Xoi, Xoi, Xoi, Xoi, Xoi, Xoi, Xoi, Xoi, Xoi, Xoi, Xoi, Xoi, Xu, Wwg, Wwg, Xu, Uu^Uf, Xoi, Urb, Xoi, Urb, Uu^Vud, Urb, Uu^Uf, Urb, Urb, Urb, Urb, Urb, Urb, Irs, Irs, Irs, Irs, Irs, Irs
Xoi, Xoi, Xoi, Xoi, Xoi, Xoi, Xoi, Xoi, Xoi, Xoi, Xoi, Xoi, Xu, Xu, Wwg, Xu, Xoi, Xoi, Xoi, Xoi, Xoi, Xoi, Urb, Uu^Uf, Uu^Uf, Urb, Urb, Urb, Urb, Urb, Uu^Uf, Uu^Uf, Uu^Uf, Irs, Urb, Irs, Uue
Xoi, Xoi, Xoi, Xoi, Xoi, Xoi, Xoi, Xoi, Xoi, Xoi, Xu, Xoi, Xu, Wwg, Xu, Xu, Xoi, Xoi, Xoi, Xoi, Xoi, Xoi, Uu^Uf, Uu^Uf, Uh, Uu^Uf, Uu^Uf, Urb, Urb, Urb, Xoi, Uh, Xoi, Urb, Uu^Uf, Uu^Uf, Uu^Uf
Xoi, Xoi, Xoi, Xoi, Xoi, Xoi, Xoi, Xoi, Xu, Xu, Wwg, Xu, Wwg, Wwg, Xu, Xoi, Xoi, Xoi, Xoi, Xoi, Xoi, Xoi, Xoi, Uh, Xoi, Uh, Xoi, Uu^Vud, Xoi, Xoi, Xoi, Xoi, Xoi, Xoi, Xoi, Uh, Xoi
Xoi, Xoi, Xoi, Xoi, Xoi, Xoi, Xoi, Xoi, Xu, Wwg, Wwg, Wwg, Wwg, Xu, Xu, Xoi, Xoi, Xoi, Xoi, Xoi, Xoi, Xoi, Xoi, Xoi, Xoi, Xoi, Xoi, Xoi, Xoi, Xoi, Xoi, Xoi, Xoi, Xoi, Xoi, Xoi, Xoi
Xoi, Xoi, Xoi, Xoi, Xoi, Xoi, Xoi, Xoi, Xu, Wwg, Wwg, Wwg, Wwg, Wwg, Xu, Xoi, Xoi, Xoi, Xoi, Xoi, Xoi, Xoi, Xoi, Xoi, Xoi, Xoi, Xoi, Xoi, Xoi, Xoi, Xoi, Xoi, Xoi, Xoi, Xoi, Xoi, Xoi
Xoi, Xoi, Xoi, Xoi, Xoi, Xoi, Xoi, Xoi, Xoi, Xu, Xu, Wwg, Wwg, Xu, Xoi, Xoi, Xoi, Xoi, Xoi, Xoi, Xoi, Xoi, Xoi, Xoi, Xoi, Xoi, Xoi, Xoi, Xoi, Xoi, Xoi, Xoi, Xoi, Xoi, Xoi, Xoi, Xoi
Xoi, Xoi, Xoi, Xoi, Xoi, Xoi, Xoi, Xoi, Xoi, Xoi, Xoi, Xu, Xu, Xu, Xoi, Xoi, Xoi, Xoi, Xoi, Xoi, Xoi, Xoi, Xoi, Xoi, Xoi, Xoi, Xoi, Xoi, Xoi, Xoi, Xoi, Xoi, Xoi, Xoi, Xoi, Xoi, Xoi
