Xu, Xu, Ms^Xm, Ms^Xm, Ms, Ha^Fda, Ha^Fda, Ha^Fda, Ha^Fda, Ha^Fda, Aa^Fpa, Aa, Aa, Aa, Aa^Fpa, Ha^Fda, Ha^Fda, Ha, Ha^Fda, Ha^Fda, Ms, Ms, Ms^Xm, Ms^Xm, Ms^Xm, Ms^Xm, Xu, Xu, Xu, Xu, Xu, Xu, Xu, Xu, Xu, Xu, Xu
Xu, Xu, Xu, Ms^Xm, Ms^Xm, Ms, Ms, Ms, Ms, Ms, Aa^Fpa, Aa, Aa, Aa, Aa^Fpa, Ms, Ms, Ha^Fda, Ms, Ms, Ms^Xm, Ms^Xm, Xu, Ms^Xm, Xu, Xu, Xu, Xu, Xu, Xu, Xu, Xu, Xu, Xu, Xu, Xu, Xu
Xu, Xu, Xu, Xu, Xu, Ms^Xm, Ms^Xm, Ms^Xm, Ms^Xm, Ms^Xm, Aa^Fpa, Aa^Fpa, Aa, Aa^Fpa, Aa^Fpa, Ms^Xm, Ms^Xm, Ms, Ms^Xm, Ms^Xm, Xu, Ms^Xm, Xu, Xu, Xu, Xu, Xu, Xu, Xu, Xu, Xu, Xu, Xu, Xu, Xu, Xu, Xu
Xu, Xu, Xu, Xu, Xu, Xu, Xu, Xu, Xu, Xu, Aa, Aa, Aa, Aa, Aa, Xu, Xu, Ms^Xm, Xu, Xu, Xu, Xu, Xu, Xu, Xu, Xu, Xu, Xu, Xu, Xu, Xu, Xu, Xu, Xu, Xu, Xu, Xu
Xu, Xu, Xu, Xu, Xu, Xu, Xu, Xu, Xu, Xu, Aa, Uu, Aa, Uu, Aa, Xu, Xu, Xu, Xu, Xu, Xu, Xu, Xu, Xu, Xu, Xu, Xu, Xu, Xu, Xu, Xu, Xu, Xu, Xu, Xu, Xu, Xu
Xu, Xu, Xu, Xu, Xu, Xu, Xu, Xu, Xu, Xu, Aa, Uu, Ur, Aa, Uu, Xu, Xu, Xu, Xu, Xu, Xu, Xu, Xu, Xu, Xu, Xu, Xu, Xu, Xu, Xu, Xu, Xu, Xu, Xu, Xu, Xu, Xu
Xu, Xu, Xu, Xu, Xu, Xu, Xu, Xu, Xu, Xu, Uu, Aa, Ur, Uu, Uu, Xu, Xu, Xu, Xu, Xu, Xu, Xu, Xu, Xu, Xu, Xu, Xu, Xu, Xu, Xu, Xu, Xu, Xu, Xu, Xu, Xu, Xu
Xu, Xu, Xu, Xu, Xu, Xu, Xu, Xu, Xu, Xu, Cud, Uu, Ur, Uu, Cud, Xu, Xu, Xu, Xu, Xu, Xu, Xu, Xu, Xu, Xu, Xu, Xu, Xu, Xu, Xu, Xu, Xu, Xu, Xu, Xu, Xu, Xu
Xu, Xu, Xu, Xu, Xu, Xu, Xu, Xu, Xu, Xu, Cud, Uu, Ur, Uu, Cud, Xu, Xu, Xu, Xu, Xu, Xu, Xu, Xu, Xu, Xu, Xu, Xu, Xu, Xu, Xu, Xu, Xu, Xu, Xu, Xu, Xu, Xu
Xu, Xu, Xu, Xu, Xu, Xu, Xu, Xu, Uu, Cud, Uu, Uu, Ur, Uu, Uu, Cud, Uu, Xu, Uu^Uf, Uh, Uh, Uh, Xu, Xu, Xu, Xu, Xu, Xu, Xu, Xu, Xu, Xu, Xu, Xu, Xu, Xu, Xu
Xu, Xu, Xu, Xu, Xu, Xu, Uu^Uf, Uu, Uu, Uu, Cud, Uu, Ur, Uu, Cud, Uu, Uu, Uu, Uu, Uu^Uf, Uu^Uf, Uu^Uf, Uu, Xu, Xu, Xu, Xu, Xu, Xu, Xu, Xu, Xu, Xu, Xu, Xu, Xu, Xu
Xu, Xu, Xu, Xu, Uh, Uh, Uu^Uf, Uu, Uu, Cud, Cud, Uu, Ur, Uu, Cud, Cud, Uu, Uu, Uu^Vud, Uu, Uu, Uu, Uu, Uu, Uu, Xu, Xu, Xu, Xu, Xu, Xu, Xu, Xu, Xu, Xu, Xu, Xu
Xu, Xu, Xu, Xu, Uh, Uu^Uf, Uu^Uf, Uu, Uu, Uu, Uu, Uu, Ur, Uu, Uu, Uu, Uu, Uu, Uu, Uu, Qxu, Uu^Vud, Qxu, Uu, Xoc, Uu, Uu^Uf, Uh, Uh, Xu, Xu, Xu, Xu, Xu, Xu, Xu, Xu
Xu, Xu, Xu, Xu, Xu, Uu^Uf, Uu, Uu, Qxu, Uu^Uf, Qxu, Uu, Uu, Ur, Ur, Uu, Uu, Uu, Uu, Uu, Uu, Qxu, Qxu, Qxu, Qxu, Xoc, Uu, Uu^Uf, Uu^Uf, Xu, Xu, Xu, Xu, Xu, Xu, Xu, Xu
Xu, Xu, Xu, Xu, Xu, Uu, Uu^Vud, Qxu, Qxu, Qxu, Qxu, Uu, Uu, Uu, Uu^Vud, Ur, Uu, Uu, Qxu, Uu, Xoc, Uu, Uu^Uf, Qxu, Qxu, Xoc, Uu, Uu^Uf, Uu^Uf, Xu, Xu, Xu, Xu, Xu, Xu, Xu, Xu
Xu, Xu, Xu, Xu, Xu, Uu, Uu, Qxu, Xu, Qxu, Uh, Uu^Uf, Uh, Uu, Uu, Ur, Uu, Uu, Xoc, Qxu, Uu, Uu, Uu^Uf, Uu^Vud, Qxu, Qxu, Uu, Uu, Uu, Xu, Xu, Xu, Xu, Xu, Xu, Xu, Xu
Xu, Xu, Xu, Xu, Xu, Uu, Uu, Qxu, Qxu, Qxu, Uu^Uf, Uu^Uf, Uh, Uu^Uf, Uu, Ur, Uu, Uu, Qxu, Qxu, Uu, Uu, Uu, Qxu, Qxu, Qxu, Uu, Uu, Uu^Uf, Xu, Xu, Xu, Xu, Xu, Xu, Xu, Xu
Xu, Xu, Xu, Xu, Xu, Uu, Uu, Qxu, Qxu, Qxu, Uh, Uu^Uf, Uu^Uf, Uu^Uf, Uu, Ur, Uu, Uu, Qxu, Qxu, Uu^Uf, Uu, Uu, Qxu, Qxu, Xoc, Uu, Uu, Uu^Uf, Uh, Xu, Xu, Xu, Xu, Xu, Xu, Xu
Xu, Xu, Xu, Xu, Xu, Uu, Xoc, Uu, Uu, Qxu, Qxu, Uu, Uu, Uu, Uu, Ur, Uu, Uu, Uu, Qxu, Uh, Uu^Uf, Uu, Qxu, Qxu, Uu^Vud, Uu, Uu, Uu, Uu^Uf, Xu, Xu, Xu, Xu, Xu, Xu, Xu
Xu, Xu, Xu, Xu, Xu, Uu, Xoc, Xoc, Uu, Qxu, Qxu, Qxu, Qxu, Uu, Uu, Ur, Ur, Uu, Uu, Qxu, Qxu, Uu^Uf, Xoc, Uu, Uu, Uu, Uu, Uu, Uu, Uu, Xu, Xu, Xu, Xu, Xu, Xu, Xu
Xu, Xu, Xu, Xu, Xu, Uu, Uu^Vud, Uu, Uu, Uu, Uu, Uu^Vud, Uu, Uu, Uu, Uu^Vud, Ur, Uu, Uu, Qxu, Qxu, Qxu, Xoc, Uu, Uu, Uu, Qxu, Qxu, Uh, Uu^Uf, Uu^Uf, Xu, Xu, Xu, Xu, Xu, Xu
Xu, Xu, Xu, Xu, Xu, Uu, Uu, Uu, Xoc, Uu, Uu, Uu, Uu^Emf, Uu, Uu, Uu, Uh, Ur, Ur, Uu, Uu, Qxu, Xoc, Uu, Uu, Uu^Uf, Qxu, Qxu, Uh, Uu^Uf, Uu^Uf, Xu, Xu, Xu, Xu, Xu, Xu
Xu, Xu, Xu, Xu, Uu, Uu, Xoc, Uu, Uu, Uu, Uu^Emf, Uu^Emf, Uu^Emf, Uu^Emf, Uu, Uh, Uh, Uh, Uh, Ur, Uu, Xoc, Uu, Uu, Uu, Uu^Uf, Qxu, Qxu, Qxu, Uh, Uu, Xu, Xu, Xu, Xu, Xu, Xu
Xu, Xu, Xu, Xu, Uu, Xoc, Xoc, Uu, Xoc, Uu, Uu, Uu^Emf, Uu^Vud, Uu, Uu^Emf, Uu^Emf, Uu^Emf, Uh, Uh, Ur, Ur, Uu, Uu, Uu^Vud, Uu, Qxu, Xu, Xu, Qxu, Uu, Uu, Xu, Xu, Xu, Xu, Xu, Xu
Xu, Xu, Xu, Xu, Xu, Uu, Uu, Uu, Uu, Uu, Xoc, Uu, Uu, Uu^Emf, Uu^Emf, Uu^Emf, Uu, Uh, Uu, Uu, Uu, Ur, Ur, Uu, Uu, Qxu, Qxu, Xu, Qxu, Uu, Uu, Xu, Xu, Xu, Xu, Xu, Xu
Xu, Xu, Xu, Xu, Xu, Uu, Uu, Xoc, Uu, Uu, Uu, Uu, Xoc, Uu, Uu, Uu, Uu^Emf, Uu^Emf, Uu^Emf, Xoc, Uu, Uu, Ur, Uu, Uu, Uu, Uu, Qxu, Uu, Uu, Uu^Vud, Xu, Xu, Xu, Xu, Xu, Xu
Xu, Xu, Xu, Xu, Xu, Xu, Uu, Xoc, Xoc, Uu, Uu, Uu^Vud, Xoc, Xoc, Xoc, Uu^Emf, Uu^Emf, Uu^Emf, Uu^Vud, Uu, Xoc, Uu, Uu, Ur, Ur, Uu, Uu, Uu, Uu, Uu, Uu, Xu, Xu, Xu, Xu, Xu, Xu
Xu, Xu, Xu, Xu, Xu, Xu, Uu^Vud, Uu, Uu, Xoc, Xoc, Uu, Xoc, Xoc, Xoc, Uu, Uu, Uu, Uu^Emf, Uu, Uu, Uu, Uu, Uu, Ur, Uu, Cud, Uu, Cud, Uu, Uu, Xu, Xu, Xu, Xu, Xu, Xu
Xu, Xu, Xu, Xu, Xu, Xu, Xu, Xu, Xu, Uu, Uu, Uu, Uu, Xoc, Xoc, Uu, Uu^Emf, Uu^Emf, Uu^Emf, Uu^Emf, Uu, Xoc, Uu, Uu, Ur, Cud, Uu^Vud, Kud, Uu^Vud, Cud, Uu, Xu, Xu, Xu, Xu, Xu, Xu
Xu, Xu, Xu, Xu, Xu, Xu, Xu, Xu, Xu, Xu, Xu, Uu, Xoc, Uu, Uu, Uu, Uu, Uu^Emf, Uu, Uu, Xoc, Uu, Uu, Uu, Cud, Kud, Cud, Cud, Cud, Kud, Cud, Uu, Uh, Xu, Xu, Xu, Xu
Xu, Xu, Xu, Xu, Xu, Xu, Xu, Xu, Xu, Xu, Xu, Uu, Xoc, Uu, Uu, Uu, Uu^Cov, Uu^Cov, Uu^Kov, Uu, Uu, Uu, Uu, Uu, Cud, Uu^Vud, Cud, 2 Kud, Cud, Uu^Vud, Cud, Uu, Uu, Xu, Xu, Xu, Xu
Xu, Xu, Xu, Xu, Xu, Xu, Xu, Xu, Xu, Xu, Xu, Uu, Uu, Xoc, Xoc, Uu, Uu^Cov, 1 Uu^Kov, Uu^Cov, Uu, Xoc, Uu, Uu, Uu, Uu, Kud, Uu^Vud, Cud, Uu^Vud, Kud, Ur, Uu, Uu, Xu, Xu, Xu, Xu
Xu, Xu, Xu, Xu, Xu, Xu, Xu, Xu, Xu, Xu, Xu, Xu, Uu^Uf, Uu, Uu, Xoc, Uu, Uu^Cov, Uu, Uu, Uu, Uu, Xoc, Uu, Uu, Cud, Cud, Kud, Cud, Cud, Ur, Ur, Uu, Xu, Uu^Uf, Xu, Uu^Uf
Xu, Xu, Xu, Xu, Xu, Xu, Xu, Xu, Xu, Xu, Xu, Xu, Xu, Xu, Xu, Uu, Uu^Vud, Uu, Uh, Uu, Uu, Uu, Uu, Uu, Uu^Uf, Uu, Uu, Uu, Uu, Uu, Ur, Ur, Ur, Uu, Ur, Uu^Uf, Ur
Xu, Xu, Xu, Xu, Xu, Xu, Xu, Xu, Xu, Xu, Xu, Xu, Xu, Xu, Xu, Xu, Xu, Uh, Xu, Uh, Xu, Uu, Uu, Uu^Uf, Uh, Uu^Uf, Uu, Uu, Uu, Uu, Uu, Ur, Ur, Ur, Ur, Ur, Ur
Xu, Xu, Xu, Xu, Xu, Xu, Xu, Xu, Xu, Xu, Xu, Xu, Xu, Xu, Xu, Xu, Xu, Xu, Xu, Xu, Xu, Xu, Uu, Xoc, Xoc, Uu^Uf, Uu, Uu, Uu, Uu, Uu^Uf, Uu^Uf, Uu^Uf, Ur, Uu, Ur, Uu
Xu, Xu, Xu, Xu, Xu, Xu, Xu, Xu, Xu, Xu, Xu, Xu, Xu, Xu, Xu, Xu, Xu, Xu, Xu, Xu, Xu, Xu, Uu, Xoc, Uu, Uu, Uu^Uf, Uu^Uf, Uu^Uf, Uu^Vud, Xu, Uh, Xu, Uu, Uu^Uf, Uu^Uf, Uu^Uf
Xu, Xu, Xu, Xu, Xu, Xu, Xu, Xu, Xu, Xu, Xu, Xu, Xu, Xu, Xu, Xu, Xu, Xu, Xu, Xu, Xu, Xu, Xu, Uu, Xu, Uu^Vud, Xu, Uh, Xu, Xu, Xu, Xu, Xu, Xu, Xu, Uh, Xu
Xu, Xu, Xu, Xu, Xu, Xu, Xu, Xu, Xu, Xu, Xu, Xu, Xu, Xu, Xu, Xu, Xu, Xu, Xu, Xu, Xu, Xu, Xu, Xu, Xu, Xu, Xu, Xu, Xu, Xu, Xu, Xu, Xu, Xu, Xu, Xu, Xu
Xu, Xu, Xu, Xu, Xu, Xu, Xu, Xu, Xu, Xu, Xu, Xu, Xu, Xu, Xu, Xu, Xu, Xu, Xu, Xu, Xu, Xu, Xu, Xu, Xu, Xu, Xu, Xu, Xu, Xu, Xu, Xu, Xu, Xu, Xu, Xu, Xu
Xu, Xu, Xu, Xu, Xu, Xu, Xu, Xu, Xu, Xu, Xu, Xu, Xu, Xu, Xu, Xu, Xu, Xu, Xu, Xu, Xu, Xu, Xu, Xu, Xu, Xu, Xu, Xu, Xu, Xu, Xu, Xu, Xu, Xu, Xu, Xu, Xu
Xu, Xu, Xu, Xu, Xu, Xu, Xu, Xu, Xu, Xu, Xu, Xu, Xu, Xu, Xu, Xu, Xu, Xu, Xu, Xu, Xu, Xu, Xu, Xu, Xu, Xu, Xu, Xu, Xu, Xu, Xu, Xu, Xu, Xu, Xu, Xu, Xu
