Xu, Xu, Xu, Xu, Xu, Xu, Xu, Xu, Xu, Xu, Xu, Ms^Xm, Ms, Ha^Fpa, Ha^Fpa, Aa^Fma, Ha^Fpa, Aa^Fma, Aa^Fma, Aa^Fma, Aa, Aa, Aa^Fma, Aa^Fma, Aa^Fma, Aa^Fma, Ha^Fpa, Ha^Fpa, Ms, Ms^Xm, Xu, Xu, Xu, Xu, Xu, Xu, Xu
Xu, Xu, Xu, Xu, Xu, Xu, Xu, Xu, Xu, Xu, Xu, Ms^Xm, Ms^Xm, Ms, Ms, Ha^Fpa, Ms, Ha^Fpa, Aa^Fma, Aa^Fma, Aa, Aa, Aa^Fma, Aa^Fma, Ha^Fpa, Ha^Fpa, Ms, Ms, Ms^Xm, Ms^Xm, Xu, Xu, Xu, Xu, Xu, Xu, Xu
Xu, Xu, Xu, Xu, Xu, Xu, Xu, Xu, Xu, Xu, Xu, Xu, Xu, Ms^Xm, Ms^Xm, Ms, Ms^Xm, Ha^Fpa, Aa^Fma, Aa^Fma, Aa, Aa^Fma, Ha^Fpa, Ha^Fpa, Ms, Ms, Ms^Xm, Ms^Xm, Xu, Xu, Xu, Xu, Xu, Xu, Xu, Xu, Xu
Xu, Xu, Xu, Xu, Xu, Xu, Xu, Xu, Xu, Xu, Xu, Xu, Xu, Ms^Xm, Xu, Ms^Xm, Xu, Xu, Aa, Aa, Aa, Aa^Fma, Ha^Fpa, Ms^Xm, Ms^Xm, Ms^Xm, Xu, Xu, Xu, Xu, Xu, Xu, Xu, Xu, Xu, Xu, Xu
Xu, Xu, Xu, Xu, Xu, Xu, Xu, Xu, Xu, Xu, Xu, Xu, Xu, Xu, Xu, Xu, Xu, Xu, Aa, Uu, Uu, Aa, Aa, Xu, Xu, Xu, Xu, Xu, Xu, Xu, Xu, Xu, Xu, Xu, Xu, Xu, Xu
Xu, Xu, Xu, Xu, Xu, Xu, Xu, Xu, Xu, Xu, Xu, Xu, Xu, Xu, Uu, Uu, Uu, Uu, Aa, Uu, Ur, Aa, Uu, Xu, Xu, Xu, Xu, Xu, Xu, Xu, Xu, Xu, Xu, Xu, Xu, Xu, Xu
Xu, Xu, Xu, Xu, Xu, Xu, Xu, Xu, Xu, Xu, Xu, Xu, Xu, Uu, Xu, Xu, Xu, Xu, Uu, Aa, Ur, Aa, Uu, Xu, Uu, Xu, Xu, Xu, Xu, Xu, Xu, Xu, Xu, Xu, Xu, Xu, Xu
Xu, Xu, Xu, Xu, Xu, Xu, Xu, Xu, Xu, Xu, Xu, Xu, Uu^Vu, Uu, Uu, Xu, Uh, Uu^Uf, Uu, Uu, Ur, Uu, Xu, Uu, Xu, Uu, Xu, Xu, Xu, Xu, Xu, Xu, Xu, Xu, Xu, Xu, Xu
Xu, Xu, Xu, Xu, Xu, Xu, Xu, Xu, Xu, Xu, Xu, Xu, Uu, Uu, Uu, Uu^Uf, Uu^Uf, Uu^Uf, Ur, Ur, Ur, Uu, Uu, Uu, Xu, Uu, Xu, Xu, Xu, Xu, Uu, Xu, Xu, Xu, Xu, Xu, Xu
Xu, Xu, Xu, Xu, Xu, Xu, Xu, Xu, Xu, Xu, Xu, Xu, Uu, Xu, Ur, Ur, Ur, Ur, Uu, Uu, Ur, Uu, Xu, Uu, Uu, Uu, Uu, Uh, Uh, Uu, Xu, Uu, Uu, Uu^Vu, Xu, Xu, Xu
Xu, Xu, Xu, Xu, Xu, Xu, Xu, Xu, Xu, Xu, Uu, Uu, Xu, Xu, Uu, Xu, Uu, Xu, Uu, Uu, Ur, Uu, Uu, Uu, Uu, Xu, Uu, Uu, Uu, Xu, Uu, Xu, Xu, Uu, Xu, Xu, Xu
Xu, Xu, Xu, Xu, Xu, Xu, Uh, Xu, Uu^Vu, Uu, Xu, Uu, Ur, Ur, Uu, Xu, Uu, Uu, Uu, Uu, Ur, Uu, Qxu, Qxu, Qxu, Uu, Qxu, Qxu, Uu, Uu, Qxu, Uu, Uu, Uu, Xu, Xu, Xu
Xu, Xu, Xu, Xu, Xu, Uh, Uh, Uu^Uf, Uu, Uu, Uu, Uu, Ur, Ur, Xu, Xu, Uu, Xu, Xu, Uu, Ur, Uu, Uu^Uf, Uh, Uh, Qxu, Uu, Uu, Uu, Qxu, Uu, Uu, Xu, Xu, Xu, Xu, Xu
Xu, Xu, Xu, Xu, Xu, Uu^Uf, Uu^Uf, Uu^Uf, Xu, Uu, Uu, Xu, Ur, Uu, Uu, Uu, Uu, Xu, Uh, Uu^Uf, Uu, Uu^Uf, Uh, Xu, Uh, Qxu, Uu, Xu, Uu, Qxu, Qxu, Uu, Xu, Xu, Xu, Xu, Xu
Xu, Xu, Xu, Xu, Xu, Uu, Xu, Uu, Uu, Xu, Xu, Ur, Uu, Xu, Uu, Xu, Uu, Xu, Uu^Uf, Uu^Uf, Uu, Uu^Uf, Xu, Xu, Xu, Uu, Uu, Xu, Uu, Uh, Qxu, Uu, Uu, Xu, Xu, Xu, Xu
Xu, Xu, Xu, Xu, Xu, Uu, Uu, Uu, Uu, Xu, Uu, Uu^Vu, Uu, Xu, Uu, Xu, Uu, Xu, Uh, Uh, Ur, Uu, Xu, Xu, Uu, Uu, Uu, Uu, Uu, Uh, Qxu, Uu, Xu, Uu^Vu, Xu, Xu, Xu
Xu, Xu, Ql, Xu, Xu, Xu, Uu, Xu, Ur, Ur, Xu, Uu^Uf, Uh, Uu^Uf, Uu^Uf, Xu, Xu, Uu^Uf, Uu^Uf, Uh, Ur, Ur, Uu, Uu, Uu, Xu, Uu, Uu, Uu, Qxu, Uu^Vu, Uu, Uu, Uu, Uu, Xu, Xu
Xu, Ql, Ql, Ql, Ql, Xu, Xu, Uu, Ur, Xu, Xu, Uu^Uf, Ql, Uh, Ql, Uu, Uu^Uf, Uh, Uu^Uf, Uu, Ur, Uu, Xu, Xu, Uh, Uh, Xu, Xu, Uu, Qxu, Uu, Uu, Uh, Xu, Xu, Uu^Vu, Xu
Xu, Ql, Ql, Ql, Ql, Ql, Ql, Uu^Vu, Qxu^Bs|, Uu, Ql, Xu, Xu, Ql, Ql, Ql, Uu, Uu^Uf, Ql, Uu, Uu, Ur, Ur, Uh, Wwf, Wwf, Wwf, Uh, Xu, Uu, Uu, Xu, Uh, Xu, Uu, Uu, Xu
Xu, Xu, Xu, Ql, Xu, Xu, Xu, Ql, Uu, Ql, Ql, Xu, Ql, Ql, Uu, Uu, Xu, Uu, Xu, Ql, Ql, Uh, Xu, Xu, Wwg, Xu, Wwg, Uh, Qxu, Uu, Uu, Uh, Xu, Xu, Uu, Xu, Xu
Xu, Xu, Xu, Xu, Xu, Xu, Uu, Uu, Xu, Uu, Uu, Xu, Uu, Xu, Uu, Xu, Uu, Uu, Xu, Uu^Uf, Ql, Uh, Xu, Qxu, Wwg, Wwf, Wwf, Wwg, Wwf, Qxu, Xu, Uu, Uu, Uu, Xu, Xu, Xu
Xu, Xu, Xu, Xu, Xu, Xu, Uu^Uf, Uu, Uu, Xu, Uh, Xu, Ql, Xu, Xu, Uu, Uu, Uu, Uu, Xu, Uu, Ql, Qxu, Qxu, Wwf, Xu, Wwf, Wwg, Wwf, Xu, Xu, Uu, Uu, Xu, Xu, Xu, Xu
Xu, Xu, Xu, Xu, Xu, Uh, Uu^Uf, Xu, Uu, Uh, Uh, Xu, Ql, Ql, Xu, Uu, Uu^Uf, Uu, Xu, Uu, Uu, Ql, Qxu, Qxu, Qxu, Wwg, Wwg, Xu, Wwg, Uu, Uu, Xu, Uu, Xu, Xu, Xu, Xu
Xu, Xu, Xu, Xu, Xu, Uh, Uu^Uf, Uu^Uf, Uu, Uh, Ql, Xu, Xu, Uu, Uu, Uu^Uf, Uh, Xu, Xu, Xu, Uu, Uu, Uu, Qxu, Wwf, Wwf, Xu, Wwg, Wwf, Uu^Vu, Uu^Uf, Uu^Uf, Xu, Uu, Uu^Vu, Xu, Xu
Xu, Xu, Xu, Xu, Xu, Xu, Uu, Xu, Xu, Ql, Ql, Ql, Xu, Uu, Uu, Uu^Uf, Xu, Xu, Xu, Xu, Uu^Uf, Uu, Uu, Uu, Uu, Wwf, Wwg, Wwg, Wwf, Uu, Uu^Uf, Uh, Xu, Xu, Uu^Uf, Xu, Xu
Xu, Xu, Xu, Xu, Xu, Xu, Xu, Uu, Uu, Xu, Uu, Xu, Uu, Xu, Xu, Ql, Ql, Xu, Uu^Uf, Uh, Uu^Uf, Uu, Xu, Xu, Xu, Wwg, Wwg, Wwg, Xu, Xu, Wwg, Xu, Uu, Uu^Uf, Uh, Xu, Xu
Xu, Xu, Uu, Xu, Xu, Xu, Xu, Uu^Vu, Uu, Uu, Xu, Uu, Xu, Ql, Ql, Xu, Ql, Uu, Uu, Uu^Uf, Uu, Uu, Wwf, Xu, Wwf, Wwf, Wwg, Wwg, Wwf, Wwg, Wwf, Xu, Uu, Uu^Uf, Xu, Xu, Xu
Uu, Uu, Uu, Uu, Uh, Xu, Uh, Xu, Uu^Emf, Uu^Emf, Uu^Emf, Uu, Xu, Ql, Ql, Xu, Uu^Vu, Xu, Xu, Uu, Uu, Wwf, Xu, Wwf, Wwf, Xu, Wwf, Xu, Wwf, Uh, Xu, Wwf, Wwf, Xu, Xu, Xu, Xu
Ur, Ur, Ur, Uu, Uu, Uh, Uu, Uu^Emf, Uu^Emf, Uu^Emf, Uu, Uu, Xu, Xu, Ql, Xu, Uu, Xu, Uu^Uf, Uu, Uu, Wwf, Wwf, Wwf, Wwg, Wwf, Wwf, Wwg, Wwg, Uh, Xu, Uu^Vu, Wwg, Xu, Xu, Xu, Xu
Ur, Ur, Ur, Ur, Ur, Ur, Ur, Uu, Uu, Uu, Xu, Uu, Uu, Ql, Xu, Xu, Uu, Uu^Uf, Uh, Uu^Uf, Uu, Wwf, Wwg, Wwg, Wwg, Wwg, Wwf, Xu, Wwf, Wwg, Wwf, Wwf, Xu, Wwg, Xu, Xu, Xu
Uu, Uu, Uu, Ur, Ur, Ur, Ur, Ur, Ur, Kte, Uu^Vu, Xu, Uu, Uu, Xu, Xu, Xu, Xu, Ur^Cov, Ur^Cov, Ur^Kov, Wwf, Wwf, Wwg, Wwg, Wwg, Xu, Wwf, Uu^Vu, Wwg, Wwg, Xu, Wwf, Wwg, Xu, Xu, Xu
Xu, Xu, Xu, Uu, Uu, Uh, Ur, Kte, Cte, Cte, Cte, Kte, Xu, Xu, Xu, Xu, Uu^Vu, Uu, Uu^Cov, 1 Uu^Kov, Uu^Cov, Uu, Uu^Vu, Wwg, Wwf, Wwf, Wwg, Wwf, Uu, Wwg, Xu, Wwf, Uh, Xu, Xu, Xu, Xu
Xu, Xu, Xu, Xu, Uu, Xu, Uu, Ur, Cte, 2 Kte, Cte, Xu, Xu, Xu, Ql, Ql, Ql, Xu, Xu, Uu^Cov, Xu, Uu, Uu, Wwf, Wwf, Wwg, Uu, Uu, Xu, Wwf, Wwf, Wwg, Xu, Xu, Xu, Xu, Xu
Xu, Xu, Xu, Xu, Uu, Xu, Uu, Kte, Uu^Vu, Cte, Uu^Vu, Kte, Uu, Ql, Ql, Ql, Uu, Uu, Uu^Emf, Uu^Emf, Uu^Emf, Uu, Uu, Xu, Wwf, Uh, Xu, Xu, Uu, Wwg, Wwg, Uh, Xu, Xu, Xu, Xu, Xu
Xu, Xu, Xu, Xu, Xu, Uu, Ql, Ql, Ql, Kte, Ql, Uu, Uu, Uu, Xu, Xu, Xu, Uu, Xu, Uu^Emf, Uu^Emf, Uu^Emf, Xu, Uu, Wwf, Uh, Uh, Uu, Wwf, Wwg, Xu, Xu, Xu, Xu, Xu, Xu, Xu
Xu, Xu, Xu, Xu, Xu, Xu, Ql, Ql, Xu, Ql, Ql, Xu, Uu^Vu, Uu, Uu, Uu, Uu, Uu, Uu, Xu, Xu, Uu, Xu, Xu, Uu, Wwf, Wwg, Wwf, Xu, Wwg, Xu, Xu, Xu, Xu, Xu, Xu, Xu
Xu, Xu, Xu, Xu, Xu, Xu, Xu, Ql, Ql, Xu, Ql, Ql, Xu, Xu, Xu, Xu, Xu, Xu, Xu, Uu, Uu^Uf, Uu^Uf, Uu^Uf, Uu, Xu, Uu, Uu^Vu, Uu, Xu, Wwg, Wwg, Xu, Xu, Xu, Xu, Xu, Xu
Xu, Xu, Xu, Xu, Xu, Xu, Xu, Xu, Ql, Ql, Xu, Xu, Xu, Xu, Xu, Xu, Xu, Xu, Xu, Uu^Uf, Uh, Uh, Xu, Xu, Xu, Xu, Xu, Xu, Xu, Xu, Xu, Wwg, Wwg, Xu, Xu, Xu, Xu
Ql, Ql, Ql, Xu, Xu, Xu, Ql, Ql, Xu, Xu, Xu, Xu, Xu, Xu, Xu, Xu, Xu, Xu, Xu, Xu, Xu, Uh, Xu, Xu, Xu, Xu, Xu, Xu, Xu, Xu, Wwg, Wwg, Wwg, Wwg, Wwg, Xu, Xu
Ql, Ql, Ql, Ql, Ql, Ql, Ql, Ql, Xu, Xu, Xu, Xu, Xu, Xu, Xu, Xu, Xu, Xu, Xu, Xu, Xu, Xu, Xu, Xu, Xu, Xu, Xu, Xu, Xu, Xu, Wwg, Wwg, Wwg, Wwg, Wwg, Xu, Xu
Xu, Ql, Ql, Ql, Xu, Xu, Xu, Xu, Xu, Xu, Xu, Xu, Xu, Xu, Xu, Xu, Xu, Xu, Xu, Xu, Xu, Xu, Xu, Xu, Xu, Xu, Xu, Xu, Xu, Xu, Xu, Wwg, Wwg, Wwg, Xu, Xu, Xu
Xu, Xu, Xu, Xu, Xu, Xu, Xu, Xu, Xu, Xu, Xu, Xu, Xu, Xu, Xu, Xu, Xu, Xu, Xu, Xu, Xu, Xu, Xu, Xu, Xu, Xu, Xu, Xu, Xu, Xu, Xu, Xu, Xu, Wwg, Xu, Xu, Xu
