border_size=1
usage=map

Ds, Gg, Ss, Gg, Ss, Gg, Ds, Gg, Ds, Gg, Ss, Ss, Ds, Gg, Ds, Gg, Ds, Gs, Gs, Gg, Gg, Gg, Gg, Gg, Gs, Gs, Gs^Fms, Gll, Gs^Fms, Gll, Gs^Fms, Gll, Gll, Gll, Gs^Fms, Gll, Gll, Gll, Gll, Gll, Gll, Gll, Gll, Gll, Gs^Fms, Gll, Gll, Gll, Gll, Gll, Gll
Ss, Ds, Ds, Ss, Ss, Ss, Ds, Ss, Gs, Ss, Ss, Ss, Chs, Ss, Ss, Ss, Ss, Ds, Gs, Gs, Gs, Gg, Gg, Gg, Gs, Gs, Gs^Fms, Gs^Fms, Gll, Gll, Gs^Fms, Gs^Fms, Gll, Gs^Fms, Gll, Gs^Fms, Gs^Fms, Gll, Gs^Fms, Gs^Fms, Gll, Gll, Gll, Gs^Fms, Gll, Gll, Gs^Fms, Gll, Gs^Fms, Gs^Fms, Gs^Fms
Ss, Ss, Ss, Wwf, Ds, Ss, Ds, Gs, Gs, Ds, Ss, Chs, 3 Khs, Chs, Ds, Ds, Ss, Ds, Gs, Gg, Gg, Gs, Gs, Gg, Gs, Gs^Fms, Gll, Gll, Gs^Fms, Gs^Fms, Gs^Fms, Gs^Fms, Gll, Gs^Fms, Gs^Fms, Gs^Fms, Gll, Gs^Fms, Gs^Fms, Gll, Gs^Fms, Gs^Fms, Gll, Gll, Gs^Fms, Gll, Gll, Gll, Gs^Fms, Gll, Gs^Fms
Ds, Ds, Gs, Gs, Ds, Ss, Ss, Ss^Vhs, Ds, Ss, Ss, Chs, Chs, Chs, Ds, Gs, Ss^Vhs, Ds, Gs, Gg, Gg, Gg, Gs, Gs, Gs^Fms, Gll, Gs^Fms, Gll, Gll, Gll, Gs^Fms, Gs^Fms, Gg^Ve, Gll, Gs^Fms, Gll, Gs^Fms, Gll, Gs^Fms, Gll, Gll, Gs^Fms, Gll, Gll, Gs^Fms, Gs^Fms, Gs^Fms, Gll, Gs^Fms, Gll, Gll
Ww, Ds, Ds, Ss, Gs, Ss, Gs, Ss, Ss, Ds, Wwf, Wwf, Ds, Ss, Ss, Gs, Ds, Ds, Gs, Gg, Gg, Gg, Gg, Gs, Gs^Fms, Gll, Gll, Gs^Fms, Gs^Fms, Gll, Gll, Gll, Gs^Fms, Gs^Fms, Gll, Gll, Gll, Gs^Fms, Gs^Fms, Gs^Fms, Gll, Gs^Fms, Cv, Gs^Fms, Gll, Gll, Gll, Gs^Fms, Gll, Gll, Gs^Fms
Ww, Ww, Ww, Gs, Gs, Gs, Gs, Gs, Ss, Ds, Ss, Ss, Ss, Ds, Gs, Ds, Ss, Ds, Ds, Gs, Gs, Gg, Gs, Gs, Gs, Gll, Gll, Gll, Gs^Fms, Gs^Fms, Gs^Fms, Gll, Gs^Fms, Gll, Gs^Fms, Gll, Gll, Gll, Gs^Fms, Gs^Fms, Cv, Gs^Fms, Cv, Gs^Fms, Cv, Gs^Fms, Gll, Gs^Fms, Gs^Fms, Gll, Gll
Ss, Ww, Ww, Ww, Ds, Ss, Ss, Gs, Ss, Ss, Ss, Wwf, Ss^Vhs, Ss, Ss, Ds, Ss, Ds, Ds, Gs, Gs, Gs, Gg, Gg, Gg, Gs, Gs^Fms, Gs^Fms, Gll, Gs^Fms, Gll, Gll, Gs^Fms, Gs^Fms, Gll, Gs^Fms, Gll, Gs^Fms, Gs^Fms, Gs^Fms, Gs^Fms, Cv, Kv, Cv, Gll, Gll, Gll, Gs^Fms, Gs^Fms, Gll, Gll
Ss, Ss, Ww, Ww, Ds, Ss, Ss^Vhs, Ss, Wwf, Ss, Ss, Gs, Gs, Ss, Ss, Ss, Ss, Ss, Gs, Ds, Ds, Gs, Gs, Gg, Gg, Gs, Gll, Gll, Gs^Fms, Gll, Gs^Fms, Gll, Gs^Fms, Gll, Gll, Gll, Gll, Gs^Fms, Gll, Gs^Fms, Cv, Cv, Cv, Cv, Cv, Gll, Gll, Gs^Fms, Gs^Fms, Gs^Fms, Gll
Ds, Ss, Ww, Ww, Ss, Ss, Ds, Wwf, Ds, Ds, Ss, Ss, Gs, Ss, Ss, Ss, Ss, Ss, Gs, Ss, Ss, Ds, Ds, Gs, Gs, Gg, Gg, Gll, Gs^Fms, Gll, Gs^Fms, Gs^Fms, Gs^Fms, Gs^Fms, Gll, Gll, Gs^Fms, Gs^Fms, Gs^Fms, Gll, Gs^Fms, Gll, Cv, Gs^Fms, Gs^Fms, Gs^Fms, Gs^Fms, Gll, Gs^Fms, Gs^Fms, Gs^Fms
Ss, Ss, Ww, Ww, Ds, Ss, Ds, Ds, Ww, Ww, Ww, Ww, Ww, Gs, Gs, Ss, Ss, Ss, Gs, Ss, Ds, Ds, Gs, Ds, Gs^Vc, Gs, Gs, Gs, Gs, Gs^Fms, Gs, Gs^Fms, Gs^Fms, Gll, Gs^Fms, Gll, Gs^Fms, Gs^Fms, Gll, Gs^Fms, Gll, Gll, Gs^Fms, Gll, Gll, Gs^Fms, Gs^Fms, Gs^Fms, Gll, Gs^Fms, Gll
Ss, Ds, Ww, Ww, Ss, Ss, Ss, Ww, Ww, Ww, Ww, Ww, Ww, Ww, Ww, Ss, Ss, Gs, Gs, Gs, Ss, Ss, Gs, Ss, Ds, Ds, Gs, Gg, Gs, Gs, Gs, Gs, Gs, Gs^Fms, Gs^Fms, Gs^Fms, Gg^Ve, Gs^Fms, Gs^Fms, Gll, Gs^Fms, Gs^Fms, Gll, Gll, Gll, Gs^Fms, Gll, Gll, Gs^Fms, Gs^Fms, Gll
Ss, Ss, Ww, Ww, Ww, Ss, Ww, Ww, Ww, Ss, Ds, Ss, Ss, Ww, Ww, Ss, Ss, Gs, Ss, Ds, Ds, Ss, Ds, Ds, Ss, Ds, Ds, Gs, Ds, Gs, Ds, Gs, Gs, Gs, Gll, Gll, Gll, Gll, Gs^Fms, Gll, Gll, Gs^Fms, Gs^Fms, Gs^Fms, Gs^Fms, Gs^Fms, Gs^Fms, Gll, Gs^Fms, Gs^Fms, Ww
Ds, Ss, Ss, Ww, Ww, Ww, Ww, Ww, Ss, Ss^Vhs, Gs, Ds, Ds, Ww, Ww, Ss, Ss, Ds, Ds, Ss, Ss, Ss, Ss, Ds, Ss, Gs, Gs, Ds, Ss, Ds, Ds, Ds, Gs, Gg, Gg, Gll, Gs^Fms, Gll, Gll, Gs^Fms, Gll, Gll, Gll, Gs^Fms, Gs^Fms, Gs^Fms, Gs^Fms, Gs^Fms, Ww, Ww, Ww
Ss, Wwf, Ds, Ss, Ww, Ww, Ww, Ss, Ds, Ss, Gs, Sm, Ds, Ww, Ww, Ds, Ss, Ds, Ss, Ds, Ss, Ss^Vhs, Ss, Ss, Ss, Ss, Ss, Ds, Gs, Gs, Ss, Ds, Ds, Gs, Gs, Gs, Gs, Gll, Gs^Fms, Gll, Gs^Fms, Gs^Fms, Gll, Gg^Ve, Gs^Fms, Gs^Fms, Ww, Ww, Ww, Ww, Gll
Wwf, Ds, Ss, Ds, Ss, Ww, Ww, Ww, Ds, Gs, Ss, Ss, Wwf, Ww, Ww, Ww, Ds, Ss, Gs, Ss, Ss, Ss, Gs, Ds, Gs, Ss, Gs, Ds, Gs, Gs, Gs, Ss, Ds, Ds, Gs, Gg, Gg, Gs, Gs, Gll, Gs^Fms, Gll, Gll, Gs^Fms, Gs^Fms, Ww, Ww, Ww, Gll, Gs^Fms, Gll
Ds, Ds, Ss, Ds, Ss, Ww, Ww, Ww, Ds, Ss, Wwf, Ss, Ss, Ds, Ww, Ww, Ww, Ds, Gs, Ss, Ss, Gs, Ds, Gs, Ss, Ss, Gs, Ds, Gs, Gs, Ds, Ss, Ss, Ds, Ds, Gs, Gg, Gg, Gg, Gs, Gll, Gll, Gll, Gs^Fms, Ww, Ww, Ww, Gll, Gll, Gll, Gs^Fms
Ss, Ss, Ds, Ss^Vhs, Ss, Ss, Ww, Ww, Ww, Ds, Ss, Wwf, Ss, Ds, Ds, Ww, Ww, Ds, Gs, Ds, Ds, Ss, Ss, Ds, Wwf, Ss, Ss^Vhs, Ss, Gs, Ss, Gs, Ds, Ss, Ds, Gs, Gs, Gg, Gg, Gs, Gll, Gs^Fms, Gll, Gs^Fms, Gll, Ww, Ww, Gs^Fms, Gll, Gll, Gll, Gll
Ss, Wwf, Wwf, Wwf, Wwf, Ds, Ss, Ww, Ww, Ds, Gs, Ss, Ss, Ss, Ss, Ww, Ww, Gs, Gs, Ss, Ss, Ss, Ds, Ds, Ss, Ss, Ss, Ss, Gs, Ss, Gs, Ds, Gs, Ds, Ds, Gs, Gs, Gg, Gs, Gs^Fms, Gll, Gs^Fms, Gll, Gll, Ww, Ww, Gll, Gs^Fms, Gll, Gs^Fms, Gll
Ss, Wwf, Ss, Ds, Gs, Ds, Ss^Vhs, Ww, Ww, Ww, Gs, Wwf, Wwf, Ss, Ww, Ww, Ss, Ds, Ss, Ds, Gs, Ds, Gs^Cov, Gs^Cov, Gs^Cov, Ds, Ss, Gs, Gs, Gs, Ss, Ds, Ss, Ds, Ds, Ds, Ds, Gs, Gs, Gs^Fms, Gs^Fms, Gll, Gll, Gll, Ww, Ww, Gs^Fms, Gll, Gs^Fms, Gll, Gs^Fms
Ss, Ss, Chs, Chs, Chs, Ss, Wwf, Ds, Ww, Ww, Gs, Ss^Vhs, Wwf, Gs, Ww, Ww, Ss, Ss, Wwf, Ss, Ds, Gs, Gs^Kov, 1 Gs^Kov, Gs^Cov, Ds, Wwf, Wwf, Ss, Ss, Ss, Ss, Ds, Ss, Ss, Ds, Ds, Gs, Ds, Gs, Ww, Ww, Ww, Ww, Ww, Ww, Gs, Gll, Gll, Gs^Fms, Gll
Ds, Wwf, Chs, 4 Khs, Chs, Wwf, Ss, Ds, Ww, Ww, Ss, Wwf, Gs, Gs, Ww, Ww, Ss^Vhs, Ss, Wwf, Ss, Ss, Ds, Gs, Gs^Cov, Ss, Ds, Ds, Ds, Ds, Ss, Wwf, Ds, Ss, Ss, Ss, Sm, Ss, Ds, Ww, Ww, Ww, Ww, Ww, Ww, Gg, Gg, Gg, Gg, Gll, Gs^Fms, Gll
Ss, Ds, Ss, Chs, Ss, Ss, Ww, Ww, Ww, Ww, Ds, Ss, Gs, Gs, Ww, Ww, Ww, Ss, Ss, Ss, Ss, Gs, Gs, Ds, Ss, Wwf, Ss, Ss, Ss, Wwf, Ss, Wwf, Ss, Ds, Ss, Ds, Ss, Ss, Ww, Ww, Ds, Ds, Gs^Vc, Gs, Gs, Gg, Gg, Gg, Gs^Fms, Gll, Gg
Ds, Ss, Ww, Ds, Ww, Ww, Ww, Ww, Gs, Gs, Ss, Ds, Gs, Ss, Ss, Ww, Ww, Ww, Ww, Gs, Sm, Ds, Ss, Ds, Ds, Ss, Ss, Gs, Gs, Wwf, Wwf, Ss, Ds, Ds, Ds, Ss, Ss, Ss, Ww, Ww, Ww, Ds, Ds, Ds, Gs, Gg, Gg, Gg, Gg, Gs, Gg
Ww, Ww, Ww, Ww, Ww, Ww, Ds, Ds, Ss, Wwf, Ds, Ds, Gs, Gs, Ss, Ss, Ss, Ww, Ww, Ds, Ss, Ds, Ds, Ss, Ss, Wwf, Ds, Ss, Ds, Gs, Ss, Ss, Ds, Wwf, Ss^Vhs, Gs, Gs, Ss, Sm, Ww, Ww, Ww, Ds, Ds, Ds, Gs, Gs, Gs, Gs, Gg, Gg
Ww, Ww, Ss^Vhs, Ww, Ss, Gs, Ss, Gs, Gs, Gs, Ds, Ds, Gs, Ds, Ss, Ds, Ss, Ww, Ww, Ds, Ss, Ss, Wwf, Ds, Gs^Cov, Ds^Cov, Gs^Cov, Gs, Wwf, Gs, Wwf, Ss, Ds, Ss, Ss, Gs, Gs, Gs, Sm, Ss, Ww, Ww, Ww, Sm, Sm, Ds, Ds, Ds, Ds, Gs, Gs
Ww, Ww, Ss, Ss, Ds, Gs, Wwf, Wwf, Ss, Ds, Ss, Ds, Wwf, Wwf, Ss, Ss, Ww, Ww, Ww, Ss, Ds, Sm, Wwf, Ss, Gs^Cov, 2 Gs^Kov, Gs^Cov, Gs, Ds, Ss, Ds, Sm, Ds, Ds, Ss, Ds, Gs, Gs, Gs, Sm, Ww, Ww, Ww, Sm, Wwf, Ss, Ss, Ds, Ds, Ds, Gs
Ww, Ww, Ss, Sm, Ds, Gs, Ss, Ss, Wwf, Ss, Ds, Ss, Sm, Ss, Sm, Gs, Ww, Ww, Ss^Vhs, Ss, Ss, Ss, Ss, Ss, Ds, Gs^Cov, Ds, Ds, Ss, Ds, Ds, Ds, Ds, Ss, Ss, Sm, Ww, Ss, Ss, Ss, Ww, Ww, Ss, Ss, Ss, Ss, Sm, Sm, Ss, Ds, Ds
Ww, Ww, Ss, Sm, Ss, Ds, Ss, Ds, Ss, Wwf, Wwf, Ss, Ss, Ds, Ss, Gs, Ww, Ww, Ww, Ss, Ww, Ds, Ww, Ww, Ww, Ss, Ds, Ss, Ss^Vhs, Ss, Ss, Ss, Ww, Ww, Ww, Ww, Ww, Ww, Ww, Ww, Ww, Ww, Wwf, Wwf, Ss, Gs, Ds, Ss, Ss, Sm, Ds
Ds, Ds, Sm, Ds, Sm, Ss, Wwf, Ds, Ds, Ss, Ss^Vhs, Ss, Wwf, Sm, Ss, Gs, Gs, Ww, Ww, Ww, Ww, Ww, Ww, Ww, Ww, Ww, Ww, Ww, Ww, Ds, Ww, Ww, Ww, Ww, Ww, Ww, Ww, Ww, Ww, Ww, Sm, Ds, Ss, Ss, Ds, Ss, Wwf, Ds, Ss, Wwf, Wwf
Ss, Ss, Ss, Ds, Ss, Wwf, Ss, Wwf, Ss, Ds, Ss, Ds, Ss, Ds, Ds, Ss, Ss, Ss, Ss, Ss, Ss, Ww, Ss, Ss, Sm, Ww, Ww, Ww, Ww, Ww, Ww, Ww, Ds, Ss, Gs, Ww, Ww, Ss, Ss, Ds, Ss, Ss, Wwf, Ds, Ss, Ss, Ss, Wwf, Ds, Gs, Wwf
Ss, Ss, Ds, Ss, Ds, Ss, Ds, Sm, Sm, Ss, Ss, Wwf, Ss, Ss, Ss, Ss, Wwf, Wwf, Ss, Wwf, Wwf, Ss, Wwf, Ss^Vhs, Wwf, Ss, Ss, Ss, Ss, Ww, Ww, Ss, Ss, Ss, Gs, Ww, Ww, Ww, Ss, Ss, Ds, Ss, Ss, Wwf, Ss, Ss, Wwf, Ss, Ds, Ds, Ss
Ds, Ds, Gs, Ds, Gs, Ds, Gs, Ds, Ss, Ss, Ss, Ss, Ds, Ss, Ds, Ss, Ss, Wwf, Wwf, Ss, Ss, Ss, Ss, Wwf, Gs, Gs, Ss, Ss, Ss, Ww, Ww, Ww, Sm, Ds, Wwf, Ss, Ww, Ww, Ss^Vhs, Ds, Ds, Ds, Ds, Ss, Ss^Vhs, Ds, Ss, Sm, Ds, Wwf, Ss
Gs, Gs, Gg, Gs, Gg, Gs, Gs, Ds, Ds, Ds, Ds, Ds, Ds, Ds, Gs, Ds, Ds, Ss, Ss, Ss, Ds, Ds, Ds, Gs, Ss, Ss, Gs, Wwf, Ss, Ds, Ww, Ww, Ss, Ds, Ss, Ss, Ss, Ww, Ww, Ww, Ww, Ww, Ww, Ds, Ss, Ss, Ss, Wwf, Ss, Ss, Gg
Gg, Gg, Gs, Gg, Gs, Gg, Gs, Gs, Gs, Gs, Gs, Gs, Gs, Gs, Gg, Gs, Gs, Ds, Ds, Ds, Gs, Gs, Gs, Ds, Ds, Ds, Ds, Sm, Ss, Ss, Ww, Ww, Ss, Ss, Ss, Wwf, Ds, Ww, Ww, Ww, Ss, Ww, Ww, Ww, Ds, Ss, Ss, Wwf, Ss, Ss, Gg
Gs, Gs, Hh, Gs, Hh, Gs, Gg, Gg, Gg, Gs^Vc, Gg, Gg, Gs, Gg, Gg, Gg, Gg, Gs, Gs^Vc, Gs, Gs, Gs, Gs, Gs, Gs, Gs, Ds, Ss, Ds, Ww, Ww, Ww, Ds, Ds, Ss, Ss, Sm, Ds, Sm, Ss, Wwf, Ss, Ww, Ww, Ww, Ds, Sm, Ss, Ss, Ss, Gg
Hh, Hh, Hh, Hh, Hh, Gs, Gs, Gs, Gs, Gs, Gs, Gs, Gg, Gg, Gg, Gg, Gs, Gs, Gs, Gs, Hh, Hh, Hh, Gs, Hh, Gs, Gs, Ds, Ds, Ww, Ww, Ds, Gs, Ds, Ds, Ds, Ss, Ds, Ss, Ss, Ds, Gs, Sm, Ww, Ww, Ww, Ss, Wwf, Ss, Ss, Ss
Hh, Hh, Mm, Hh, Hh, Hh, Hh, Hh, Hh, Hh, Hh, Gs, Gs, Gg, Gg, Gg, Gs, Hh, Hh, Hh, Hh, Hh, Hh, Hh, Hh, Hh, Hh, Gs, Gs, Ww, Ww, Ds, Gs, Gs, Gs, Ds, Ds, Ds, Ss, Ss, Ss, Ds, Ss, Sm, Ww, Ww, Ss, Ds, Ds, Ss, Ss
Mm, Mm, Mm, Hh, Hh, Hh, Hh, Hh, Hh, Hh, Hh, Hh, Hh, Gs, Gg, Gs, Hh^Vhh, Hh, Mm, Mm, Mm, Mm, Mm, Hh, Mm, Hh, Hh, Hh, Gs, Ww, Ww, Gs, Gg, Gg, Gg, Gs, Gs, Ds, Ds, Ds, Gs, Ds, Ds, Ss, Ww, Ww, Ds, Ss, Ss, Ds, Wwf
Mm, Mm, Mm, Mm, Mm, Mm, Mm, Mm, Mm, Mm, Mm, Hh^Vhh, Hh, Gs, Gs, Gs, Gs, Hh, Hh, Mm, Mm, Mm, Mm, Mm, Mm, Mm, Hh, Hh, Gs, Ww, Hh, Gs, Gs, Gg, Gg, Gg, Gg, Gs, Gs, Ds, Ss, Sm, Ss^Vhs, Ss, Ww, Ww, Ww, Ss, Ds, Wwf, Ss
Mm, Mm, Mm, Mm, Mm, Mm, Mm, Mm, Mm, Mm, Mm, Hh, Hh, Hh, Gs, Kh, Gs, Hh, Hh, Mm, Mm, Mm, Mm, Mm, Mm, Mm, Hh, Hh, Ww, Ww, Hh, Hh, Hh, Gs, Gs, Gg, Gg, Gg, Gs, Ds, Ss, Wwf, Ss, Ss, Ds, Ww, Ww, Ww, Ww, Ss, Wwf
Mm, Mm, Mm, Mm, Mm, Mm, Mm, Mm, Mm, Mm, Mm, Mm, Hh, Kh, Ch, Ch, Ch, Kh, Hh, Mm, Mm, Mm, Mm, Mm, Mm, Mm, Ww, Ww, Hh, Hh, Mm, Hh, Hh, Hh, Hh, Gs, Gs, Gg, Gs, Ds, Ds, Ss, Ss, Ss, Ss, Ds, Ds, Ww, Ww, Ss, Ss
Mm, Mm, Mm, Mm, Mm, Mm, Mm, Mm, Mm, Mm, Mm, Mm, Hh, Hh, Ch, Kh, Ch, Gs, Hh, Mm, Mm, Mm, Mm, Mm, Mm, Hh, Ww, Ww, Mm, Mm, Mm, Mm, Mm, Hh, Hh, Hh, Gs, Gg, Gs, Ds, Ds, Ss, Ss, Ss, Ds, Ss, Ss, Ww, Ww, Ww, Ww
Mm, Mm, Mm, Mm, Mm, Mm, Mm, Mm, Mm, Mm, Mm, Mm, Hh, Kh, Hh, Ch, Hh, Kh, Hh^Vhh, Mm, Mm, Mm, Mm, Mm, Mm, Mm, Ww, Hh, Mm, Mm, Mm, Mm, Mm, Hh, Hh, Gs, Gg, Gg, Gg, Gs, Ds, Ss, Ss, Ds, Ss, Ss, Wwf, Ss, Ss, Ww, Ww
Mm, Mm, Mm, Mm, Mm, Mm, Mm, Mm, Mm, Mm, Mm, Mm, Mm, Hh, Hh, Kh, Hh, Hh, Mm, Mm, Mm, Mm, Mm, Mm, Mm, Mm, Mm, Mm, Mm, Mm, Mm, Mm, Mm, Hh, Hh, Gs, Gg, Gg, Gg, Gs, Ds, Ss, Ss, Ss, Ss^Vhs, Ss, Ds, Ds, Ss, Ww, Ww
Mm, Mm, Mm, Mm, Mm, Mm, Mm, Mm, Mm, Mm, Mm, Mm, Mm, Mm, Mm, Hh, Mm, Mm, Mm, Mm, Mm, Mm, Mm, Mm, Mm, Mm, Mm, Mm, Mm, Mm, Mm, Mm, Mm, Hh, Hh, Gs, Gs, Gg, Gg, Gs, Gs, Ds, Ss, Wwf, Ds, Ss, Ds, Wwf, Ss, Ww, Ww
Mm, Mm, Mm, Mm, Mm, Mm, Mm, Mm, Mm, Mm, Mm, Mm, Mm, Mm, Mm, Mm, Mm, Mm, Mm, Mm, Mm, Mm, Mm, Mm, Mm, Mm, Mm, Mm, Mm, Mm, Mm, Mm, Hh, Hh, Hh, Gs, Gs, Gg, Gg, Gg, Gs, Ds, Ds, Ss, Wwf, Ss, Ss, Ss, Ds, Ww, Ww
Mm, Mm, Mm, Mm, Mm, Mm, Mm, Mm, Mm, Mm, Mm, Mm, Mm, Mm, Mm, Mm, Mm, Mm, Mm, Mm, Mm, Mm, Mm, Mm, Mm, Mm, Mm, Mm, Mm, Mm, Mm, Mm, Mm, Hh, Hh, Hh, Gs, Gs, Gg, Gg, Gg, Gs, Ds, Ss, Ss, Ss, Gg, Ss, Gg, Ww, Ww
