border_size=1
usage=map

Gs^Fms, Gg, Gs^Fms, Gs^Fms, Gg, Gg, Gg, Gg, Gg, Wwt, Wwt, Wwt, Gg, Gg, Gg, Gg, Gg, Gg, Gs^Fms, Gll, Gs^Fms, Gs^Fms, Gll, Gs^Fms, Gs^Fms, Gll, Gs^Fms, Gs^Fms, Gs^Fms, Gg, Gg, Gg, Rp, Gg, Gg, Gg, Gg, Gg, Gs^Fms, Gs^Fms, Gs^Fms, Gll, Gs^Fms, Gs^Fms, Gs^Fms, Gg, Gs^Fms
Gs^Fms, Gs^Fms, Gs^Fms, Gs^Fms, Gg, Gg, Gg^Es, Gg, Gg, Wwt, Wwt, Gg, Gg, Gg, Gg, Gg, Gg, Gg, Gg, Gs^Fms, Gs^Fms, Gll, Gs^Fms, Gll, Gs^Fms, Gs^Fms, Gll, Gll, Gs^Fms, Gg, Gg, Gg, Rp, Gg, Gg, Gg, Gg, Gs^Fms, Gll, Gll, Gll, Gs^Fms, Gs^Fms, Gll, Gs^Fms, Gs^Fms, Gll
Gs^Fms, Gg, Gs^Fms, Gs^Fms, Gg, Gg, Gg, Gg, Gg, Wwt, Wwt, Gg^Es, Gg, Gg, Gg, Gg, Gg^Es, Gg, Gg, Gs^Fms, Gs^Fms, Gs^Fms, Gs^Fms, Gs^Fms, Gll, Gs^Fms, Gs^Fms, Gs^Fms, Gg, Gg, Gg, Gg, Rp, Gg, Gg, Gg, Gg^Es, Gs^Fms, Gs^Fms, Gll, Gs^Fms, Gg^Fet, Gs^Fms, Gs^Fms, Gs^Fms, Gs^Fms, Gll
Gs^Fms, Gs^Fms, Gs^Fms, Gs^Fms, Gg, Gg, Gg^Efm, Gg^Efm, Gg^Efm, Wwt, Wwt, Gs^Vl, Gg, Gg, Gs^Fms, Gg, Gg, Gg, Gg, Gg, Gs^Fms, Gs^Fms, Gs^Fms, Gs^Fms, Gg, Gs^Fms, Gg, Gg, Gg, Gg, Gg, Gg, Rp, Gg, Gg, Gg, Gg, Gg, Gs^Fms, Gs^Fms, Gll, Gs^Fms, Gs^Fms, Gll, Gs^Fms, Gs^Fms, Gs^Fms
Gs^Fms, Gs^Fms, Gg, Gg, Gg^Es, Gg, Gg, Gg, Gg, Wwt, Wwt, Wwt, Wwt, Gg, Gg, Gll, Gg, Gg, Gg, Gg, Gg, Gg, Gg, Gg, Gg, Gg, Gg, Gg, Gg, Gg^Es, Gg, Gg, Rp, Gg, Gg^Es, Gg, Gg, Gg, Gg, Gs^Fms, Gs^Fms, Gll, Gs^Fms, Gll, Gs^Fms, Gs^Fms, Gs^Fms
Gg, Gg, Gg, Gg, Gg, Gg^Efm, Gg^Efm, Gg^Efm, Gg^Efm, Gg, Gg, Wwt, Wwt, Wwt, Gg, Gs^Fms, Gg, Gg, Gg^Efm, Gg, Re^Vct, Gg, Gg^Efm, Gg, Gg^Cov, Gg^Cov, Gg^Cov, Gg, Gg, Re^Vct, Gg, Gg, Rp, Gg, Gg, Gg, Gg, Gg, Gg^Eff, Gg, Gg, Gll, Gll, Gll, Gll, Gs^Fms, Gs^Fms
Gg, Gg^Es, Gg, Gg, Gg, Gg, Gg, Gg, Gg, Gg, Gg, Gg, Wwt, Wwt, Gg, Gll, Gg, Gg, Gg, Gg, Gg, Gg, Gg, Gg, Gg^Kov, 1 Gg^Kov, Gg^Cov, Gg, Gg, Gg, Rp, Rp, Re, Gg, Gg, Gg, Gg^Eff, Gg^Eff, Rb^Gvs, Gg^Eff, Gg^Eff, Gg, Gg, Gg^Fet, Gs^Fms, Gs^Fms, Gs^Fms
Gg, Gg, Gg, Gg, Gg, Gg, Gs^Fms, Gg, Gg, Gg, Gs^Fms, Gg, Wwt, Wwt, Gg, Gs^Fms, Gg^Fet, Gg, Gg, Gg^Efm, Gg, Gg, Gg, Gg, Gg, Gg^Cov, Gg, Gg, Rp, Rp, Gg, Gg, Gg, Re, Re, Gg^Eff, Rb^Gvs, Rb^Gvs, Rb^Gvs, Rb^Gvs, Rb^Gvs, Gg^Eff, Gg^Eff, Gs^Fms, Gs^Fms, Gs^Fms, Gg
Gg, Gg, Gg, Gg, Gs^Fms, Gll, Gs^Fms, Gg, Gs^Vl, Gg, Gs^Fms, Gg, Wwt, Wwt, Gg, Gs^Fms, Gs^Fms, Gg, Gg, Gg, Gg, Gg, Gg^Efm, Gg, Gg, Gg, Rp, Rp, Gg, Gg, Gg, Gg, Gg^Eff, Gg^Eff, Rb^Gvs, Re, Re, Rb^Gvs, Rb^Gvs, Rb^Gvs, Re, Re, Rb^Gvs, Gg^Eff, Gg^Eff, Gg, Gg
Gg, Gg, Gg, Gg, Gg, Gg, Gg, Gg, Gg, Gg, Gg, Gg, Wwt, Wwt, Gg, Gg, Gg, Gg, Re^Vct, Gg, Gg, Gg, Rp, Gg, Rp, Rp, Gg, Gg, Gg^Efm, Gg, Gg^Eff, Gg^Eff, Rb^Gvs, Rb^Gvs, Rb^Gvs, Rb^Gvs, Gs^Vl, Re, Re, Re, Gs^Vl, Rb^Gvs, Rb^Gvs, Rb^Gvs, Rb^Gvs, Gg^Eff, Gg^Eff
Gg, Gg, Gg, Gg, Gg, Gg, Gg^Fet, Gg, Gg, Gg^Es, Gg, Gg, Wwt, Wwt, Wwt, Gg, Gg, Gg, Gg, Gg, Gg, Rp, Gg^Fet, Rp, Gg, Gg, Gg^Efm, Gg, Gg, Gg, Gg, Gg^Eff, Gg^Eff, Rb^Gvs, Rb^Gvs, Rb^Gvs, Re, Re, Rb^Gvs, Re, Re, Rb^Gvs, Rb^Gvs, Rb^Gvs, Re, Re, Rb^Gvs
Gg, Gg, Gs^Vl, Gs^Fms, Gll, Gg, Gg, Gg, Gg, Gg, Gg, Gg, Gg, Wwt, Wwt, Gg, Gg, Gg, Gg, Gg, Rp, Rp, Gg, Gg, Gg^Efm, Gg, Gg, Gg, Hh, Gg, Hh, Gg, Gg, Gg^Eff, Gg^Eff, Re, Rb^Gvs, Rb^Gvs, Rb^Gvs, Rb^Gvs, Rb^Gvs, Re, Re, Re, Rb^Gvs, Rb^Gvs, Rb^Gvs
Gg, Gg, Gg, Gg, Gg, Gs^Fms, Gs^Fms, Gs^Fms, Gg, Gg, Gg, Gg, Gg, Wwt, Wwt, Wwt, Wwt, Gg, Rp, Rp, Gg, Gg, Gg^Efm, Gg, Gg, Gg, Gg, Gg, Hh, Hh, Hh, Hh, Hh, Gg, Gg, Gg^Eff, Gg^Eff, Rb^Gvs, Rb^Gvs, Rb^Gvs, Re, Re, Gs^Vl, Re, Re, Rb^Gvs, Rb^Gvs
Gg, Gg, Gs^Fms, Gll, Gg, Gg, Gg, Gg, Gg, Gg, Gg, Gg, Gg, Gg, Gg, Wwt, Wwt^Bw/, Rp, Gg, Gg, Gg, Gg, Gg^Efm, Gg, Gs^Fms, Gg, Gs^Fms, Gg, Gs^Fms, Hh, Hh, Hh, Hh, Gg, Gg, Gg, Gg, Gg^Eff, Gg^Eff, Re^Wm, Rb^Gvs, Rb^Gvs, Rb^Gvs, Rb^Gvs, Rb^Gvs, Gg, Gg^Eff
Gg, Gg, Gg, Gs^Fms, Gg, Gg, Gg, Gg, Gg, Gg, Gg, Gs^Fms, Gs^Fms, Gg, Rp, Wwt^Bw/, Wwt, Gg, Gg, Gg, Gs^Fms, Gg, Gg, Gg, Gll, Gs^Fms, Gs^Fms, Gs^Fms, Hh^Fms, Hh^Fms, Hh^Fms, Hh, Hh, Hh, Gg, Gg, Gg^Eff, Gg^Eff, Re, Re, Gg^Eff, Rb^Gvs, Rb^Gvs, Rb^Gvs, Gg^Eff, Gg^Eff, Gg
Gg, Gg, Gg, Gg, Gg, Gg, Gg^Efm, Gg, Gg^Efm, Gg, Gg, Gll, Gs^Fms, Rp, Gg, Wwt, Wwt, Gg, Gg, Gs^Fms, Gg, Gg, Gg, Gg, Gs^Fms, Gll, Gs^Fms, Hh^Fms, Hh^Fms, Hh^Fms, Hh^Fms, Hh, Hh, Hh, Gg^Eff, Gg^Eff, Rb^Gvs, Re, Gg^Eff, Gg^Eff, Gs^Fms, Gs^Fms, Gs^Fms, Gg^Eff, Gg, Gg, Gg
Gg, Gg, Gg^Es, Gg, Gg, Gg, Gg, Gg, Gg, Gg, Gg, Gg, Rp, Rp, Gg, Wwt, Wwt, Gg, Gg, Gg, Gg, Gg, Gg^Es, Gg, Gs^Fms, Gll, Gs^Fms, Hh^Fms, Hh^Fms, Hh^Fms, Hh, Hh, Gg^Eff, Gg^Eff, Gs^Vl, Rb^Gvs, Rb^Gvs, Rb^Gvs, Rb^Gvs, Gg^Eff, Gg^Eff, Gll, Gll, Gs^Fms, Gg, Gg^Es, Gg
Gg, Gg, Gg, Gg, Gg, Gg^Efm, Gg^Efm, Gg, Gg, Gg, Rp, Rp, Gg, Gg, Wwt, Wwt, Wwt, Gs^Fms, Gg, Gg, Gg, Gg, Gg, Gg, Gg, Gs^Fms, Gs^Fms, Gs^Fms, Gs^Fms, Gs^Fms, Gg, Gg^Eff, Gg^Eff, Re, Gg, Rb^Gvs, Rb^Gvs, Rb^Gvs, Gg^Eff, Gg^Eff, Gg, Gg, Gs^Fms, Gs^Fms, Gg, Gg, Gg
Gg, Gg, Gg, Gg, Gg, Gg, Gg, Gg^Efm, Gg, Rp, Gg, Gg, Gs^Fms, Gg, Wwt, Wwt, Gs^Vl, Gll, Gs^Fms, Gg, Gg, Gg^Fet, Gg, Gg, Gg, Gs^Fms, Gs^Fms, Gs^Fms, Gs^Fms, Gg, Gg, Gg^Eff, Gg^Eff, Re, Gg, Gg, Gg, Re, Re, Gg^Eff, Gg^Eff, Gg, Gg, Gg, Gg, Gg^Es, Gg
Rp, Rp, Rp, Rp, Rp, Rp, Rp, Gs^Vl, Rp, Rp, Gg, Gll, Gll, Gg, Wwt, Wwt, Wwt, Wwt, Wwt, Gs^Fms, Gg, Gg, Gg, Gg, Gg, Gg, Gg, Gg, Gg, Gg, Gg^Eff, Gg^Eff, Re, Re, Gg, Gg, Gs^Fms, Gg, Gg, Re, Re, Gg^Eff, Gg^Eff, Gg, Gg, Gg, Gg
Gg, Gg, Gg, Gg, Gg, Gg, Gg, Rp, Gg, Gg, Gg, Gs^Fms, Gs^Fms, Gg, Gg, Wwt, Wwt, Wwt, Wwt, Wwt, Wwt, Gg, Gg, Gg, Gg^Eff, Gg^Eff, Gg^Eff, Gg, Gg^Eff, Gg, Rb^Gvs, Rb^Gvs, Rb^Gvs, Gg, Gg, Gg, Gs^Fms, Gll, Gg, Gg, Rb^Gvs, Rb^Gvs, Rb^Gvs, Gg^Eff, Gg^Eff, Gg, Gg
Gg, Gg, Gg, Gg, Gg, Gg, Gg, Rp, Rp, Gg, Gg, Gg, Gg, Gg, Gg, Gs^Fms, Gs^Fms, Gg, Gs^Fms, Wwt, Wwt, Gs^Fms, Gg^Fet, Gg^Eff, Rb^Gvs, Gs^Vl, Rb^Gvs, Gg^Eff, Re, Rb^Gvs, Rb^Gvs, Rb^Gvs, Rb^Gvs, Gs^Vl, Gg, Gg, Gs^Fms, Gs^Fms, Re, Gs^Vl, Rb^Gvs, Rb^Gvs, Rb^Gvs, Rb^Gvs, Gg^Eff, Gg^Eff, Gg
Gg, Gg, Gg^Es, Gg, Gg, Gg, Gg, Gg, Gg, Rp, Rp, Gg, Gg, Gg^Es, Gs^Fms, Gll, Gg, Gg, Gg, Wwt, Wwt, Wwt, Gs^Fms, Rb^Gvs, Rb^Gvs, Rb^Gvs, Rb^Gvs, Rb^Gvs, Gg^Eff, Gg^Eff, Gg^Eff, Rb^Gvs, Re^Wm, Re, Gg, Gg, Re, Re, Gg^Eff, Gg^Eff, Gg^Eff, Rb^Gvs, Gg^Eff, Gg^Eff, Gg, Gg, Gg
Gg, Gg, Gg, Gg, Gs^Fms, Gs^Vl, Gg, Gg, Gg, Gg, Rp, Gg, Gg, Gg, Gg, Gg, Gg, Gg^Es, Gg, Gs^Fms, Wwt, Wwt, Gg, Gg^Eff, Gg^Eff, Rb^Gvs, Gg^Eff, Gg^Eff, Gg, Gg, Gg^Eff, Gg^Eff, Rb^Gvs, Rb^Gvs, Rb^Gvs, Re, Gg^Eff, Gg^Eff, Gg, Gg, Gg, Gg^Eff, Gg, Gg, Gs^Fms, Gg, Gg
Gg, Gg, Gs^Fms, Gll, Gs^Fms, Gs^Fms, Gll, Gs^Fms, Gg, Gg, Gg, Rp, Gg, Gg, Gg, Gg, Gg, Gg, Gg, Gs^Fms, Wwt, Wwt, Gg, Gg, Gg, Gg^Eff, Gg, Gs^Fms, Gg, Gg, Gg^Eff, Rb^Gvs, Rb^Gvs, Rb^Gvs, Rb^Gvs, Rb^Gvs, Gg^Eff, Gg^Eff, Gg, Gg, Gg, Gg, Gs^Fms, Gs^Fms, Gg, Gg, Gg^Es
Gg, Gs^Fms, Gll, Gs^Fms, Gg^Fet, Gll, Gll, Gs^Fms, Gg, Gg, Gg^Es, Rp, Gg, Gg, Ch, Ch, Ch, Gg, Gg, Wwt, Wwt, Wwt, Gg, Gg^Es, Gg, Gg, Gg, Gg, Gg, Gg, Gg, Gg^Eff, Gg^Eff, Rb^Gvs, Gs^Fms, Gg, Gg, Gg, Gg, Gg^Es, Gg, Gg, Gs^Fms, Gg, Gg, Gg, Gg
Gg, Gs^Fms, Gll, Gll, Gll, Gll, Gs^Fms, Gs^Fms, Gg, Gg, Gg, Rp, Gg^Fet, Gg, Gg, Kh, Gg, Gg, Gs^Fms, Wwt, Wwt, Gg, Gs^Fms, Gg, Gg, Gs^Fms, Gg, Gg, Gg, Gs^Fms, Gg, Gg, Gg, Gg^Eff, Gg, Gs^Fms, Gs^Fms, Gg, Gg, Gg, Gg, Gg, Gg, Gg, Gg^Es, Gg, Gg
Gll, Gs^Fms, Gs^Fms, Gs^Fms, Gs^Fms, Gs^Fms, Gll, Gll, Gg, Gg, Gg, Rp, Gg, Gg, Rp, Rp, Gg, Gs^Fms, Wwt, Wwt, Wwt, Gs^Fms, Gs^Fms, Gg, Gll, Gs^Fms, Gg, Gg, Gg^Efm, Gg, Gg, Gg, Gg, Gg, Gg, Gg, Gg, Gg, Gg, Gg, Gg^Efm, Gg, Gg, Gg, Gg, Gg, Gg
Gs^Fms, Gll, Gs^Fms, Gs^Fms, Gll, Gs^Fms, Gll, Gs^Fms, Gg^Efm, Gg, Gg, Rp, Rp, Rp, Gg, Gg, Gg, Gs^Fms, Wwt, Wwt, Hh^Fms, Hh^Fms, Hh^Fms, Gs^Fms, Gll, Gll, Gg, Gg, Gg^Efm, Gg^Efm, Gg, Gg, Gg, Gg^Es, Gg, Gg, Gg, Gg, Gg, Gg^Efm, Gg^Efm, Gg^Efm, Gg, Gg, Hh, Hh, Hh
Gs^Fms, Gs^Fms, Gs^Fms, Gll, Gs^Fms, Gs^Fms, Gs^Fms, Gs^Fms, Gg^Efm, Gg^Efm, Gg, Rp, Gg, Gg, Gg, Gg, Gg, Gg, Wwt, Wwt, Wwt, Hh^Fms, Hh^Fms, Gs^Fms, Gg, Gs^Fms, Gg, Gg, Gg^Efm, Gg, Gs^Fms, Gs^Fms, Gs^Fms, Gg, Gg, Gg, Gg, Gg, Gg, Gg^Efm, Gg, Gg^Efm, Gg, Hh, Hh, Hh, Hh
Gg, Gg, Gg, Gs^Fms, Gg, Gg, Gg, Gg, Gg, Gg^Efm, Gg, Rp, Gg, Gg, Gs^Fms, Hh, Hh, Hh, Hh, Wwt, Wwt, Hh^Fms, Wwt, Wwt, Wwt, Gg, Gg, Gg, Gg, Gs^Fms, Gs^Fms, Gll, Gll, Gs^Fms, Gg, Gg, Gg, Gg, Gg, Gg, Gg, Gg, Gg, Hh, Hh, Hh, Hh
Gg, Gg, Gg, Gg, Gg^Es, Gg, Gg^Es, Gg, Gg, Gg, Rp, Rp, Gg, Gs^Fms, Hh^Fms, Hh^Fms, Hh^Fms, Hh, Hh, Wwt, Wwt, Wwt, Wwt, Wwt, Wwt, Wwt, Gg, Gg, Gg, Gg, Gg, Gs^Fms, Gs^Fms, Gs^Fms, Gs^Fms, Gg, Gg, Gg, Gg, Gg, Gg, Gg, Hh, Hh, Hh, Hh^Fms, Hh^Fms
Gg^Es, Gg, Gg, Gg, Gg, Gg, Gg, Gg, Gg, Gg, Rp, Gg, Ch, Gs^Fms, Hh^Fms, Hh^Fms, Hh^Fms, Hh, Hh, Gg, Gll, Wwt, Hh^Fms, Hh^Fms, Wwt, Wwt, Gg, Gg, Gg^Es, Gg, Gg, Gs^Vl, Gs^Fms, Gs^Fms, Gg, Gg, Gg, Gg^Es, Gg, Gg, Hh, Hh, Hh, Hh, Hh^Fms, Hh^Fms, Hh^Fms
Gg, Gg, Gg, Gg, Gs^Fms, Gs^Fms, Gs^Fms, Gs^Fms, Gs^Fms, Ch, Re, Rp, Gg, Gs^Fms, Rr^Vhc, Hh^Fms, Hh^Fms, Hh^Fms, Hh, Gll, Gs^Fms, Gs^Fms, Gs^Fms, Hh^Fms, Wwt, Wwt, Wwt, Gg, Gg, Gg, Gg, Gg, Gs^Fms, Gs^Fms, Gg, Gg, Gg, Gg, Gg, Gg, Hh, Hh, Hh^Fms, Hh^Fms, Hh^Fms, Hh^Fms, Hh^Fms
Gg, Gg, Gll, Gs^Fms, Gll, Gs^Fms, Hh^Fms, Hh^Fms, Hh^Fms, Gs^Fms, Re, Rp, Rp, Re, Re, Re, Re, Hh^Fms, Gs^Fms, Gs^Fms, Gll, Gs^Fms, Gs^Fms, Gs^Fms, Gg, Wwt, Wwt, Wwt, Wwt, Gg, Gg, Gg, Gg, Gg, Gg, Gg, Gg, Gg, Gg, Hh, Hh, Hh, Hh^Fms, Hh^Fms, Hh^Fms, Hh^Fms, Hh^Fms
Gs^Fms, Gs^Fms, Gll, Gs^Fms, Gll, Hh, Hh^Fms, Hh^Fms, Re, Re, Re, Ch, Ch, Ch, Rp, Rr^Vhc, Re, Hh^Fms, Gs^Fms, Gs^Fms, Gs^Fms, Gs^Fms, Gs^Fms, Gg, Gg, Gg, Gg, Wwt, Wwt, Wwt, Wwt, Gg^Es, Gg, Gg, Gg^Efm, Gg^Efm, Gg, Gg, Gg, Hh, Hh, Hh^Fms, Hh^Fms, Hh^Fms, Hh^Fms, Hh^Fms, Hh^Fms
Gs^Fms, Gll, Gs^Fms, Gs^Fms, Gll, Hh, Hh^Fms, Hh^Fms, Rr^Vhc, Gg^Es, Ch, Ch, 2 Kh, Ch, Ch, Rp, Rp, Gs^Fms, Gs^Fms, Gll, Gs^Fms, Gg^Fet, Gs^Fms, Gg, Gg^Es, Gg, Gs^Fms, Gg, Gg, Wwt, Wwt, Gs^Vl, Gg, Gg, Gg, Gg^Efm, Gg, Gg, Gg^Es, Gg, Hh, Hh^Fms, Hh^Fms, Hh^Fms, Hh^Fms, Hh^Fms, Hh^Fms
Gll, Gs^Fms, Gll, Gs^Fms, Gs^Fms, Gs^Fms, Hh^Fms, Hh^Fms, Gg, Re, Re, Ch, Ch, Ch, Re, Gg, Rp, Gg, Gg, Gs^Fms, Gs^Fms, Gll, Gs^Fms, Gg, Gg, Gg, Gs^Fms, Gll, Gg, Wwt, Wwt, Wwt, Gg, Gg, Gg, Gg^Efm, Gg^Efm, Gg, Gg, Gg, Hh, Hh, Hh, Hh^Fms, Hh^Fms, Hh^Fms, Hh^Fms
Gs^Fms, Gs^Fms, Gs^Fms, Gll, Gll, Gs^Fms, Hh^Fms, Hh^Fms, Hh^Fms, Gg^Es, Gg, Ch, Re, Ch, Hh^Fms, Hh^Fms, Hh, Rp, Rp, Gg, Gs^Fms, Gll, Gs^Fms, Gg, Gg, Gg, Gg, Gs^Fms, Gg, Gg, Wwt, Wwt, Wwt, Gg, Gg, Gg, Gg, Gg, Gg, Gg, Gg, Hh, Hh, Hh, Hh^Fms, Hh^Fms, Hh^Fms
Gll, Gs^Fms, Gs^Fms, Gll, Gs^Fms, Hh, Hh, Hh^Fms, Hh^Fms, Hh^Fms, Hh^Fms, Gg, Rr^Vhc, Re, Hh^Fms, Hh^Fms, Hh, Gg, Rp, Gg, Gg, Gs^Fms, Gs^Fms, Gg^Es, Gg, Gg, Gg, Gll, Gg, Gg, Gg, Wwt, Wwt, Gs^Fms, Gg^Fet, Gg, Gg^Efm, Gg, Gs^Fms, Gg, Gg, Gg, Gg, Hh, Hh, Hh, Hh
Gll, Gll, Gll, Gs^Fms, Gs^Fms, Gs^Fms, Gll, Gs^Fms, Gs^Fms, Hh^Fms, Hh, Hh^Fms, Hh^Fms, Hh^Fms, Hh^Fms, Hh, Gg, Gg, Rp, Gg, Gg, Gs^Fms, Gs^Fms, Gg, Gs^Vl, Gg, Gg, Gs^Fms, Gg, Gg^Es, Gg, Wwt, Wwt, Gs^Fms, Gs^Fms, Gg, Gg^Efm, Gg, Gg, Gs^Fms, Gs^Fms, Gg, Gg^Es, Gg, Gg, Hh, Hh
Gll, Gs^Fms, Gll, Gll, Gs^Fms, Gs^Fms, Gs^Fms, Gs^Fms, Gg, Hh, Gg, Hh, Gs^Fms, Hh^Fms, Gs^Fms, Gs^Fms, Gg, Gg, Rp, Gg, Gg, Gs^Es, Gs^Fms, Gg, Gg, Gg, Gg^Fet, Gg, Gg, Gg, Gg, Wwt, Wwt, Wwt, Wwt, Gg, Gg^Efm, Gg^Efm, Gg, Gg, Gg, Gg, Gg^Es, Gg, Gg, Gg, Gg
Gs^Fms, Gs^Fms, Gs^Fms, Gs^Fms, Gll, Gs^Fms, Gs^Fms, Gll, Gll, Gll, Gs^Fms, Gll, Gs^Fms, Gs^Fms, Gll, Gs^Fms, Gg, Gg, Rp, Gg, Gs^Fms, Gll, Gll, Gg, Gg, Gg^Es, Gg, Gg, Gg, Gs^Fms, Gll, Gg, Gg, Wwt, Wwt, Wwt, Wwt, Wwt, Wwt, Gg, Gg, Gg^Es, Gg, Gs^Fms, Gs^Fms, Gg, Gg
Gs^Fms, Gs^Fms, Gs^Fms, Gll, Gs^Fms, Gs^Fms, Gg, Gs^Fms, Gs^Fms, Gs^Fms, Gg, Gs^Fms, Gg, Gs^Fms, Gs^Fms, Gs^Fms, Gg, Gg, Rp, Gg, Gg, Gs^Fms, Gs^Fms, Gs^Fms, Gs^Fms, Gg, Gg, Gg, Gg, Gs^Fms, Gs^Fms, Gs^Fms, Gs^Fms, Gg, Gg, Wwt, Wwt, Wwt, Wwt, Wwt, Gg, Gg, Gg, Gg, Gg, Gs^Fms, Gg
