border_size=1
usage=map

Hh^Fms, Hh^Fms, Hh^Fms, Hh^Fms, Hh^Fms, Gll, Gs^Fms, Gll, Gs^Fms, Gll, Gs^Fms, Gs^Fms, Gll, Gs^Fms, Hh^Fms, Hh^Fms, Hh^Fms, Gs^Fms, Gg, Rp, Rp, Rp, Gg, Gg, Gg, Gg, Gg, Gg, Gs^Fms, Gg, Gg, Gg, Gg, Gg, Gg, Gg, Gg, Gg, Gg, Gg, Gg, Gg, Gg, Gg, Gg, Gg, Gg, Gg, Gg, Gg, Gg, Gg, Gg, Gg, Gg, Gg, Gg, Gg, Gg, Gll, Gs^Fms, Gs^Fms, Gs^Fms, Gs^Fms, Gs^Fms, Gs^Fms, Gs^Fms
Hh^Fms, Hh^Fms, Gs^Fms, Hh^Fms, Gs^Fms, Gs^Fms, Gll, Gs^Fms, Gll, Gs^Fms, Gg, Gg, Gg, Gs^Fms, Gs^Fms, Hh^Fms, Gs^Fms, Gs^Fms, Gg, Rp, Rp, Rp, Gg, Gg, Gg, Gg, Gg, Gs^Fms, Gll, Gg, Gg, Gg, Gs^Fms, Gg, Gg, Gg, Gg, Gg, Gg, Gg, Gg, Gg, Gg, Gg, Gg, Gg, Gg, Gg, Gg^Efm, Gg, Gg, Gg, Gg, Gg, Gg, Gg, Gg, Gg, Gg, Gg, Gll, Gs^Fms, Gg, Gll, Gll, Gll, Gs^Fms
Hh^Fms, Gs^Fms, Gll, Gs^Fms, Gg, Gg^Fet, Gg, Gg, Gg, Gg, Gg, Gg, Rp, Gg, Gg, Gs^Fms, Gg, Gg, Rp, Rp, Rp, Rp, Gg, Gg, Gs^Vl, Gg, Gg, Gs^Fms, Gg, Gg, Gll, Gs^Fms, Gg, Gll, Gs^Fms, Gg, Gs^Fms, Gg, Gg, Gg, Gg, Gg, Gg, Gg, Gg, Gg, Gg, Gg, Gg^Efm, Gg^Efm, Gg^Efm, Gg, Gg, Gg, Gg^Es, Gg, Gg, Gg, Gg, Gg, Gg, Gg^Es, Gg, Gg, Gg, Gg, Gs^Fms
Gs^Fms, Gs^Fms, Gg, Gg, Gg, Gg, Gg, Gs^Vl, Gg^Es, Gg, Rp, Rp, Rp, Rp, Rp, Gg, Rp, Rp, Rp, Rp, Rp, Rp, Gg, Gg, Gg, Gg^Es, Gg, Gg, Gg, Gg, Gll, Gs^Fms, Gll, Gll, Gll, Gll, Gs^Fms, Gll, Gg, Gg, Gg, Gg, Gg, Gg, Gg^Es, Gg, Gg^Efm, Gg, Gg^Efm, Gg, Gg, Gg, Gg, Gg, Gg, Gg, Gg, Gg, Gg, Gg, Gg^Efm, Gg, Gg, Gg^Efm, Gg, Gg, Gg
Gll, Gll, Gg, Gg, Gg^Efm, Gg^Efm, Gg, Gg, Rp, Rp, Rp, Rp, Gg, Rp, Rp, Rp, Rp, Rp, Gg, Rp, Rp, Rp, Gg, Gg, Gg, Gg, Gg, Gg, Gg, Gs^Fms, Gs^Fms, Gs^Fms, Gll, Gg^Fet, Gg, Gg, Gs^Fms, Gs^Fms, Gs^Fms, Gg, Gg, Gg, Gg, Gg, Gg, Gg, Gg, Gg^Efm, Gg, Gg, Gg, Gg, Gg, Gg, Gg, Gg, Gg, Gg, Gg, Gg, Gg, Gg, Gg^Efm, Gg, Gg, Gg, Gg
Gg, Gg^Fet, Gg, Gg, Gg, Gg, Rp, Rp, Rp, Rp, Gg, Gg, Gg, Gg, Gg, Rp, Gg^Es, Gg, Gg, Rp, Rp, Rp, Gg, Gg^Efm, Gg, Gg^Efm, Gg, Gg, Gg, Gg, Gg, Gg, Gg, Gs^Fms, Gg, Gs^Vl, Gs^Fms, Gll, Gg, Gg, Gg, Gg, Gg, Gg, Gs^Vl, Gg, Gg, Gg^Efm, Gg, Gg, Gg, Gg, Gg, Gg, Gg, Gg, Gs^Fms, Gg, Gg, Gg, Gg^Efm, Gg, Gg^Efm, Gg^Efm, Gg, Gg, Gg
Gg, Gg^Es, Gg, Gg, Rp, Rp, Rp, Rp, Gg, Gg^Es, Gg, Gg, Gg, Gg, Gg, Gg, Gg, Gg^Efm, Gg, Rp, Rp, Rp, Gg, Gg, Gg^Efm, Gg^Efm, Gg^Efm, Gg, Gg, Gg^Es, Gg, Gg, Gg, Gg, Gg, Gg, Gs^Fms, Gg, Gg, Gg, Gg, Gg, Gg, Gg, Gg^Efm, Gg, Gg, Gg, Gg, Gg, Gs^Fms, Gs^Fms, Gg, Gg, Gg, Gs^Fms, Gs^Fms, Gll, Gg, Gg, Gg^Efm, Gg^Efm, Gg^Efm, Gg, Gg^Es, Gg, Gg
Gg, Gg, Rp, Rp, Rp, Rp, Gg, Gg, Gg, Gg, Gg^Efm, Gg^Efm, Gg, Gg, Gg^Efm, Gg, Gg^Efm, Gg^Efm, Gg, Rp, Rp, Rp, Gg, Gg, Gg, Gg, Gg, Gg, Gg, Gg, Gg, Gg, Gg^Efm, Gg, Gg^Efm, Gg, Gg, Gg, Gg, Gg, Gg, Gg, Gg, Gg, Gg, Gg, Gg^Efm, Gg, Gg, Gg, Gg, Gll, Gg, Gg, Gs^Fms, Gg^Fet, Gll, Gs^Fms, Gg, Gg, Gg, Gg^Efm, Gg^Efm, Gg, Gg^Efm, Gg, Gg
Rp, Rp, Rp, Rp, Gg, Gg, Gg, Gg^Efm, Gg, Gg, Gg, Gg, Gg, Gg, Gg, Gg, Gg, Gg, Gg, Rp, Rp, Rp, Gg, Gg, Gg, Gg, Gg, Gg, Gg, Gg, Gg, Gg, Gg, Gg, Gg, Gg^Efm, Gg, Gg, Gg, Gg^Efm, Gg^Efm, Gg, Gg^Es, Gg, Gg, Gg^Efm, Gg, Gg^Efm, Gg, Gg, Gg, Gg, Gs^Fms, Gs^Fms, Gll, Gg, Gg, Gll, Gs^Fms, Gg, Gg, Gg, Gg, Gg, Gg, Gg, Gg
Rp, Rp, Gg, Gg, Gg, Gg, Gg^Efm, Gg, Gg, Gg, Gg, Gg, Ch, Ch, Ch, Ch, Ch, Ch, Kh, Rp, Rp, Rp, Kh, Ch, Ch, Ch, Ch, Ch, Ch, Gg, Gg, Gg, Gg, Gg, Gg^Efm, Gg^Es, Gg, Gg, Gg, Gg, Gg, Gg, Gg, Gg, Gg, Gg, Gg^Efm, Gg^Efm, Gg, Gg, Gg, Gg, Gs^Fms, Gll, Gll, Gs^Fms, Gg, Gg, Gs^Fms, Gg, Gg^Efm, Gg, Gg^Efm, Gg, Gg, Gg^Efm, Gg
Gg, Gg, Gg, Gg, Gg, Gg, Gg, Gg, Gg, Gg, Ch, Ch, Rr, Rr, Rr, Rr, Rr, Rr, Rr, Rr, Rr, Rr, Rr, Rr, Rr, Rr, Rr, Rr, Rr, Ch, Ch, Gg, Gg, Gg, Gg, Gg^Efm, Gg, Gg, Gg, Gg, Gg, Gg, Gg, Gg, Gg, Gg, Gg^Efm, Gg, Gg^Efm, Gg, Gg, Gg, Gg, Gll, Gs^Fms, Gg, Gg, Gg, Gs^Fms, Gg, Gg, Gg^Efm, Gg^Efm, Gg^Efm, Gg, Gg, Gg
Gg, Gg, Gg, Gg^Efm, Gg^Efm, Gg, Gg, Gg, Ch, Ch, Rr, Rr, Gg, Gg, Gg, Gg, Gg^Efm, Gg, Gg^Efm, Gg^Fet, Rr, Gg, Gg^Efm, Gg, Gg^Efm, Gg^Efm, Gg^Efm, Rr^Vhc, Gg, Rr, Rr, Ch, Ch, Gg, Gg, Gg, Gg, Gg, Gg, Gg, Gg^Efm, Gg^Efm, Gg, Gg, Gs^Fms, Gg, Gg, Gg, Gg, Gg^Efm, Gg, Gg, Gg, Gg, Gg, Gg, Gg, Gg, Gg, Gg, Gg, Gg, Gg^Efm, Gg, Gg, Gg, Gg
Gg, Gg^Efm, Gg, Gg, Gg, Gg, Gg, Ch, Rr, Rr, Gg^Fet, Gg^Fet, Gg^Efm, Rr^Vhc, Gg^Efm, Gg, Rr, Rr^Vhc, Rr, Gg, Rr, Gg, Rr, Gg, Rr, Gg, Gg, Gg^Efm, Gg^Fet, Gg, Gg, Rr, Rr, Ch, Gg, Gg, Gg, Gg^Es, Gg, Gg, Gg, Gg^Efm, Gg, Gg, Gs^Fms, Gg, Gg, Gg, Gg, Gg, Gg, Gg, Gg, Gg^Es, Gg, Gg, Gg, Gg, Gg, Gg, Re^Vct, Gg, Gg, Gg^Efm, Gg, Gg, Gg
Gg, Gg^Efm, Gg, Gg, Gg, Gg^Es, Gg, Ch, Rr, Gg, Gg^Efm, Gg^Fet, Gg, Gg, Rr, Rr, Gg^Fet, Rr, Gg^Fet, Rr, Rr, Rr, Gg^Fet, Rr, Gg^Fet, Rr, Rr^Cov, Gg, Gg, Gg^Fet, Gg^Efm, Gg, Rr, Ch, Gg, Gg, Gg, Gg, Gg, Gg^Fet, Gs^Vl, Gg, Gg, Gg, Gg, Gll, Gs^Fms, Gg, Gg, Gg^Efm, Gg^Fet, Gg^Efm, Gg, Gg, Gg, Gg, Gg, Gg, Gg, Gg, Gg, Gg, Gg, Gg, Gg, Gg^Es, Gg
Gg, Gg^Efm, Gg, Gg, Gg, Gg, Ch, Ch, Rr, Gg, Gg, Gg, Rr, Rr, Gg, Gg, Gg^Efm, Gg^Fet, Gg^Efm, Gg^Efm, Rr, Gg, Gg^Efm, Gg^Fet, Rr^Vhc, Gg^Cov, 1 Gg^Kov, Rr^Kov, Rr, Rr^Vhc, Gg^Efm, Gg, Rr, Ch, Ch, Gg, Gg, Gg, Gg, Gg, Gg^Efm, Gg, Gg, Gg, Gg, Gll, Gll, Gg, Gg^Efm, Gg, Gg, Gg^Efm, Gg, Gg, Gg, Gg, Gg, Gg, Gg^Es, Gg, Ce, Ce, Ce, Ce, Ce, Gg, Gg
Gg, Gg^Efm, Gg, Gg, Gg^Efm, Gg, Ch, Rr, Gg, Rr, Rr, Rr, Gg, Gg, Gg^Efm, Rr^Vhc, Gg, Gg, Rr, Gg, Rr, Gg, Rr, Gg, Gg^Efm, Gg^Cov, Gg^Cov, Gg^Cov, Gg, Rr, Rr, Rr, Gg, Rr, Ch, Gg, Gg, Gg, Gg^Efm, Gg, Gg, Gg, Gg, Gs^Fms, Gs^Fms, Gs^Fms, Gs^Fms, Gg, Gg, Gg, Gg, Gg^Efm, Gg, Gg, Gg, Gg, Re^Vct, Gg, Gg, Gg, Ce, Re^Vct, Ce, Re^Vct, Ce, Gg, Gg
Gg, Gg^Efm, Gg^Efm, Gg, Gg, Gg, Ch, Rr, Gg^Efm, Gg, Rr, Rr, Rr, Gg, Gg, Gg, Rr, Rr, Wwt, Rr, Wwt^Bsb|, Rr, Wwt, Rr, Rr, Gg^Efm, Gg, Gg, Rr, Rr, Rr, Gg, Gg^Efm, Rr, Ch, Gg, Gg, Gg, Gg^Efm, Gg, Gg, Gg, Gg, Gg, Gs^Fms, Gg^Fet, Gg, Gg, Gg, Gg^Efm, Gg^Efm, Gg, Gg, Gg, Gs^Fms, Gs^Fms, Gg, Gg, Gg, Ce, Re^Vct, Ce, 2 Ke, Ce, Re^Vct, Ce, Gg
Gg, Gg, Gg, Gg, Gg, Gg, Ch, Rr, Gg, Gg, Rr, Rr^Vhc, Gg, Rr, Rr, Rr, Wwt, Wwt, Ch, Wwt, Wwt^Bsb|, Wwt, Ch, Wwt, Wwt, Rr, Rr, Rr, Gg^Efm, Gg, Rr, Gg, Gg^Fet, Rr, Ch, Gg, Gg, Gg, Gg, Gg^Efm, Gg, Gg, Gg^Efm, Gg, Gg, Gs^Fms, Gll, Gg, Gg, Gg, Gg, Gg, Gg, Gg, Gs^Fms, Gg^Fet, Gg, Gg, Gg, Ce, Ce, Ce, Ce, Ce, Ce, Ce, Gg
Gg, Gg, Gg^Es, Gg, Gg, Gg, Ch, Rr, Gg, Gg^Efm, Rr, Gg^Efm, Gg^Fet, Gg^Fet, Rr, Wwt, Ch, Ch, Gg, Ch, Gg, Ch, Gg, Ch, Ch, Wwt, Rr, Gg^Fet, Gg^Fet, Gg^Efm, Rr, Gg^Fet, Rr^Vhc, Rr, Ch, Gg, Gg, Gg, Gg, Gg, Gg, Gg, Gg, Gg, Gg, Gg, Gg, Gs^Fms, Gg, Gg, Gg, Gg, Gg, Gg, Gg, Gs^Fms, Gs^Fms, Gg, Gg, Gg, Ce, Re^Vct, Ce, Re^Vct, Ce, Gg, Gg
Gg, Gg, Gg, Gg, Gg, Gg, Ch, Rr, Gg^Efm, Gg^Efm, Rr, Gg, Gg^Efm, Rr, Wwt^Bsb\, Wwt, Ch, Gg, Gg^Efm, Gg, Gg, Gg^Efm, Gg^Efm, Gg^Efm, Ch, Wwt, Wwt^Bsb/, Rr, Gg^Fet, Gg^Efm, Rr, Gg^Efm, Gg^Efm, Rr, Ch, Gg, Gg, Gg, Gg, Gg, Gg, Gg, Gg, Gg, Gg, Gg, Gg, Gg, Gg, Gg, Gg, Gg, Gg, Gg, Gg, Gg, Gg, Gg, Re^Vct, Gg, Gg, Ce, Gg, Ce, Gg, Gg, Gg
Gg, Gg, Gg, Gg, Gg, Gg, Kh, Rr, Gg, Gg, Rr, Gg, Gg^Efm, Rr, Wwt, Wwt^Bsb\, Gg, Gg^Efm, Ch, Ch, Kh, Ch, Ch, Gg, Gg, Wwt^Bsb/, Wwt, Rr, Gg^Efm, Gg, Rr, Gg, Gg, Rr, Kh, Gg, Rp, Gg, Rp, Gg, Rp, Gg, Rp, Gg, Rp, Gg, Rp, Gg, Rp, Gg, Rp, Gg, Rp, Gg, Rp, Gg, Rp, Gg, Rp, Gg, Rp, Gg, Rp, Gg, Rp, Gg, Rp
Rp, Rp, Rp, Rp, Rp, Rp, Rp, Rr, Rr, Rr^Vhc, Rr, Gg, Rr, Rr, Wwt, Ch, Gg^Efm, Gg, Kh, Rrc, Ch, Rrc, Kh, Gg^Efm, Gg^Efm, Ch, Wwt, Rr, Rr, Rr, Rr, Rr, Rr, Rr, Rp, Rp, Rp, Rp, Rp, Rp, Rp, Rp, Rp, Rp, Rp, Rp, Rp, Rp, Rp, Rp, Rp, Rp, Rp, Rp, Rp, Rp, Rp, Rp, Rp, Rp, Rp, Rp, Rp, Rp, Rp, Rp, Rp
Rp, Rp, Rp, Rp, Rp, Rp, Rp, Rr, Rr, Rr, Rr, Rr, Rr, Rr, Wwt, Ch, Gg, Ch, Rrc, Ch, 3 Kh, Ch, Rrc, Ch, Gg, Ch, Wwt, Rr, Rr, Rr, Rr, Rr, Rr, Rr, Rp, Rp, Rp, Rp, Rp, Rp, Rp, Rp, Rp, Rp, Rp, Rp, Rp, Rp, Rp, Rp, Rp, Rp, Rp, Rp, Rp, Rp, Rp, Rp, Rp, Rp, Rp, Rp, Rp, Rp, Rp, Rp, Rp
Rp, Rp, Rp, Rp, Rp, Rp, Kh, Rr, Gg^Fet, Rr, Rr, Rr, Gg, Rr, Wwt, Ch, Gg^Efm, Ch, Kh, Ch, Ch, Ch, Kh, Ch, Gg, Ch, Wwt, Rr, Gg^Efm, Rr^Vhc, Rr, Gg, Gg, Rr, Kh, Rp, Gg, Rp, Gg, Rp, Gg, Rp, Gg, Rp, Gg, Rp, Gg, Rp, Gg, Rp, Gg, Rp, Rp, Rp, Gg, Rp, Gg, Rp, Gg, Rp, Gg, Rp, Gg, Rp, Gg, Rp, Gg
Gg, Gg, Gg, Gg, Gg, Gg, Ch, Rr, Gg^Efm, Gg^Fet, Rr, Gg^Efm, Gg^Efm, Rr, Wwt, Ch, Gg, Gg^Efm, Ch, Rrc, Kh, Rrc, Ch, Gg^Efm, Gg, Ch, Wwt, Rr, Gg, Gg^Efm, Rr, Gg^Efm, Gg, Rr, Ch, Gg, Gg, Gg, Gg, Gg, Gg, Gg, Gs^Fms, Gg, Gg, Gg, Gg, Gg, Gg, Gg, Gg, Gg, Rp, Rp, Gg, Gg, Gg, Gg, Gg, Gg, Gg, Gg, Gg, Gg, Gg, Gg, Gg
Gg, Gg, Gg, Gg^Es, Gg, Gg, Ch, Rr, Gg, Rr^Vhc, Rr, Gg, Gg^Efm, Rr, Wwt^Bsb/, Wwt^Bsb/, Ch, Gg^Efm, Gg, Ch, Gg^Efm, Ch, Gg, Gg^Efm, Ch, Wwt^Bsb\, Wwt^Bsb\, Rr, Gg^Efm, Gg, Rr, Gg^Fet, Gg^Efm, Rr, Ch, Gg, Gg, Gg, Gg^Efm, Gg, Gg, Gg, Gs^Fms, Gg, Gg, Gg, Gg, Gg, Gg, Gg, Gg, Gg, Rp, Rp, Gg, Gg^Es, Gg, Gg, Gs^Fms, Gg, Gg, Gg, Gs^Vl, Gg, Gg^Es, Gg, Gg
Gg, Gg, Gg, Gg^Efm, Gg^Efm, Gg, Ch, Rr, Gg, Gg^Efm, Rr, Gg^Efm, Gg, Rr, Rr, Wwt, Ch, Gg^Efm, Gg, Gg^Efm, Gg, Gg^Efm, Gg^Efm, Gg, Ch, Wwt, Rr, Rr, Gg^Efm, Gg^Efm, Rr, Gg, Gg^Efm, Rr, Ch, Gg, Gg, Gg^Efm, Gg^Efm, Gg, Gg, Gg, Gll, Gg, Gg, Gg, Gg, Gg, Gg, Gg, Gg, Gg, Rp, Rp, Gg, Gg, Gg, Gg, Gll, Gg, Gg, Gg, Gg, Gg, Gg, Gg, Gg
Gg, Gg, Gs^Fms, Gg, Gg, Gg, Ch, Rr, Gg, Gg^Efm, Rr, Gg, Rr, Rr, Rr, Wwt, Wwt, Ch, Ch, Ch, Wwt^Bsb|, Ch, Ch, Ch, Wwt, Wwt, Rr, Rr, Rr, Gg, Rr, Gg^Efm, Rr^Vhc, Rr, Ch, Gg, Gg, Gg, Gg, Gg, Gg, Gg, Gg^Fet, Gs^Fms, Gll, Gs^Fms, Gg, Gg, Gg, Gg^Fet, Gg, Gg, Rp, Rp, Gg, Gg, Gg, Gs^Fms, Gg^Fet, Gg, Gg, Gg, Gg, Gg, Gg, Gg, Gg
Gg, Gg, Gg^Fet, Gs^Fms, Gg, Gg, Ch, Rr, Gg^Efm, Gg^Fet, Rr, Rr, Gg^Efm, Gg, Gg^Efm, Rr, Wwt^Bsb\, Wwt, Wwt, Wwt, Wwt^Bsb|, Wwt, Wwt, Wwt, Rr, Rr, Gg, Gg, Gg, Rr, Rr, Gg^Fet, Gg^Fet, Rr, Ch, Gg, Gg, Gg, Gg, Gg, Gll, Gs^Fms, Gg, Gll, Gg, Gs^Fms, Gs^Vl, Gg, Rb^Gvs, Gg, Gg, Gg, Rp, Rp, Gg, Gg, Gg, Gs^Fms, Gs^Fms, Gg, Gg, Gg, Gg, Gg, Gg, Gg, Gg
Gg^Efm, Gg, Gg, Gs^Fms, Gg, Gg, Ch, Rr, Rr, Gg^Fet, Gg^Fet, Rr, Rr, Gg, Wwt, Wwt, Gg, Rr, Rr, Rr, Rr, Rr, Rr, Rr, Rr^Vhc, Gg^Efm, Gg^Efm, Gg^Efm, Rr, Rr, Gg^Efm, Gg, Rr, Rr, Ch, Gg, Gg, Gg, Gg, Gs^Fms, Gll, Gg, Gll, Gs^Fms, Gg, Gg, Rb^Gvs, Rb^Gvs, Rb^Gvs, Rb^Gvs, Rb^Gvs, Gg, Rp, Rp, Rp, Gg, Gg, Gg, Gg, Gs^Fms, Gg, Gg^Es, Gg, Gg, Gg, Gg, Gg
Gg, Gg^Efm, Gg, Gg, Gg, Gg, Gg, Ch, Rr, Gg, Gg^Efm, Rr^Vhc, Wwt, Wwt^Bsb\, Rr, Gg^Fet, Gg^Efm, Gg^Efm, Gg^Efm, Gg^Fet, Rr, Gg^Fet, Gg^Efm, Gg, Gg^Fet, Gg^Fet, Rr, Rr, Gg, Gg, Gg^Fet, Gg, Rr, Ch, Gg, Gg, Gg^Efm, Gg, Gg, Gs^Fms, Gs^Fms, Gll, Gs^Fms, Gg, Gg, Rb^Gvs, Rb^Wm, Rb^Gvs, Rb^Gvs, Rb^Gvs, Rb^Gvs, Rb^Gvs, Rb^Gvs, Rp, Rp, Rp, Rp, Gg, Gg, Gg, Gg, Gg, Gg, Gs^Vl, Gg, Gg, Gg
Gg, Gg^Efm, Gg, Gg, Gg, Gg^Efm, Gg, Ch, Rr, Gg, Wwt, Wwt, Gg^Fet, Gg^Fet, Gg, Rr, Rr, Rr, Rr, Rr, Rr, Rr, Rr, Rr, Rr, Rr, Gg, Gg^Fet, Gg^Efm, Rr^Vhc, Gg^Fet, Gg, Rr, Ch, Gg, Gg, Gg^Efm, Gg^Efm, Gg, Gg, Gg, Gs^Fms, Rb^Gvs, Rb^Gvs, Rb^Gvs, Gg, Gg, Rb^Gvs, Rb^Gvs, Rb^Gvs, Rb^Gvs, Rb^Gvs, Gg, Gg, Gg, Rp, Rp, Rp, Rp, Gg, Gg, Gg, Gg^Fet, Gg, Gg, Gg, Gg
Gg, Gg^Efm, Gg, Gs^Fms, Gs^Fms, Gg^Efm, Gg, Ch, Kh, Rr, Wwt^Bsb\, Gg, Gg, Gg^Efm, Gg^Efm, Rr^Vhc, Gg^Efm, Gg, Gg^Efm, Gg^Efm, Rr, Gg, Gg, Gg, Gg^Efm, Gg, Gg^Efm, Gg^Fet, Gg, Gg^Efm, Rr, Rr, Ch, Ch, Gg, Gg, Gg, Gg, Gg, Gs^Vl, Rb^Gvs, Rb^Gvs, Rb^Gvs, Rb^Gvs, Rb^Gvs, Rb^Gvs, Rb^Gvs, Gg, Gg, Rb^Gvs, Gg, Gg, Gg, Gg^Fet, Gg^Es, Gg, Gg, Rp, Rp, Gg, Gg, Gg, Gg, Gg, Gs^Fms, Gg, Gg
Gg, Gg^Es, Gg, Gs^Fms, Gg, Gg, Gg, Gg, Wwt, Wwt^Bsb\, Kh, Rr, Rr, Gg, Rr, Gg^Efm, Rr, Gg, Rr, Gg, Rr, Rr^Vhc, Rr, Gg, Rr, Gg^Efm, Rr, Gg, Rr, Rr, Ch, Ch, Gg, Gg, Gg, Gg, Gg, Gg, Rb^Gvs, Gg, Gg, Rb^Gvs, Rb^Gvs, Rb^Gvs, Rb^Gvs, Rb^Gvs, Rb^Gvs, Rb^Gvs, Gg, Gg, Gg, Gg, Gg, Gg, Gg, Gg, Gg, Rp, Rp, Gg, Gg, Gg, Gg, Gg, Gs^Fms, Gg, Gg
Gg, Gg, Gg, Gg, Gg, Gg, Gg, Wwt, Gg, Gg, Gg, Ch, Ch, Rr, Ch, Rr, Ch, Rr, Kh, Rr, Rp, Rr, Kh, Rr, Ch, Rr, Ch, Rr, Ch, Ch, Gg, Gg, Gg, Gg, Gg, Gg, Rb^Gvs, Rb^Gvs, Rb^Gvs, Rb^Gvs, Rb^Gvs, Gg, Gg, Rb^Gvs, Rb^Gvs, Rb^Gvs, Gg, Gg, Rb^Gvs, Rb^Gvs, Rb^Gvs, Gg, Gg, Gg, Gg^Efm, Gg^Efm, Gg, Rp, Rp, Rp, Rp, Gg, Gg, Gg, Gs^Fms, Gg, Gg
Gg, Gg, Gg^Fet, Gg, Gg, Gg^Es, Gg, Wwt, Gg, Gg, Gs^Fms, Gg, Gg, Ch, Gg, Ch, Gg, Ch, Gg, Rp, Rp, Rp, Gg, Ch, Gg, Ch, Gg, Ch, Gg, Gg, Gg, Gg, Gg, Gg, Rb^Gvs, Gg, Gg^Wm, Rb^Gvs, Rb^Gvs, Rb^Gvs, Gg, Gg, Gg, Gg, Gg, Gg^Wm, Rb^Gvs, Rb^Gvs, Rb^Gvs, Rb^Gvs, Rb^Gvs, Rb^Gvs, Rb^Gvs, Gg, Gg, Gg^Efm, Gg, Gg, Gg, Rp, Rp, Rp, Gg, Gg, Gg, Gg, Gg
Gg, Gs^Fms, Gs^Fms, Gs^Fms, Gg, Gg, Wwt, Wwt, Gg, Gg, Gll, Gll, Gs^Fms, Gg, Gg, Gg, Gg, Gg, Gg, Rp, Rp, Rp, Gg, Gg, Gg, Gg, Gg, Gg, Gg, Gg, Gg, Gs^Vl, Rb^Gvs, Rb^Gvs, Rb^Gvs, Rb^Gvs, Rb^Gvs, Gg, Gg, Gg, Gs^Fms, Gg, Gg, Gg, Gg, Gg, Gg, Rb^Gvs, Rb^Gvs, Rb^Gvs, Rb^Gvs, Rb^Gvs, Gs^Fms, Gg, Gg, Gg, Gs^Fms, Gg, Gg, Gg, Rp, Rp, Gg, Gg, Gg^Es, Gg, Gg
Gg, Gg, Gs^Fms, Gg, Gg, Wwt, Gg, Gg, Gg, Gg, Gg, Gs^Fms, Gg, Gg, Gg, Gg, Gg, Gg, Gg, Rp, Rp, Rp, Gg, Gg, Gg^Es, Gg, Gg, Gg, Gg, Gg, Gg, Gg, Gg, Rb^Gvs, Rb^Gvs, Rb^Gvs, Gg, Gg, Gg, Gs^Fms, Gg, Gg, Hh, Gg, Gll, Gs^Fms, Gg, Gg, Gs^Vl, Rb^Gvs, Gg, Gg, Gg, Gg, Gg, Gg, Gll, Gg^Fet, Gg, Gg, Rp, Rp, Gg, Gg, Gg, Gg, Gg
Wwt, Gg, Gg, Gg, Wwt, Wwt, Gg, Gg, Gg^Fet, Gs^Fms, Gg, Gg, Gg, Gg, Gs^Vl, Gg, Gg, Gg, Rp, Rp, Rp, Rp, Gg, Gg, Gg, Gg^Efm, Gg, Gg, Gg, Gg, Gs^Fms, Gll, Gs^Fms, Gg, Gg, Gg, Gg, Gg, Gg, Gll, Gg, Hh, Hh^Fms, Hh^Fms, Gs^Fms, Gll, Gg, Gg, Gg, Gg, Gg, Gg, Gg, Gg, Gg^Es, Gg, Gll, Gs^Fms, Gg, Gg, Rp, Rp, Gg^Efm, Gg, Gg, Gs^Fms, Gg
Wwt, Wwt, Wwt, Wwt, Gg, Gg, Gs^Fms, Gg^Fet, Gs^Fms, Gs^Fms, Gg^Efm, Gg^Efm, Gg, Gg^Es, Gg, Gg, Rp, Rp, Rp, Rp, Rp, Rp, Gg, Gg^Efm, Gg^Efm, Gg^Efm, Gg, Gg, Gs^Fms, Gs^Fms, Hh^Fms, Gs^Fms, Gs^Fms, Gs^Fms, Gg, Gg, Gg, Gg, Gg, Gs^Fms, Gg, Hh, Hh, Hh^Fms, Gg, Gll, Gs^Fms, Gg, Gg, Gg, Gg, Gg, Gg, Gg, Gg, Gg, Gs^Fms, Gs^Fms, Gg, Gg, Rp, Rp, Gg^Efm, Gg^Efm, Gg, Gll, Gg
Gg, Gg, Gg, Gg, Gs^Fms, Gll, Gg, Gs^Fms, Gg, Gg, Gg, Gg, Gg, Gg, Rp, Rp, Rp, Rp, Gg, Rp, Rp, Rp, Gg, Gg, Gg, Gg, Gg, Gs^Fms, Gs^Fms, Hh^Fms, Hh^Fms, Hh^Fms, Gs^Fms, Gg^Fet, Gs^Fms, Gg, Gg, Gg^Efm, Gg^Efm, Gg, Gg, Gg, Gg, Gg, Gg, Gg, Gg, Gg, Gg, Gg, Gg, Gs^Fms, Gg, Gg, Gg, Gll, Gg, Gg, Gg, Gg, Rp, Rp, Gg, Gg, Gg, Gs^Fms, Gg
Gg, Gg, Gg, Gg^Fet, Gs^Fms, Gg, Gg, Gg, Gg, Gg^Efm, Gg, Gg^Efm, Rp, Rp, Rp, Rp, Gg, Gg, Gg, Rp, Rp, Rp, Gg, Gg, Gg, Gg, Gs^Fms, Gs^Fms, Gg^Fet, Gs^Fms, Hh^Fms, Hh^Fms, Gs^Fms, Gs^Fms, Gs^Fms, Gg, Gg^Efm, Gg^Efm, Gg^Efm, Gg, Gg, Gg, Gg^Efm, Gg, Gg^Efm, Gg, Gg^Es, Gg, Gg, Gg, Gg, Gs^Fms, Gg, Gg, Gg, Gs^Fms, Gg, Gg, Gg, Gg, Rp, Rp, Gg, Gg, Gg, Gs^Fms, Gg
Gg, Gg, Gg, Gs^Fms, Gg, Gg, Gg, Gg^Es, Gg, Gg, Rp, Rp, Rp, Rp, Gg, Gg, Gg^Fet, Gg^Fet, Gg, Rp, Rp, Rp, Gg, Gg, Gg, Gg, Gs^Fms, Gs^Fms, Gll, Gs^Fms, Gs^Fms, Gs^Fms, Gs^Fms, Gll, Gs^Fms, Gg, Gg, Gg, Gg, Gg, Gg, Gg, Gg, Gg, Gg, Gg, Gg, Gg, Gg, Gg, Gg, Gg, Gg, Gg, Gg, Gg, Gg, Gg, Rp, Rp, Rp, Rp, Gg, Gg, Gg, Gg, Gg
Gs^Fms, Gg, Gg, Gg, Gg, Gg, Gg, Gg, Rp, Rp, Rp, Rp, Gg^Es, Gg, Gg, Gg, Gg, Gg, Gg, Rp, Rp, Rp, Gg, Gg, Gg, Gg, Gg, Gs^Fms, Gs^Fms, Gll, Gll, Gs^Fms, Gll, Gs^Fms, Gg, Gg, Gg, Gg, Gg, Gg^Es, Gg, Gg, Gg, Gg^Efm, Gg^Efm, Gg, Gg, Gg, Gg, Gg, Gg, Gg^Es, Gg, Gg, Gg, Gg, Gg, Rp, Rp, Rp, Gg, Gg, Gg, Gg^Es, Gg, Gg, Gg
Gg, Gg, Gg, Gg, Gg, Gg, Gg, Rp, Rp, Rp, Gg, Gg, Gg, Gg, Gg, Gg, Gg, Gg, Gg, Rp, Rp, Rp, Gg, Gg, Gg, Gg, Gg, Gg, Gg, Gs^Fms, Gs^Fms, Gs^Fms, Gs^Fms, Gs^Fms, Gg, Gg, Gg, Gg, Gg, Gg, Gg, Gg, Gg, Gg, Gg, Gg, Gg, Gg, Gg, Gg, Gg, Gg, Gg, Gg, Gg, Gg, Gg, Rp, Rp, Gg, Gg, Gg, Gg, Gg, Gg, Gg, Gg
