border_size=1
usage=map

Gll, Gll, Gs^Fms, Gg, Gll, Gg, Gg^Efm, Gg, Gg^Efm, Rp, Rp, Rp, Gg^Efm, Gs^Fms, Gs, Gg, Gll, Gg, Gs, Gg, Gs, Gs, Gs, Gg, Gg, Gg, Gs, Gll, Gs^Fms, Gg, Gll, Gll, Gs^Fms, Gs^Fms, Gs^Fms, Hh^Fms, Hh^Fms, Hh^Fms, Mm, Mm, Mm, Mm, Mm, Mm, Mm, Mm, Mm, Mm
Gll, Gs^Fms, Gs^Fms, Gs^Fms, Gs^Fms, Gll, Gs, Gg^Efm, Gg^Efm, Rp, Rp, Rp, Gg^Efm, Gs, Gg^Efm, Gll, Gs^Fms, Gs^Fms, Gs^Fms, Gs, Gll, Gs^Fms, Gs^Fms, Gs, Gg^Efm, Gg, Gs, Gs^Fms, Gg^Fet, Gs, Gll, Gs^Fms, Gs^Fms, Gs^Fms, Gll, Gs^Fms, Hh^Fms, Hh^Fms, Hh^Fms, Mm, Md, Mm, Mm, Mm, Mm, Mm, Mm, Mm
Gs, Gll, Gll, Gll, Gll, Gs^Fms, Gll, Gg, Gg^Efm, Rp, Rp, Rp, Gs, Gll, Gll, Gll, Gs^Fms, Gg^Fet, Gll, Gs, Gg, Gll, Gs, Gg, Gg, Gg^Efm, Gg, Gs, Gll^Efm, Gg, Gs, Gll, Gs^Fms, Gs^Fms, Gs^Fms, Gs^Fms, Hh^Fms, Hh^Fms, Hh^Fms, Md, Md, Md, Mm, Mm, Wwt, Mm, Mm, Mm
Gs, Gll, Gs^Fms, Gs^Fms, Gll, Gs, Gll, Gll, Gg, Rp, Rp, Rp, Gs, Gs^Fms, Gs^Fms, Gs^Fms, Gll, Gs^Fms, Gll, Gg^Efm, Gll, Gg^Efm, Gg^Fet, Gg^Fet, Gs, Gg^Efm, Gs, Gs, Gll, Gs^Fms, Gs, Gll, Gs^Fms, Gll, Gs^Fms, Gs^Fms, Gs^Fms, Hh^Fms, Hh^Fms, Md, Md, Md, Hh^Fms, Wwt, Mm, Mm, Mm, Mm
Gs^Fms, Gll, Gll, Gs, Gs, Gll, Gll, Gs^Fms, Gs, Rp, Rp, Rp, Gg, Gs, Gg, Gll, Gg^Efm, Gs, Gg, Gs^Fms, Gs, Gg^Efm, Gs^Efm, Gg^Fet, Gs, Gg, Gll, Gs^Fms, Gs^Fms, Gll, Gll, Gll, Gs^Fms, Gs^Fms, Gs^Fms, Gll, Gs^Fms, Hh^Fms, Hh^Fms, Hh^Fms, Hh^Fms, Hh^Fms, Wwt, Wwt, Mm, Mm, Mm, Mm
Gll, Gs^Fms, Gg^Efm, Gs, Gs^Fms, Gll, Gg^Fet, Gs^Fms, Gs, Rp, Rp, Rp, Gs, Gg, Gll, Gg^Efm, Gg, Gg^Ve, Gg, Gs, Gg^Efm, Gs, Gs^Fms, Gll, Gll, Gll, Gs^Fms, Gll, Gs^Fms, Gs^Fms, Gs^Fms, Gll, Gs^Fms, Gs^Fms, Gg^Fet, Gs^Fms, Gll, Gs^Fms, Gs^Fms, Hh^Fms, Wwt, Wwt, Hh^Fms, Hh^Fms, Hh^Fms, Mm, Mm, Mm
Gll, Gs, Gs, Gs^Fms, Gs^Fms, Gll, Gll, Gs, Gg^Efm, Rp, Rp, Rp, Gs, Gs^Fms, Gll, Gll, Gg, Gs, Gs, Gg^Efm, Gg, Gs, Gll, Gll, Gs^Fms, Gs^Fms, Gs^Fms, Gg^Fet, Gs^Fms, Gll, Gs^Fms, Gs^Fms, Gg^Fet, Gs^Fms, Gg^Fet, Gs^Fms, Gs^Fms, Gll, Gs^Fms, Gs^Fms, Wwt, Wwt, Hh^Fms, Hh^Fms, Hh^Fms, Mm, Mm, Mm
Gs^Fms, Gll, Gg^Efm, Gll, Gg^Fet, Gg^Efm, Gg, Gll, Gs^Fms, Rp, Rp, Rp, Gg, Gll, Gs^Fms, Gs^Fms, Gll, Gs^Fms, Gg^Efm, Gg^Efm, Gg^Efm, Gll, Gs^Fms, Gs^Fms, Gs^Fms, Gs^Fms, Gs^Fms, Gs^Fms, Gs^Fms, Gs^Fms, Gs^Fms, Gs^Fms, Gs^Fms, Gg^Fet, Gs^Fms, Gs^Fms, Gs^Fms, Gs^Fms, Gg^Fet, Gs^Fms, Wwt, Wwt, Gs^Fms, Hh^Fms, Hh^Fms, Hh^Fms, Hh^Fms, Mm
Gs^Fms, Gll, Gll, Gll, Gg^Fet, Gg^Efm, Gll, Gll, Gs^Fms, Rp, Rp, Rp, Ce, Ce, Ce, Gs^Fms, Gs, Gs, Gg, Gg^Efm, Gll, Gg, Gll, Gs^Fms, Gll, Gs^Fms, Gs^Fms, Gs^Fms, Gs^Fms, Gs^Fms, Gs^Fms, Gs^Fms, Gs^Fms, Gs^Fms, Gs^Fms, Gs^Fms, Gll, Gll, Wwt, Wwt, Wwt, Wwt, Gd^Fetd, Gd^Fetd, Gd^Fetd, Hh^Fms, Gg^Fet, Hh^Fms
Gll, Gs^Fms, Gll, Gs^Fms, Gll, Gs, Gll, Gll, Gs^Fms, Rp, Rp, Rp, Ce, 1 Ke, Ce, Gs^Fms, Gll, Gg, Gg^Fet, Gll, Gs, Gs^Fms, Gg, Gll, Gs^Fms, Gs^Fms, Gs^Fms, Gg^Fet, Gs^Fms, Gs^Fms, Gs^Fms, Gg^Ve, Gll, Gll, Wwt, Gll, Wwt, Wwt, Wwt, Ww^Ewl, Gs^Fms, Gd^Fetd, Rrc^Xfv, Gd^Xff, Gd^Xff, Gd^Fetd, Gd^Fetd, Hh^Fms
Gll, Gs^Fms, Gll, Gll, Gll, Gs^Fms, Gll, Gg^Ve, Gs^Fms, Rp, Rp, Rp, Rp, Ce, Gs^Fms, Gs^Fms, Gll, Gs^Fms, Gs, Gg, Gll, Gs, Gll, Gs, Gs^Fms, Gg^Fet, Gs^Fms, Gs^Fms, Gs^Fms, Gs^Fms, Gs^Fms, Gll, Wwt, Wwt, Ww^Ewl, Ww^Ewl, Wwt, Wwt, Gd, Re^Vct, Gd^Fetd, Gd^Fetd, Gd^Fetd, Gd^Fetd, Gd^Fetd, Gd^Xff, Gd^Fetd, Gd^Fetd
Gll, Gs^Fms, Gs^Fms, Gll, Gll, Gll, Gll, Gll, Gs^Fms, Rp, Rp, Rp, Rp, Rp, Gs^Fms, Gll, Gs^Fms, Gll, Gg^Ve, Gll, Gs^Fms, Gll, Gs^Fms, Gll, Gll, Gs^Fms, Gs^Fms, Gs^Fms, Gll, Gll, Ww^Ewl, Wwt, Ww^Ewl, Wwt, Gg^Fet, Wwt, Gd^Fetd, Gd^Fetd, Gd^Xff, Gd^Fetd, Gs^Fms, Gd^Fetd, Ce, Gd, Re^Vct, Gd^Fetd, Gd^Fetd, Gd^Xff
Gll, Gs^Fms, Gll, Gs^Fms, Gs^Fms, Gll, Gs^Fms, Gll, Gs^Fms, Gs^Fms, Gs^Fms, Rp, Rp, Rp, Gs^Fms, Gs^Fms, Gs^Fms, Gs^Fms, Gs^Fms, Gs^Fms, Gs^Fms, Gs^Fms, Gg^Fet, Gs^Fms, Gll, Gs^Fms, Gg^Fet, Gs^Fms, Gll, Wwt, Ww^Ewl, Wwt, Gs^Fms, Gg^Fet, Gs^Fms, Gs^Fms, Gd^Fetd, Gd^Xff, Gd^Fetd, Gd^Fetd, Ce, Ce, 2 Ke, Ce, Gd^Fetd, Gd^Fetd, Gd^Fetd, Gd^Xff
Gll, Gll, Gll, Gll, Gll, Gll, Gll, Gll, Gll, Gll, Gs^Fms, Rp, Rp, Rp, Rp, Gs^Fms, Gs^Fms, Gs^Fms, Gs^Fms, Gg^Fet, Gs^Fms, Gg^Fet, Gg^Fet, Gs^Fms, Gll, Gs^Fms, Gs^Fms, Gs^Fms, Gs^Fms, Wwt, Wwt, Gg^Ve, Gs^Fms, Gs^Fms, Gs^Fms, Gs^Fms, Gd, Gd^Fetd, Gd^Fetd, Gs^Fms, Gll, Ce, Ce, Ce, Gs^Fms, Gd^Fetd, Gd^Fetd, Gd^Xff
Gs^Fms, Gs^Fms, Gll, Gll, Gll, Gll, Gll, Gll, Gll, Gg^Ve, Gs^Fms, Rp, Rp, Rp, Rp, Rp, Rp, Gs^Fms, Gs^Fms, Gs^Fms, Gs^Fms, Gs^Fms, Gs^Fms, Gs^Fms, Gll, Gs^Fms, Gs^Fms, Gs^Fms, Gs^Fms, Wwt, Wwt, Wwt, Wwt, Gs^Fms, Gs^Fms, Gs^Fms, Gd^Fetd, Gd^Xff, Gd^Fetd, Gd^Fetd, Gd^Fetd, Ce, Gs^Fms, Ce, Gd^Fetd, Gd^Fetd, Gd, Gd^Fetd
Gs^Fms, Gs^Fms, Gs^Fms, Gs^Fms, Gs^Fms, Gll, Gs^Fms, Gs^Fms, Gs^Fms, Gs^Fms, Gs^Fms, Gs^Fms, Gs^Fms, Rp, Rp, Rp, Rp, Rp, Gs^Fms, Gs^Fms, Gs^Fms, Gg^Fet, Gs^Fms, Gll, Gll, Gs^Fms, Gs^Fms, Gg^Fet, Gs^Fms, Gs^Fms, Gs^Fms, Ww^Ewl, Wwt, Ww^Ewl, Gll, Gs^Fms, Gd, Gd^Fetd, Re^Vct, Rrc^Xfv, Gd^Fetd, Gll, Gd^Fetd, Gd^Fetd, Gd^Fetd, Gd^Xff, Re^Vct, Gd
Gll, Gs^Fms, Gs^Fms, Gs^Fms, Gs^Fms, Gs^Fms, Gs^Fms, Gs^Fms, Gs^Fms, Gg^Fet, Gs^Fms, Gs^Fms, Gs^Fms, Gs^Fms, Gs^Fms, Rp, Rp, Rp, Gs^Fms, Gs^Fms, Gll, Gs^Fms, Gs^Fms, Gs^Fms, Gll, Gs^Fms, Gs^Fms, Gs^Fms, Gll, Gs^Fms, Gs^Fms, Gs^Fms, Wwt, Wwt, Wwt, Gll, Gll, Gd^Fetd, Gs^Fms, Gd^Fetd, Gd^Xff, Gd^Fetd, Gd, Gd^Xff, Gd, Gd, Gd, Gd
Gs^Fms, Gs^Fms, Gll, Gs^Fms, Gs^Fms, Gs^Fms, Gs^Fms, Gs^Fms, Gs^Fms, Gs^Fms, Gll, Gs^Fms, Gll, Gs^Fms, Gs^Fms, Rp, Rp, Rp, Gll, Gll, Gs^Fms, Gll, Gll, Gll, Gs^Fms, Gll, Gll, Gll, Gs^Fms, Gll, Gll, Gll, Gs^Fms, Ww^Ewl, Wwt, Gll, Gs^Fms, Gd, Gd, Gd, Gd, Gd, Gs^Fms, Gd, Gs^Fms, Gs^Fms, Gs^Fms, Gs^Fms
Gs^Fms, Gs^Fms, Gs^Fms, Gll, Gs^Fms, Gs^Fms, Gg^Fet, Gll, Gs^Fms, Gs^Fms, Gs^Fms, Gs^Fms, Gs^Fms, Gs^Fms, Gs^Fms, Rp, Rp, Rp, Gs^Fms, Gs^Fms, Gs^Fms, Gs^Fms, Gs^Fms, Gll, Gll, Gs^Fms, Gs^Fms, Gs^Fms, Gg^Fet, Gs^Fms, Gs^Fms, Gs^Fms, Wwt, Wwt, Ww^Ewl, Gs^Fms, Gs^Fms, Gll, Gd, Rrc^Xfv, Gd^Fetd, Gs^Fms, Gs^Fms, Gs^Fms, Gs^Fms, Gs^Fms, Gs^Fms, Gs^Fms
Gs^Fms, Gs^Fms, Gs^Fms, Gll, Gll, Gs^Fms, Gll, Gs^Fms, Gll, Gs^Fms, Gs^Fms, Gs^Fms, Gs^Fms, Gs^Fms, Gll, Rp, Rp, Rp, Gs^Fms, Gs^Fms, Gg^Fet, Gg^Fet, Gs^Fms, Gs^Fms, Gll, Gs^Fms, Gs^Fms, Gg^Fet, Gs^Fms, Gs^Fms, Gs^Fms, Gg^Ve, Ww^Ewl, Wwt, Wwt, Gg^Fet, Gs^Fms, Gll, Gs^Fms, Gd^Fetd, Gg^Fet, Gs^Fms, Gg^Fet, Gg^Fet, Gs^Fms, Gg^Fet, Gg^Fet, Gs^Fms
Gs^Fms, Gll, Gs^Fms, Gs^Fms, Gs^Fms, Gs^Fms, Gll, Gs^Fms, Gs^Fms, Gs^Fms, Gs^Fms, Gg^Ve, Gll, Gll, Gs^Fms, Rp, Rp, Rp, Rp, Gs^Fms, Gs^Fms, Gg^Fet, Cv, Cv, Gll, Gs^Fms, Gs^Fms, Gg^Fet, Gs^Fms, Gs^Fms, Gll, Ww^Ewl, Wwt, Wwt, Gll, Gs^Fms, Gs^Fms, Gll, Gll, Gs^Fms, Gs^Fms, Gs^Fms, Gs^Fms, Gs^Fms, Gs^Fms, Gs^Fms, Gg^Fet, Gs^Fms
Gll, Gs^Fms, Gs^Fms, Gs^Fms, Gg^Fet, Gs^Fms, Gll, Gs^Fms, Gs^Fms, Gs^Fms, Gll, Gll, Gs^Fms, Gs^Fms, Gs^Fms, Rp, Rp, Rp, Rp, Rp, Rp, Gs^Fms, Cv, Gs^Fms, Wwt, Gs^Fms, Ww^Ewl, Gs^Fms, Gs^Fms, Gll, Wwt, Wwt, Ww^Ewl, Gll, Gs^Fms, Gs^Fms, Gs^Fms, Gs^Fms, Gs^Fms, Gll, Gll, Gs^Fms, Gs^Fms, Gs^Fms, Gs^Fms, Gs^Fms, Gs^Fms, Gs^Fms
Gll, Gs^Fms, Gll, Gs^Fms, Gs^Fms, Gs^Fms, Gll, Gll, Gs^Fms, Gs^Fms, Gll, Gs^Fms, Gs^Fms, Gg^Fet, Gs^Fms, Gs^Fms, Gs^Fms, Rp, Rp, Rp, Rp, Rp, Wwt^Bsb\, Ww^Ewl, Ww^Ewl, Wwt, Ww^Ewl, Ww^Ewl, Wwt, Wwt, Wwt, Ww^Ewl, Gs^Fms, Gll, Gs^Fms, Gs^Fms, Gg^Fet, Gs^Fms, Gs^Fms, Gs^Fms, Gll, Gs^Fms, Gll, Gll, Gs^Fms, Gll, Gll, Gs^Fms
Gll, Gs^Fms, Gs^Fms, Gll, Gs^Fms, Gs^Fms, Gs^Fms, Gs^Fms, Gs^Fms, Gs^Fms, Gll, Gs^Fms, Gs^Fms, Gs^Fms, Gs^Fms, Gg^Fet, Gg^Fet, Gs^Fms, Gs^Fms, Rp, Rp, Wwt^Bsb\, Wwt^Bsb\, Wwt^Bsb\, Rp, Wwt, Cv, Wwt, Ww^Ewl, Ww^Ewl, Gs^Fms, Gg^Fet, Gs^Fms, Gs^Fms, Gs^Fms, Gs^Fms, Gs^Fms, Gs^Fms, Gg^Ve, Gs^Fms, Gs^Fms, Gll, Gs^Fms, Gs^Fms, Gs^Fms, Gs^Fms, Gs^Fms, Gll
Gs^Fms, Gs^Fms, Gs^Fms, Gg^Fet, Gs^Fms, Gs^Fms, Gs^Fms, Gll, Gs^Fms, Gs^Fms, Gll, Gs^Fms, Gs^Fms, Gll, Gs^Fms, Gs^Fms, Gll, Gs^Fms, Gs^Fms, Gs^Fms, Cv, Wwt^Bsb\, Wwt^Bsb\, Rp, Rp, Rp, Rp, Kv, Gs^Fms, Gs^Fms, Gg^Fet, Gs^Fms, Gg^Fet, Gg^Fet, Gs^Fms, Gs^Fms, Gll, Gs^Fms, Gs^Fms, Gs^Fms, Gs^Fms, Gs^Fms, Gs^Fms, Gs^Fms, Gs^Fms, Gs^Fms, Gg^Fet, Gs^Fms
Gs^Fms, Gs^Fms, Gs^Fms, Gs^Fms, Gs^Fms, Gs^Fms, Gg^Fet, Gs^Fms, Gs^Fms, Gs^Fms, Gll, Gs^Fms, Gs^Fms, Gs^Fms, Gs^Fms, Gll, Gs^Fms, Gs^Fms, Gs^Fms, Cv, Gs^Fms, Ww^Ewl, Wwt, Rp, Rp, Rp, Rp, Rp, Rp, Gg^Ve, Gs^Fms, Gs^Fms, Gs^Fms, Gs^Fms, Gll, Gll, Gs^Fms, Gll, Gll, Gll, Gs^Fms, Gs^Fms, Gs^Fms, Gg^Fet, Gs^Fms, Gs^Fms, Gs^Fms, Gg^Fet
Gll, Gs^Fms, Gll, Gll, Gll, Gg^Fet, Gs^Fms, Gs^Fms, Gll, Gll, Gs^Fms, Gs^Fms, Gs^Fms, Gg^Fet, Gs^Fms, Gs^Fms, Gs^Fms, Gs^Fms, Gll, Cv, Gs^Fms, Ww^Ewl, Ww^Ewl, Cv, Kv, Rp, Rp, Rp, Rp, Rp, Rp, Gs^Fms, Gll, Gll, Gs^Fms, Gs^Fms, Gg^Fet, Gs^Fms, Gll, Gll, Gs^Fms, Gs^Fms, Gs^Fms, Gs^Fms, Gs^Fms, Gs^Fms, Gs^Fms, Gg^Fet
Gll, Gll, Gs^Fms, Gs^Fms, Gs^Fms, Gs^Fms, Gll, Gll, Gs^Fms, Gs^Fms, Gg^Fet, Gs^Fms, Gs^Fms, Gll, Gs^Fms, Gs^Fms, Gll, Gs^Fms, Gll, Gs^Fms, Gs^Fms, Gs^Fms, Wwt, Wwt, Gs^Fms, Gs^Fms, Gs^Fms, Rp, Rp, Rp, Rp, Rp, Rp, Gs^Fms, Gs^Fms, Gs^Fms, Gs^Fms, Gs^Fms, Gg^Ve, Gll, Gs^Fms, Gs^Fms, Gll, Gs^Fms, Gll, Gs^Fms, Gll, Gll
Gs^Fms, Gs^Fms, Gs^Fms, Gs^Fms, Gll, Gll, Gll, Gs^Fms, Gs^Fms, Gs^Fms, Gg^Fet, Gs^Fms, Gs^Fms, Gll, Gs^Fms, Gs^Fms, Gs^Fms, Gs^Fms, Gs^Fms, Gs^Fms, Gs^Fms, Gs^Fms, Wwt, Ww^Ewl, Wwt, Gs^Fms, Gg^Fet, Gs^Fms, Gs^Fms, Rp, Rp, Rp, Rp, Rp, Rp, Gg^Fet, Gg^Fet, Gs^Fms, Gs^Fms, Gll, Gs^Fms, Gs^Fms, Gs^Fms, Gll, Gs^Fms, Gs^Fms, Gs^Fms, Gs^Fms
Gs^Fms, Gs^Fms, Gll, Gll, Gs^Fms, Gs^Fms, Gll, Gg^Ve, Gs^Fms, Gs^Fms, Gs^Fms, Gs^Fms, Gs^Fms, Gs^Fms, Gs^Fms, Gs^Fms, Gs^Fms, Gs^Fms, Gll, Gs^Fms, Gs^Fms, Gll, Gg^Ve, Ww^Ewl, Ww^Ewl, Gs^Fms, Gs^Fms, Gg^Fet, Gg^Fet, Gs^Fms, Gg^Ve, Rp, Rp, Rp, Rp, Gs^Fms, Gs^Fms, Gs^Fms, Gs^Fms, Gll, Gs^Fms, Gg^Fet, Gs^Fms, Gs^Fms, Gs^Fms, Gs^Fms, Gs^Fms, Gs^Fms
Gll, Gll, Gs^Fms, Gs^Fms, Gg^Fet, Gs^Fms, Gll, Gs^Fms, Gll, Gs^Fms, Gll, Gs^Fms, Gs^Fms, Gs^Fms, Wwt, Gs^Fms, Wwt, Gll, Wwt, Gll, Wwt, Gs^Fms, Gs^Fms, Wwt, Wwt, Gs^Fms, Gs^Fms, Gs^Fms, Gs^Fms, Gs^Fms, Gll, Gll, Rp, Rp, Rp, Gs^Fms, Gs^Fms, Gs^Fms, Gs^Fms, Gs^Fms, Gs^Fms, Gs^Fms, Gs^Fms, Gll, Gll, Gll, Gll, Gs^Fms
Gs^Fms, Gs^Fms, Gs^Fms, Gs^Fms, Gs^Fms, Gs^Fms, Gs^Fms, Gll, Gs^Fms, Gll, Gs^Fms, Gll, Wwt, Wwt, Wwt, Wwt, Ww^Ewl, Wwt, Wwt, Wwt, Ww^Ewl, Wwt, Wwt, Ww^Ewl, Wwt, Gs^Fms, Gg^Fet, Gs^Fms, Gs^Fms, Gll, Gs^Fms, Gs^Fms, Rp, Rp, Rp, Gs^Fms, Gs^Fms, Gg^Fet, Gs^Fms, Gll, Gll, Gg^Fet, Gs^Fms, Gs^Fms, Gs^Fms, Gs^Fms, Gs^Fms, Gll
Gs^Fms, Gg^Fet, Gs^Fms, Gll, Gs^Fms, Gg^Fet, Gs^Fms, Gll, Gg^Fet, Gs^Fms, Gg^Fet, Gs^Fms, Ww^Ewl, Ww^Ewl, Gg^Fet, Wwt, Gll, Wwt, Gs^Fms, Ww^Ewl, Gs^Fms, Ww^Ewl, Wwt, Ww^Ewl, Gs^Fms, Gs^Fms, Gs^Fms, Gs^Fms, Gll, Gll, Gs^Fms, Gs^Fms, Rp, Rp, Rp, Rp, Rp, Gs^Fms, Gs^Fms, Gs^Fms, Gs^Fms, Gg^Fet, Gs^Fms, Gll, Gs^Fms, Gs^Fms, Gs^Fms, Gs^Fms
Gs^Fms, Gs^Fms, Gll, Gs^Fms, Gg^Fet, Gs^Fms, Gll, Gll, Gs^Fms, Gg^Fet, Gs^Fms, Gs^Fms, Wwt, Ww^Ewl, Gs^Fms, Gs^Fms, Gll, Gg^Ve, Gs^Fms, Gs^Fms, Gg^Fet, Gs^Fms, Gs^Fms, Gs^Fms, Gs^Fms, Gs^Fms, Gs^Fms, Gs^Fms, Gll, Gg^Fet, Gs^Fms, Gs^Fms, Gs^Fms, Rp, Rp, Rp, Rp, Rp, Gs^Fms, Gs^Fms, Gs^Fms, Gs^Fms, Gs^Fms, Gll, Gll, Gs^Fms, Gll, Gs^Fms
Gg^Fet, Gs^Fms, Gs^Fms, Gg^Fet, Gs^Fms, Gs^Fms, Gll, Gs^Fms, Gs^Fms, Gg^Fet, Gll, Gll, Wwt, Wwt, Ww^Ewl, Gs^Fms, Gs^Fms, Gll, Gll, Gs^Fms, Gs^Fms, Gs^Fms, Gg^Fet, Gs^Fms, Gg^Fet, Gs^Fms, Gs^Fms, Gs^Fms, Gs^Fms, Gll, Gs^Fms, Gs^Fms, Gg^Fet, Gs^Fms, Gg^Ve, Rp, Rp, Rp, Gs^Fms, Gs^Fms, Gs^Fms, Gs^Fms, Gs^Fms, Gg^Ve, Gll, Gs^Fms, Gs^Fms, Gs^Fms
Gg^Fet, Gs^Fms, Gs^Fms, Gs^Fms, Gll, Gll, Gs^Fms, Gs^Fms, Gs^Fms, Gs^Fms, Gll, Gs^Fms, Gg^Fet, Wwt, Wwt, Gs^Fms, Gs^Fms, Gs^Fms, Gll, Gs^Fms, Gs^Fms, Gs^Fms, Gg^Ve, Gg^Fet, Gs^Fms, Gs^Fms, Gs^Fms, Gs^Fms, Gll, Cv, Gs^Fms, Gs^Fms, Gs^Fms, Gs^Fms, Gs^Fms, Rp, Rp, Rp, Rp, Gs^Fms, Gs^Fms, Gg^Fet, Gs^Fms, Gs^Fms, Gs^Fms, Gll, Gll, Gll
Gs^Fms, Gll, Gg^Fet, Gs^Fms, Gll, Gs^Fms, Gs^Fms, Gs^Fms, Wwt, Wwt, Ww^Ewl, Wwt, Wwt, Wwt, Wwt, Gs^Fms, Gs^Fms, Gs^Fms, Gs^Fms, Gll, Gs^Fms, Gs^Fms, Gs^Fms, Gs^Fms, Gll, Gs^Fms, Gll, Cv, Gs^Fms, Cv, Gs^Fms, Cv, Gs^Fms, Gg^Fet, Gs^Fms, Rp, Rp, Rp, Rp, Rp, Gs^Fms, Gs^Fms, Gs^Fms, Gs^Fms, Gs^Fms, Gs^Fms, Gll, Gll
Gs^Fms, Gs^Fms, Gs^Fms, Gs^Fms, Gll, Gs^Fms, Gs^Fms, Wwt, Ww^Ewl, Wwt, Wwt, Ww^Ewl, Wwt, Ww^Ewl, Gs^Fms, Gs^Fms, Gg^Fet, Gs^Fms, Gs^Fms, Gs^Fms, Gll, Gs^Fms, Gll, Gll, Gs^Fms, Gll, Cv, Cv, Cv, Cv, Cv, Cv, Cv, Gs^Fms, Gg^Fet, Gs^Fms, Gs^Fms, Rp, Rp, Rp, Gs^Fms, Gg^Fet, Gg^Fet, Gs^Fms, Gs^Fms, Gs^Fms, Gll, Gll
Gg^Fet, Gs^Fms, Gs^Fms, Gs^Fms, Gll, Gs^Fms, Wwt, Ww^Ewl, Wwt, Gs^Fms, Gs^Fms, Gs^Fms, Gs^Fms, Gs^Fms, Gg^Fet, Gs^Fms, Gs^Fms, Gs^Fms, Gs^Fms, Gs^Fms, Gs^Fms, Gs^Fms, Gll, Gll, Gs^Fms, Gs^Fms, Gg^Fet, Gs^Fms, Cv, 3 Kv, Cv, Gll, Gll, Gs^Fms, Gg^Fet, Gs^Fms, Gs^Fms, Rp, Rp, Rp, Gs^Fms, Gs^Fms, Gs^Fms, Gs^Fms, Gg^Fet, Gs^Fms, Gs^Fms, Gs^Fms
Gs^Fms, Gg^Fet, Gs^Fms, Gs^Fms, Gll, Gs^Fms, Wwt, Wwt, Wwt, Gs^Fms, Gll, Gs^Fms, Gg^Fet, Gs^Fms, Gs^Fms, Gs^Fms, Gs^Fms, Gg^Fet, Gs^Fms, Gs^Fms, Gs^Fms, Gll, Gs^Fms, Gs^Fms, Gs^Fms, Gs^Fms, Cv, Cv, Gs^Fms, Cv, Gs^Fms, Cv, Cv, Gs^Fms, Gs^Fms, Gs^Fms, Gs^Fms, Rp, Rp, Rp, Rp, Gs^Fms, Gs^Fms, Gs^Fms, Gs^Fms, Gs^Fms, Gs^Fms, Gs^Fms
Gll, Gs^Fms, Gll, Gll, Gs^Fms, Gs^Fms, Gs^Fms, Wwt, Ww^Ewl, Wwt, Gll, Gs^Fms, Gs^Fms, Gs^Fms, Gll, Gll, Gll, Gll, Gll, Gs^Fms, Gll, Gs^Fms, Gll, Gg^Fet, Gs^Fms, Gs^Fms, Gg^Fet, Gs^Fms, Cv, Cv, Cv, Gs^Fms, Gll, Gll, Gs^Fms, Gg^Fet, Gs^Fms, Rp, Rp, Rp, Rp, Rp, Rp, Gs^Fms, Gs^Fms, Gs^Fms, Gs^Fms, Gg^Fet
Gs^Fms, Gll, Gs^Fms, Gs^Fms, Gg^Fet, Gg^Fet, Gs^Fms, Gg^Fet, Wwt, Wwt, Gll, Gll, Gs^Fms, Gs^Fms, Gll, Gs^Fms, Gs^Fms, Gs^Fms, Gs^Fms, Gs^Fms, Gll, Gs^Fms, Gll, Gs^Fms, Gs^Fms, Gs^Fms, Gg^Fet, Gg^Fet, Gg^Fet, Gg^Fet, Gs^Fms, Gs^Fms, Gll, Gs^Fms, Gs^Fms, Gs^Fms, Gs^Fms, Gs^Fms, Gs^Fms, Rp, Rp, Rp, Rp, Rp, Rp, Gs^Fms, Gs^Fms, Gs^Fms
Gg^Fet, Gg^Fet, Gs^Fms, Gg^Fet, Gs^Fms, Gs^Fms, Gs^Fms, Gs^Fms, Ww^Ewl, Wwt, Gs^Fms, Gs^Fms, Gs^Fms, Gs^Fms, Gll, Gs^Fms, Gs^Fms, Gs^Fms, Gs^Fms, Gs^Fms, Gs^Fms, Gs^Fms, Gs^Fms, Gll, Gs^Fms, Gs^Fms, Gs^Fms, Gs^Fms, Gs^Fms, Gs^Fms, Gll, Gll, Gll, Gll, Gs^Fms, Gs^Fms, Gll, Gs^Fms, Gs^Fms, Gs^Fms, Gs^Fms, Rp, Rp, Rp, Rp, Rp, Rp, Gs^Fms
Gs^Fms, Gg^Fet, Gs^Fms, Gs^Fms, Gs^Fms, Gll, Wwt, Wwt, Ww^Ewl, Wwt, Gll, Gs^Fms, Gs^Fms, Gll, Gll, Gs^Fms, Gs^Fms, Gs^Fms, Gg^Fet, Gs^Fms, Gg^Fet, Gs^Fms, Gs^Fms, Gll, Gs^Fms, Gg^Ve, Gs^Fms, Gs^Fms, Gs^Fms, Gll, Gll, Gs^Fms, Gs^Fms, Gs^Fms, Gs^Fms, Gs^Fms, Gs^Fms, Gll, Gll, Gs^Fms, Gs^Fms, Gs^Fms, Gg^Fet, Rp, Rp, Rp, Rp, Rp
Gs^Fms, Gs^Fms, Gs^Fms, Gs^Fms, Wwt, Wwt, Ww^Ewl, Ww^Ewl, Gs^Fms, Gs^Fms, Gll, Gs^Fms, Gs^Fms, Gs^Fms, Gs^Fms, Gs^Fms, Gg^Fet, Gs^Fms, Gs^Fms, Gs^Fms, Gs^Fms, Gs^Fms, Gs^Fms, Gll, Gll, Gs^Fms, Gs^Fms, Gs^Fms, Gll, Gll, Gs^Fms, Gs^Fms, Gs^Fms, Gs^Fms, Gg^Fet, Gg^Ve, Gs^Fms, Gs^Fms, Gs^Fms, Gll, Gs^Fms, Gs^Fms, Gg^Fet, Gs^Fms, Gs^Fms, Rp, Rp, Rp
Gs^Fms, Wwt, Wwt, Wwt, Ww^Ewl, Ww^Ewl, Wwt, Wwt, Gs^Fms, Gs^Fms, Gs^Fms, Gs^Fms, Gs^Fms, Gs^Fms, Gs^Fms, Gs^Fms, Gs^Fms, Gs^Fms, Gs^Fms, Gs^Fms, Gs^Fms, Gs^Fms, Gs^Fms, Gll, Gll, Gs^Fms, Gs^Fms, Gs^Fms, Gll, Gs^Fms, Gs^Fms, Gs^Fms, Gs^Fms, Gs^Fms, Gs^Fms, Gs^Fms, Gs^Fms, Gs^Fms, Gs^Fms, Gll, Gll, Gs^Fms, Gg^Fet, Gg^Fet, Gs^Fms, Gs^Fms, Gs^Fms, Rp
