border_size=1
usage=map

Gg^Fet, Gg^Fet, Gg^Fet, Gg^Fet, Gg^Fet, Gg^Fet, Gg^Fet, Gg^Fet, Gg^Fet, Gg^Fet, Gg^Fet, Gg^Fet, Gg^Fet, Gg^Fet, Gg^Fet, Gg^Fet, Gg^Fet, Gg^Fet
Gg^Fet, Gg^Fet, Wwt, Wwt, Wwt, Wwt, Wwt, Wwt, Wwt, Wwt, Wwt, Wwt, Wwt, Wwt, Wwt, Gg^Fet, Gg^Fet, Gg^Fet
Gg^Fet, Wwt, Kv, Kv, Kv, Kv, Kv, Kv, Kv, Kv, Kv, Kv, Kv, Kv, Kv, Wwt, Gg^Fet, Gg^Fet
Gg^Fet, Wwt, Kv, Gg^Fet, Gg^Fet, Gg^Fet, Gg^Fet, Gg^Fet, Gg^Fet, Gg^Fet, Gg^Fet, Gg^Fet, Gg^Fet, Gg^Fet, Kv, Wwt, Gg^Fet, Gg^Fet
Gg^Fet, Wwt, Kv, Gg^Fet, Gg^Efm, Gg^Ii, Gg^Efm, Gg^Ii, 2 Gg^Ii, Gg^Ii, Gg^Efm, Gg^Ii, Gg^Efm, Gg^Fet, Kv, Wwt, Gg^Fet, Gg^Fet
Gg^Fet, Wwt, Kv, Gg^Fet, Gg^Ii, Gg^Efm, Gg^Ii, Gg^Ii, Gg, Gg^Ii, Gg^Ii, Gg, Gg^Ii, Gg^Fet, Kv, Wwt, Gg^Fet, Gg^Fet
Gg^Fet, Wwt, Kv, Gg^Fet, Gg^Ii, Gg, Gg, Gg, Gg, Gg, Gg^Efm, Gg^Efm, Gg^Ii, Gg^Fet, Kv, Wwt, Gg^Fet, Gg^Fet
Gg^Fet, Wwt, Kv, Gg^Fet, Gg^Efm, Gg^Efm, Gg^Ii, Gg, 1 Gg^Efm, Gg, Gg^Ii, Gg^Efm, Gg^Efm, Gg^Fet, Kv, Wwt, Gg^Fet, Gg^Fet
Gg^Fet, Wwt, Kv, Gg^Fet, Gg^Fet, Gg^Fet, Gg^Fet, Gg^Efm, Gg^Efm, Gg^Efm, Gg^Fet, Gg^Fet, Gg^Fet, Gg^Fet, Kv, Wwt, Gg^Fet, Gg^Fet
Gg^Fet, Wwt, Wwt, Kv, Kv, Kv, Kv, Gg^Fet, Gg, Gg^Fet, Kv, Kv, Kv, Kv, Wwt, Wwt, Gg^Fet, Gg^Fet
Gg^Fet, Gg^Fet, Gg^Fet, Wwt, Wwt, Wwt, Kv, Gg^Fet, Gg, Gg^Fet, Kv, Wwt, Wwt, Wwt, Gg^Fet, Gg^Fet, Gg^Fet, Gg^Fet
Gg^Fet, Gg^Fet, Gg^Fet, Gg^Fet, Gg^Fet, Wwt, Kv, Gg^Fet, Gg, Gg^Fet, Kv, Wwt, Gg^Fet, Gg^Fet, Gg^Fet, Gg^Fet, Gg^Fet, Gg^Fet
Gg^Fet, Gg^Fet, Gg^Fet, Gg^Fet, Gg^Fet, Wwt, Kv, Gg^Fet, Gg, Gg^Fet, Kv, Wwt, Gg^Fet, Gg^Fet, Gg^Fet, Gg^Fet, Gg^Fet, Gg^Fet
Gg^Fet, Gg^Fet, Gg^Fet, Gg^Fet, Wwt, Wwt, Kv, Gg^Fet, Gg, Gg^Fet, Kv, Wwt, Gg^Fet, Gg^Fet, Gg^Fet, Gg^Fet, Gg^Fet, Gg^Fet
