border_size=1
usage=map

Rp, Gs^Fms, Gs^Fms, Gs^Fms, Gs^Fms, Gs^Fms, Gs^Fms, Gs^Fms, Gs^Fms, Gll, Gs^Fms, Gs^Fms, Gs^Fms, Gs^Fms, Gs^Fms, Gs^Fms, Gs^Fms, Gs^Fms, Gs^Fms, Gs^Fms, Gs^Fms, Gs^Fms, Gll, Gs^Fms, Gs^Fms, Gg^Fet, Gs^Fms, Gs^Fms, Gs^Fms, Gs^Fms, Gs^Fms, Gs^Fms, Gll^Efm, Gs^Fms, Gs^Fms
Gs^Fms, Rp, Rp, Gs^Fms, Gs^Fms, Gs^Fms, Gs^Fms, Gs^Fms, Gg^Fet, Gll, Gs^Fms, Gs^Fms, Gs^Fms, Gg^Fet, Gs^Fms, Gs^Fms, Gs^Fms, Gg^Fet, Gs^Fms, Gs^Fms, Gg^Ve, Gs^Fms, Gs^Fms, Gll, Gs^Fms, Gs^Fms, Gs^Fms, Gs^Fms, Gg^Fet, Gs^Fms, Gll, Gll, Gs^Fms, Gs^Fms, Gll
Gs^Fms, Gs^Fms, Gs^Fms, Rp, Gs^Fms, Gs^Fms, Gll, Gs^Fms, Gs^Fms, Gs^Fms, Gs^Fms, Gg^Fet, Gll, Gs^Fms, Gs^Fms, Gs^Fms, Gll, Gs^Fms, Gs^Fms, Gs^Fms, Gll^Efm, Gs^Fms, Gll, Gll, Gs^Fms, Gs^Fms, Gg^Fet, Gs^Fms, Gg^Ve, Gs^Fms, Gll, Gs^Fms, Gs^Fms, Gll, Wwt
Gll, Gs^Fms, Gs^Fms, Rp, Gs^Fms, Gs^Fms, Gs^Fms, Gs^Fms, Gs^Fms, Gg^Fet, Gs^Fms, Gs^Fms, Gs^Fms, Gll, Gll, Gs^Fms, Gs^Fms, Gll, Gll, Gll, Gll, Gll^Efm, Gs^Fms, Gs^Fms, Gs^Fms, Gs^Fms, Gs^Fms, Gs^Fms, Gs^Fms, Gs^Fms, Gll^Efm, Gg^Fet, Gs^Fms, Gs^Fms, Wwt
Gs^Fms, Gs^Fms, Gs^Fms, Rp, Gs^Fms, Gs^Fms, Gg^Fet, Gs^Fms, Gll, Gs^Fms, Gs^Fms, Gg^Fet, Gs^Fms, Gs^Fms, Gs^Fms, Gll, Gs^Fms, Gs^Fms, Gs^Fms, Gs^Fms, Gs^Fms, Gll, Gll, Gs^Fms, Gg^Fet, Gg^Fet, Gs^Fms, Gs^Fms, Gg^Fet, Gs^Fms, Gs^Fms, Gll^Efm, Gs^Fms, Wwt, Ww^Ewf
Gll, Gs^Fms, Gs^Fms, Rp, Rp, Gs^Fms, Gs^Fms, Gs^Fms, Gll^Efm, Gs^Fms, Gs^Fms, Gs^Fms, Gs^Fms, Gs^Fms, Gg^Ve, Gll^Efm, Gll, Gs^Fms, Hh^Fms, Gs^Fms, Gs^Fms, Gs^Fms, Gll^Efm, Gg^Fet, Cv, Cv, Cv, Gg^Fet, Gs^Fms, Gs^Fms, Gs^Fms, Gll^Efm, Gs^Fms, Wwt, Wwt
Gll, Gll, Gs^Fms, Gs^Fms, Gs^Fms, Rp, Gs^Fms, Gs^Fms, Gs^Fms, Gll, Hh, Gll, Gll, Gll, Gs^Fms, Gs^Fms, Gll, Gs^Fms, Hh^Fms, Hh^Fms, Gs^Fms, Gg^Fet, Gll, Gg^Fet, Cv, 2 Kv, Cv, Gg^Fet, Gll, Gll^Efm, Gs^Fms, Gs^Fms, Gll, Ww^Ewf, Wwt
Gs^Fms, Gll, Gs^Fms, Gs^Fms, Gs^Fms, Rp, Gs^Fms, Gs^Fms, Gs^Fms, Gs^Fms, Hh^Fms, Hh^Fms, Mm, Hh^Fms, Gs^Fms, Gs^Fms, Gs^Fms, Hh^Fms, Hh^Fms, Hh^Fms, Gs^Fms, Gs^Fms, Gll, Gll, Gll, Cv, Gll, Gll, Gg^Ve, Gs^Fms, Gs^Fms, Gll, Ww^Ewf, Wwt, Wwt
Gs^Fms, Gs^Fms, Gll, Gg^Fet, Gs^Fms, Rp, Rp, Gs^Fms, Gs^Fms, Gll, Hh^Fms, Mm, Mm, Mm, Hh^Fms, Gll, Gs^Fms, Gs^Fms, Hh^Fms, Hh^Fms, Gs^Fms, Gs^Fms, Gll, Gg^Fet, Gg^Fet, Gg^Fet, Gg^Fet, Gg^Fet, Gs^Fms, Gs^Fms, Gs^Fms, Wwt, Wwt, Wwt, Gs^Fms
Gs^Fms, Gs^Fms, Gll, Gs^Fms, Gs^Fms, Gs^Fms, Rp, Gs^Fms, Gs^Fms, Gs^Fms, Gs^Fms, Hh^Fms, Hh^Fms, Mm, Mm, Hh, Gs^Fms, Gs^Fms, Gs^Fms, Gs^Fms, Gll, Gll, Gs^Fms, Gs^Fms, Gs^Fms, Gs^Fms, Gll^Efm, Gs^Fms, Wwt, Wwt, Wwt, Wwt, Wwt, Gg^Fet, Gs^Fms
Gs^Fms, Gs^Fms, Gs^Fms, Gs^Fms, Gs^Fms, Gs^Fms, Gs^Fms, Rp, Gs^Fms, Gs^Fms, Gs^Fms, Hh, Gs^Fms, Mm, Mm, Hh, Gs^Fms, Gg^Fet, Gs^Fms, Gll, Gll, Gg^Ve, Gs^Fms, Gs^Fms, Gll, Gll^Efm, Wwt, Wwt, Wwt, Ww^Ewf, Wwt, Wwt, Gs^Fms, Gs^Fms, Gll
Gg^Fet, Gs^Fms, Gs^Fms, Gll, Gs^Fms, Gs^Fms, Gs^Fms, Rp, Rp, Gs^Fms, Gs^Fms, Gs^Fms, Gs^Fms, Gs^Fms, Gs^Fms, Gll, Gll^Efm, Gll, Gs^Fms, Gs^Fms, Gs^Fms, Gs^Fms, Gg^Fet, Gs^Fms, Gs^Fms, Gll^Efm, Wwt, Ww^Ewf, Gg^Ve, Gs^Fms, Gs^Fms, Gs^Fms, Gll, Gs^Fms, Gs^Fms
Gs^Fms, Gs^Fms, Gs^Fms, Gll, Gll, Gs^Fms, Gs^Fms, Gs^Fms, Gs^Fms, Rp, Rp, Gs^Fms, Gll, Gs^Fms, Gs^Fms, Gll^Efm, Gll^Efm, Gs^Fms, Hh^Fms, Gs^Fms, Gs^Fms, Gs^Fms, Gs^Fms, Gs^Fms, Gs^Fms, Gs^Fms, Wwt, Ww^Ewf, Gs^Fms, Gs^Fms, Hh^Fms, Hh, Gs^Fms, Gg^Fet, Gs^Fms
Gs^Fms, Gs^Fms, Gs^Fms, Gs^Fms, Gs^Fms, Gs^Fms, Gg^Ve, Gs^Fms, Gs^Fms, Gs^Fms, Rp, Gs^Fms, Gs^Fms, Gs^Fms, Gll, Gs^Fms, Hh, Hh^Fms, Mm, Hh^Fms, Hh^Fms, Gll, Gs^Fms, Gs^Fms, Gs^Fms, Gs^Fms, Ww^Ewf, Wwt, Gs^Fms, Hh^Fms, Hh^Fms, Hh^Fms, Gs^Fms, Gs^Fms, Gs^Fms
Gll, Gll, Gg^Fet, Gs^Fms, Gs^Fms, Hh^Fms, Hh^Fms, Gs^Fms, Gll, Gg^Fet, Gs^Fms, Rp, Rp, Gg^Ve, Gll^Efm, Gs^Fms, Hh, Hh^Fms, Mm, Mm, Mm, Hh^Fms, Gs^Fms, Gs^Fms, Wwt, Wwt, Wwt, Wwt, Hh^Fms, Hh^Fms, Hh^Fms, Hh^Fms, Hh^Fms, Gs^Fms, Gs^Fms
Gs^Fms, Gs^Fms, Gs^Fms, Gs^Fms, Hh^Fms, Gs^Fms, Hh^Fms, Gs^Fms, Gs^Fms, Gll^Efm, Gll^Efm, Gs^Fms, Rp, Gs^Fms, Gs^Fms, Gll^Efm, Gs^Fms, Hh^Fms, Hh^Fms, Mm, Mm, Hh^Fms, Gs^Fms, Gll, Ww^Ewf, Ww^Ewf, Gg^Ve, Hh, Hh^Fms, Hh^Fms, Hh^Fms, Hh^Fms, Hh^Fms, Gs^Fms, Gg^Fet
Gll, Gs^Fms, Gll, Gs^Fms, Gs^Fms, Hh^Fms, Hh^Fms, Hh^Fms, Gs^Fms, Gs^Fms, Gll, Gg^Fet, Gs^Fms, Rp, Gs^Fms, Gs^Fms, Gg^Fet, Gs^Fms, Gs^Fms, Hh^Fms, Hh^Fms, Hh^Fms, Gg^Fet, Gll^Efm, Wwt, Ww^Ewf, Wwt, Hh, Gs^Fms, Hh^Fms, Hh^Fms, Hh^Fms, Gs^Fms, Gs^Fms, Gs^Fms
Gs^Fms, Gll, Gll, Gll, Gs^Fms, Hh^Fms, Mm, Hh^Fms, Hh^Fms, Gs^Fms, Hh^Fms, Hh^Fms, Hh^Fms, Rp, Gs^Fms, Gs^Fms, Gs^Fms, Gs^Fms, Gs^Fms, Gll^Efm, Gll, Gs^Fms, Gs^Fms, Gs^Fms, Gs^Fms, Ww^Ewf, Ww^Ewf, Gs^Fms, Gs^Fms, Hh^Fms, Gs^Fms, Hh, Gs^Fms, Gs^Fms, Gll
Gs^Fms, Gs^Fms, Gs^Fms, Gs^Fms, Gs^Fms, Hh^Fms, Mm, Mm, Mm, Hh^Fms, Mm, Mm, Hh^Fms, Rp, Rp, Gs^Fms, Gs^Fms, Gll, Gs^Fms, Gll^Efm, Gs^Fms, Gs^Fms, Gs^Fms, Gs^Fms, Gg^Fet, Wwt, Wwt, Wwt, Gs^Fms, Gs^Fms, Gs^Fms, Gs^Fms, Gs^Fms, Gs^Fms, Gll
Gs^Fms, Gg^Fet, Gs^Fms, Gs^Fms, Gs^Fms, Hh^Fms, Hh^Fms, Mm, Mm, Mm, Mm, Mm, Hh^Fms, Gs^Fms, Gg^Ve, Rp, Rp, Gs^Fms, Gs^Fms, Gs^Fms, Gs^Fms, Gs^Fms, Gs^Fms, Gs^Fms, Gs^Fms, Gs^Fms, Wwt, Ww^Ewf, Wwt, Gll, Gs^Fms, Gs^Fms, Gs^Fms, Gll, Gs^Fms
Gll, Gs^Fms, Gll, Gll, Gs^Fms, Gs^Fms, Gs^Fms, Hh^Fms, Gs^Fms, Mm, Hh^Fms, Hh, Gll, Gs^Fms, Gs^Fms, Gg^Fet, Gs^Fms, Rp, Rp, Gs^Fms, Gs^Fms, Gll, Gll, Gs^Fms, Gs^Fms, Gll, Gg^Ve, Ww^Ewf, Ww^Ewf, Gg^Fet, Gs^Fms, Gg^Fet, Gs^Fms, Gll, Gs^Fms
Gs^Fms, Gs^Fms, Gs^Fms, Gs^Fms, Gll, Gs^Fms, Gs^Fms, Hh, Gs^Fms, Hh^Fms, Gs^Fms, Gs^Fms, Gs^Fms, Gg^Fet, Hh^Fms, Hh^Fms, Hh^Fms, Gs^Fms, Rp, Gs^Fms, Gg^Fet, Gs^Fms, Gs^Fms, Gg^Fet, Gs^Fms, Gs^Fms, Gll^Efm, Wwt, Wwt, Gs^Fms, Gll, Gs^Fms, Gll, Gs^Fms, Gs^Fms
Gs^Fms, Gs^Fms, Gs^Fms, Gs^Fms, Gg^Fet, Gs^Fms, Gs^Fms, Gs^Fms, Gs^Fms, Hh, Gs^Fms, Gs^Fms, Gll, Gs^Fms, Gs^Fms, Hh^Fms, Hh^Fms, Gs^Fms, Rp, Gs^Fms, Gs^Fms, Gll, Gs^Fms, Gs^Fms, Gs^Fms, Gll^Efm, Wwt, Wwt, Ww^Ewf, Gs^Fms, Gll, Gg^Ve, Gg^Fet, Gll, Gs^Fms
Gs^Fms, Gs^Fms, Gll, Gs^Fms, Gs^Fms, Gs^Fms, Gs^Fms, Gs^Fms, Gg^Fet, Gs^Fms, Gll, Gs^Fms, Gs^Fms, Gs^Fms, Gll, Hh^Fms, Gs^Fms, Gs^Fms, Rp, Gs^Fms, Gg^Ve, Gs^Fms, Gs^Fms, Gs^Fms, Wwt, Wwt, Ww^Ewf, Ww^Ewf, Gs^Fms, Gs^Fms, Hh^Fms, Gs^Fms, Gs^Fms, Gll, Gs^Fms
Gll, Gll, Gs^Fms, Gs^Fms, Gg^Ve, Gs^Fms, Gs^Fms, Gs^Fms, Gll, Gs^Fms, Gll, Gs^Fms, Gs^Fms, Gs^Fms, Gs^Fms, Gs^Fms, Gs^Fms, Gs^Fms, Rp, Gs^Fms, Gs^Fms, Gll, Gs^Fms, Gs^Fms, Ww^Ewf, Ww^Ewf, Gs^Fms, Gs^Fms, Hh, Hh^Fms, Hh^Fms, Hh^Fms, Hh^Fms, Gs^Fms, Gs^Fms
Gll, Gs^Fms, Gll, Gs^Fms, Gs^Fms, Gs^Fms, Gs^Fms, Gll, Gll, Gs^Fms, Ce, Ce, Ce, Gg^Fet, Gs^Fms, Gs^Fms, Gg^Fet, Rp, Gs^Fms, Gs^Fms, Gg^Fet, Gll^Efm, Gs^Fms, Gs^Fms, Ww^Ewf, Wwt, Gs^Fms, Hh, Mm, Mm, Mm, Hh^Fms, Hh^Fms, Gs^Fms, Gs^Fms
Gg^Fet, Gs^Fms, Gs^Fms, Gs^Fms, Gs^Fms, Gg^Fet, Gs^Fms, Gs^Fms, Gs^Fms, Gll, Ce, 1 Ke, Ce, Gll, Gs^Fms, Gll, Gs^Fms, Rp, Gll, Gs^Fms, Gll, Gll^Efm, Gll^Efm, Gll, Wwt, Wwt, Gs^Fms, Hh^Fms, Mm, Mm, Mm, Hh^Fms, Hh^Fms, Gs^Fms, Gs^Fms
Hh^Fms, Gs^Fms, Gs^Fms, Gs^Fms, Gll^Efm, Gll, Gll, Gs^Fms, Gs^Fms, Gg^Fet, Gs^Fms, Ce, Gs^Fms, Gs^Fms, Hh^Fms, Gs^Fms, Gs^Fms, Rp, Kv, Gs^Fms, Gs^Fms, Gs^Fms, Wwt, Gs^Fms, Wwt, Ww^Ewf, Hh, Hh^Fms, Hh^Fms, Mm, Hh^Fms, Hh^Fms, Hh, Hh, Gs^Fms
Hh^Fms, Hh^Fms, Hh^Fms, Hh, Gs^Fms, Gll^Efm, Gs^Fms, Gll^Efm, Gll, Gg^Fet, Gs^Fms, Gs^Fms, Gs^Fms, Hh^Fms, Hh^Fms, Gs^Fms, Gs^Fms, Rp, Rp, Cv, Wwt, Ww^Ewf, Wwt, Ww^Ewf, Ww^Ewf, Wwt, Gs^Fms, Hh, Hh^Fms, Hh^Fms, Hh^Fms, Hh^Fms, Gs^Fms, Gll, Gs^Fms
Hh^Fms, Hh^Fms, Hh^Fms, Hh^Fms, Hh, Gs^Fms, Gs^Fms, Gs^Fms, Gll, Gll^Efm, Gll, Gs^Fms, Gs^Fms, Hh^Fms, Hh^Fms, Hh^Fms, Gs^Fms, Kv, Cv, Wwt^Bsb\, Wwt^Bsb\, Ww^Ewf, Cv, Wwt, Gs^Fms, Gs^Fms, Gll, Gs^Fms, Hh, Gs^Fms, Gs^Fms, Gs^Fms, Gg^Fet, Gs^Fms, Gs^Fms
Hh^Fms, Hh^Fms, Hh^Fms, Hh^Fms, Hh, Gs^Fms, Gs^Fms, Gll, Gs^Fms, Gs^Fms, Gll, Gs^Fms, Gll, Hh^Fms, Hh^Fms, Hh^Fms, Hh^Fms, Gs^Fms, Gs^Fms, Wwt, Wwt, Rp, Rp, Kv, Gs^Fms, Gs^Fms, Gs^Fms, Gs^Fms, Gs^Fms, Gs^Fms, Gs^Fms, Gs^Fms, Gs^Fms, Gs^Fms, Gs^Fms
Hh^Fms, Hh^Fms, Hh^Fms, Hh^Fms, Gs^Fms, Gs^Fms, Gs^Fms, Gs^Efm, Gs^Fms, Gg^Ve, Gs^Fms, Gs^Fms, Gs^Fms, Gs^Fms, Gs^Fms, Gs^Fms, Gs^Fms, Gs^Fms, Gs^Fms, Ww^Ewf, Ww^Ewf, Cv, Kv, Rp, Rp, Gs^Fms, Gs^Fms, Gs^Fms, Gs^Fms, Gll, Gs^Fms, Gs^Fms, Hh^Fms, Hh^Fms, Hh^Fms
Gs^Fms, Gs^Fms, Gs^Fms, Gs^Fms, Gs^Fms, Gg^Fet, Gs^Fms, Gg^Fet, Gs^Fms, Gs^Fms, Gll, Gg^Fet, Gs^Fms, Gs^Fms, Gs^Fms, Gll, Gs^Fms, Gs^Fms, Gs^Fms, Wwt, Ww^Ewf, Wwt, Gg^Fet, Gs^Fms, Gs^Fms, Rp, Gs^Fms, Gg^Ve, Gg^Fet, Gll^Efm, Gs^Fms, Hh^Fms, Hh^Fms, Hh^Fms, Hh^Fms
Gs^Fms, Gs^Fms, Gll, Gs^Fms, Gs^Fms, Gs^Fms, Gll^Efm, Gll^Efm, Gll, Gs^Fms, Gs^Fms, Gll^Efm, Gs^Fms, Gll^Efm, Gs^Fms, Gs^Fms, Gs^Fms, Gg^Fet, Gs^Fms, Gg^Ve, Ww^Ewf, Wwt, Gs^Fms, Gll, Gs^Fms, Rp, Gs^Fms, Gs^Fms, Gs^Fms, Gll^Efm, Hh, Hh^Fms, Hh^Fms, Hh^Fms, Hh^Fms
Wwt, Gll, Wwt, Gll, Wwt, Wwt, Wwt, Ww^Ewf, Wwt, Gs^Fms, Wwt, Gs^Fms, Gs^Fms, Gs^Fms, Gs^Fms, Gs^Fms, Gs^Fms, Gs^Fms, Gll^Efm, Wwt, Wwt, Ww^Ewf, Gs^Fms, Gll, Gg^Fet, Rp, Rp, Gs^Fms, Gs^Fms, Gs^Fms, Gs^Fms, Gs^Fms, Gs^Fms, Hh^Fms, Gs^Fms
Ww^Ewf, Ww^Ewf, Ww^Ewf, Ww^Ewf, Ww^Ewf, Ww^Ewf, Ww^Ewf, Ww^Ewf, Wwt, Ww^Ewf, Ww^Ewf, Wwt, Wwt, Gs^Fms, Wwt, Gll, Wwt, Gll^Efm, Wwt, Ww^Ewf, Wwt, Gs^Fms, Gll, Gs^Fms, Gs^Fms, Gs^Fms, Gs^Fms, Rp, Rp, Gs^Fms, Gg^Fet, Gll, Gll, Gs^Fms, Gs^Fms
Gs^Fms, Wwt, Gg^Fet, Wwt, Gs^Fms, Gs^Fms, Gs^Fms, Gs^Fms, Gll^Efm, Wwt, Gll, Wwt, Wwt, Ww^Ewf, Ww^Ewf, Ww^Ewf, Ww^Ewf, Wwt, Ww^Ewf, Ww^Ewf, Gs^Fms, Gs^Fms, Hh^Fms, Hh^Fms, Hh^Fms, Gll, Gg^Fet, Gs^Fms, Rp, Gs^Fms, Gs^Fms, Gs^Fms, Gs^Fms, Gll, Gs^Fms
Gll, Gs^Fms, Gll, Gs^Fms, Gs^Fms, Gll, Gll, Gll^Efm, Gs^Fms, Gg^Fet, Gs^Fms, Gs^Fms, Gs^Fms, Wwt, Gs^Fms, Wwt, Gs^Fms, Ww^Ewf, Gs^Fms, Gg^Fet, Gs^Fms, Hh^Fms, Hh^Fms, Hh^Fms, Hh^Fms, Gs^Fms, Gs^Fms, Gs^Fms, Gs^Fms, Rp, Gs^Fms, Gs^Fms, Gs^Fms, Gs^Fms, Gs^Fms
