border_size=1
usage=map

Hhd, Hhd, Hhd, Hhd, Hhd, Hhd, Rb^Es, Gd, Gd, Rb, Hhd, Hhd, Uh, Hhd, Uh, Hhd, Uh, Hhd, Hhd, Rb, Rb, Gd, Gd, Gd, Gd, Gd, Gd, Gd^Es, Gd, Gd^Es, Gd^Es, Gd^Es, Gd^Es, Gd, Gd, Gd, Gd, Rb, Hhd, Hhd, Hhd, Hhd, Hhd, Hhd, Hhd, Hhd, Hhd, Hhd, Hhd, Rb, Gd, Gd^Es, Rb, Gd, Gd, Rb, Hhd, Hhd
Hhd, Hhd, Rb, Rb, Rb, Rb, Gd, Gd^Es, Rb, Rb, Rb, Hhd, Hhd, Uh, Uh, Uh, Hhd, Hhd, Rb, Rb, Rb^Es, Gd^Es, Rb, Rb, Rb^Es, Gd, Rb^Es, Gd, Rb, Rb, Rb, Rb, Rb, Gd, Gd^Es, Gd, Rb^Es, Rb, Rb, Hhd, Hhd, Hhd, Hhd, Hhd, Hhd, Hhd, Hhd, Hhd, Rb, Rb, Gd, Gd^Es, Gd, Gd^Es, Gd, Rb, Hhd, Hhd
Hhd, Rb, Gd, Rb, Gd, Gd, Ce, Gd, Gd, Gd, Rb, Uh, Uh, Uh, Ql, Ql, Ql, Uh, Hhd, Rb, Gd, Gd, Gd, Gd, Rb, Rb^Es, Hhd, Rb, Uh, Hhd, Uh, Hhd, Hhd, Rb, Rb, Rb, Gd, Gd, Gd^Es, Rb, Rb, Hhd, Hhd, Hhd, Hhd, Hhd, Hhd, Hhd, Rb, Gd, Gd, Rb, Rb, Rb^Es, Gd, Rb, Hhd, Hhd
Rb, Rb, Gd^Es, Rb, Gd, Ce, 1 Ke, Ce, Gd, Gd^Es, Gd, Rb, Hhd, Hhd, Ql, Uu, Ql, Uh, Uh, Rb, Gd^Es, Gd, Xu, Rb, Uh, Uh, Uh, Hhd, Hhd, Uh, Hhd, Hhd, Rb, Rb, Gd^Es, Gd, Xu, Gd, Gd^Es, Gd, Rb, Hhd, Hhd, Hhd, Hhd, Hhd, Hhd, Rb, Gd, Rb, Rb^Es, Rb, Gd^Es, Rb^Es, Rb, Rb, Hhd, Hhd
Gd, Gd, Gd^Vhr, Rb^Es, Gd^Es, Ce, Ce, Ce, Gd, Rb, Rb, Rb, Uh, Uh, Hhd, Ql, Ql, Hhd, Hhd, Rb, Gd^Es, Gd, Rb, Rb, Hhd, Qlf, Qlf, Uh, Uh, Uh, Hhd, Hhd, Rb, Rb, Rb, Rb, Rb, Gd, Gd, Gd, Rb, Hhd, Hhd, Hhd, Hhd, Hhd, Hhd, Rb, Gd, Gd, Rb^Es, Rb, Gd^Es, Gd, Rb, Hhd, Hhd, Hhd
Rb, Gd, Gd, Rb, Gd, Gd, Gd, Gd, Rb, Rb, Gd, Rb, Hhd, Uh, Uu, Ql, Hhd, Uh, Rb, Rb, Rb, Gd, Rb, Hhd, Uh, Qlf, Qlf, Uh, Uh, Hhd, Rb, Rb, Gd^Es, Gd^Es, Xu, Rb, Gd, Rb, Rb, Gd^Es, Rb^Es, Hhd, Hhd, Hhd, Hhd, Hhd, Rb, Rb, Rb^Es, Rb, Rb^Es, Gd, Rb, Rb, Hhd, Hhd, Hhd, Hhd
Hhd, Rb, Rb, Rb, Rb, Gd^Es, Rb^Es, Rb, Gd^Vhr, Rb, Gd^Es, Rb, Rb, Uu, Uu, Hhd, Rb, Rb, Xu, Gd, Gd^Es, Rb, Rb, Uh, Uh, Uh, Uh, Qlf, Uu, Rb, Rb, Gd, Gd, Gd, Gd, Gd, Rb^Es, Rb, Xu, Rb, Rb^Es, Rb, Rb, Hhd, Rb, Hhd, Rb^Es, Gd^Es, Gd, Rb, Rb, Rb, Hhd, Hhd, Hhd, Hhd, Hhd, Hhd
Hhd, Hhd, Uh, Hhd, Hhd, Rb, Rb, Gd, Rb, Gd, Gd^Es, Gd, Rb, Uu, Uu, Uu, Rb, Gd, Rb, Rb, Gd^Es, Gd^Vhr, Rb, Hhd, Hhd, Rb, Uu, Qlf, Uu, Uu, Xu, Rb^Es, Rb, Gd^Vhr, Rb, Rb, Gd, Rb, Rb, Rb, Gd^Es, Gd, Gd, Rb^Es, Rb, Rb^Es, Rb, Rb, Rb^Es, Gd, Rb, Rb, Hhd, Hhd, Hhd, Hhd, Hhd, Hhd
Hhd, Uh, Ql, Uh, Uh, Hhd, Rb, Rb, Gd, Gd, Gd, Rb, Rb, Uu, Rb, Rb, Rb^Es, Rb, Rb, Gd^Es, Rb, Gd, Gd, Rb, Rb, Rb, Uu, Uu, Uu, Uu, Rb, Rb, Gd, Rb, Rb, Rb^Es, Rb, Rb, Rb, Gd, Gd, Gd, Rb, Xu, Rb, Gd, Gd^Vhr, Gd, Gd, Gd, Gd, Rb, Rb, Hhd, Rb, Rb, Hhd, Hhd
Hhd, Uh, Uh, Ql, Uh, Hhd, Hhd, Rb^Es, Gd, Xu, Gd, Rb^Es, Rb^Es, Rb, Rb^Es, Rb, Uh, Hhd, Rb, Gd, Rb, Xu, Rb, Gd, Gd^Es, Rb, Rb, Uu, Rb, Rb^Es, Gd^Es, Gd, Rb, Rb, Uh, Uh, Uh, Rb, Hhd, Rb, Rb, Gd^Es, Gd, Rb, Gd, Gd, Rb, Rb, Rb, Rb, Rb, Gd^Es, Gd^Es, Rb, Gd^Es, Rb, Rb, Hhd
Rb, Hhd, Uh, Ql, Ql, Hhd, Rb, Rb, Rb, Rb, Rb, Gd, Rb, Rb, Uh, Uh, Uh, Hhd, Rb, Gd^Es, Gd^Es, Rb, Gd^Es, Gd, Rb, Rb^Es, Rb, Rb^Es, Rb, Gd, Gd^Es, Gd^Es, Rb^Es, Hhd, Uh, Ql, Ql, Uh, Uh, Uh, Uh, Rb, Rb, Gd^Es, Gd, Rb, Rb, Hhd, Hhd, Hhd, Hhd, Rb, Rb, Gd, Rb, Gd^Es, Gd, Rb
Gd, Rb, Uh, Uh, Ql, Uh, Hhd, Rb, Gd^Es, Gd, Xu, Gd, Rb, Uh, Qlf, Qlf, Uh, Hhd, Uu, Rb, Rb, Rb^Es, Rb, Rb, Hhd, Hhd, Hhd, Hhd, Rb, Gd, Xu, Gd^Es, Rb, Hhd, Hhd, Uh, Uh, Ql, Ql, Ql, Ql, Uh, Uh, Rb, Rb, Rb, Rb, Hhd, Hhd, Hhd, Hhd, Hhd, Hhd, Rb, Rb, Gd, Rb, Gd
Gd, Rb, Hhd, Uh, Hhd, Uh, Uh, Rb, Rb^Es, Gd, Gd, Gd, Rb, Uh, Uu, Qlf, Uu, Uu, Uu, Uu, Xu, Gd, Rb, Hhd^Vhhr, Hhd, Hhd, Hhd, Hhd, Hhd, Rb, Gd, Gd, Gd, Rb, Rb, Hhd, Uh, Uu, Uh, Ql, Uh, Ql, Uh, Xu, Rb, Gd, Rb^Es, Rb, Rb, Hhd, Hhd, Hhd, Hhd, Rb, Rb, Gd^Es, Gd, Gd
Gd, Rb, Rb, Hhd, Hhd, Hhd, Uh, Hhd, Rb, Gd, Rb, Rb, Rb, Hhd, Uu, Uh, Uu, Uu, Uu, Uu, Uu, Rb, Rb, Rb, Hhd, Hhd, Hhd, Hhd, Hhd, Rb, Gd, Gd^Vhr, Gd, Xu, Rb, Hhd, Uh, Uu, Uu, Uh, Uh, Uu, Uu, Uh, Uh, Rb^Es, Gd, Rb^Es, Gd, Rb, Hhd^Vhhr, Hhd, Hhd, Rb^Es, Rb, Gd, Gd, Gd
Gd, Gd^Es, Gd, Rb, Rb, Rb, Rb, Rb^Es, Gd, Rb, Rb, Gd^Vhr, Rb, Rb, Rb, Uu, Rb, Xu, Rb, Uh, Uu, Rb^Es, Hhd, Hhd, Uh, Hhd, Uh, Uh, Uh, Rb, Rb, Gd^Es, Rb^Es, Gd^Es, Rb, Rb^Es, Rb, Uh, Uu, Uu, Uu, Uh, Uu, Uh, Uh, Rb, Xu, Gd, Rb, Rb, Hhd, Hhd, Hhd, Rb^Es, Gd, Rb, Gd, Gd
Wwg, Gd, Gd, Gd^Es, Gd, Gd, Gd^Es, Gd, Xu, Gd, Gd, Gd, Rb, Xu, Rb, Rb, Rb, Rb, Uh, Uh, Uu, Uh, Hhd, Uh, Uu, Uu, Uu, Uh, Uh, Hhd, Hhd, Rb, Hhd, Rb, Hhd, Hhd, Hhd, Rb, Uu, Hhd, Hhd, Uu, Uu, Uh, Hhd, Rb, Gd, Gd, Rb, Hhd, Hhd, Hhd, Rb, Rb, Gd^Es, Rb^Es, Gd^Es, Gd^Es
Wwg, Wwg, Wwg, Gd, Gd, Gd^Es, Rb, Gd, Gd, Gd, Rb, Rb, Rb, Rb, Hhd, Hhd, Hhd, Uh, Hhd, Uh, Uu, Uh, Uh, Uu, Uu, Uu, Uu, Uu, Uh, Hhd, Hhd, Hhd, Hhd, Hhd, Hhd, Hhd, Hhd, Hhd, Uu, Hhd, Hhd, Hhd, Uu, Uh, Hhd, Rb, Gd, Gd^Es, Rb, Hhd, Hhd, Hhd, Rb, Gd, Rb^Es, Gd, Rb, Gd
Gs, Wwg, Wwg, Gd^Es, Gd, Gd, Gd, Rb^Es, Rb, Gd^Es, Rb, Rb^Es, Hhd, Hhd, Hhd, Hhd, Hhd, Uh, Uh, Uh, Uh, Uu, Uu, Uu, Qlf, Uu, Qlf, Uh, Uh, Hhd, Hhd, Hhd, Md, Hhd, Md, Hhd, Hhd, Hhd, Uu, Hhd, Hhd, Hhd, Uu, Hhd, Hhd, Rb^Es, Rb, Rb, Rb, Hhd, Hhd, Hhd, Rb, Re^Vct, Rb, Gd, Rb, Gd
Gs, Wwg, Wwg, Wwg, Gd^Es, Gd, Gd, Rb^Es, Rb, Rb, Hhd, Hhd, Hhd, Hhd, Hhd, Hhd, Rb, Hhd, Rb, Rb, Uh, Uh, Uu, Uu, Uu, Qlf, Uu, Qlf, Qlf, Uh, Md, Md, Md, Md, Md, Md, Md, Md, Md, Md, Md, Uu, Hhd, Hhd, Rb, Rb^Es, Hhd, Hhd, Rb, Rb, Rb^Es, Rb, Rb^Es, Rb^Es, Rb, Rb, Hhd, Rb
Gs^Es, Gs, Wwg, Wwg, Gd^Es, Gd, Gd^Vhr, Rb, Gd^Es, Rb, Hhd, Hhd, Hhd, Hhd, Rb, Rb, Gd^Es, Rb, Gd, Rb, Uh, Uu, Uu, Uu, Uh, Uu, Uh, Uh, Uh, Qlf, Qlf, Md, Md, Md, Md, Md, Md, Md, Mv, Md, Md, Md, Hhd, Hhd, Rb, Hhd, Hhd, Hhd, Rb, Re^Vct, Gd, Gd, Rb, Ce, Hhd, Hhd, Hhd, Hhd
Gs, Gs, Wwg, Wwg, Wwg, Gd, Rb, Rb, Gd, Rb, Rb, Hhd, Hhd, Hhd, Hhd, Rb, Rb, Gd^Es, Rb^Es, Rb, Rb, Uh, Hhd, Uh, Hhd, Hhd, Hhd, Hhd, Md, Uh, Md, Qlf, Mv, Md, Md, Md, Qlf, Md, Md, Md, Md, Md, Hhd, Hhd, Rb, Rb^Es, Rb^Es, Hhd, Rb, Rb, Rb, Ce, Ce, Ce, Ce, Ce, Hhd, Hhd
Gs, Gs, Gs, Wwg, Wwg, Gd, Gd, Rb^Es, Rb, Rb, Rb, Hhd, Hhd, Xu, Hhd, Hhd, Rb, Xu, Gd, Gd, Rb, Hhd, Hhd, Hhd, Md, Md, Md, Md, Md, Md, Mv, Md, Md, Md, Md, Mv, Md, Qlf, Qlf, Md, Md, Uh, Uh, Uh, Uh, Rb, Rb, Rb, Hhd, Hhd, Hhd, Rb, Ce, 4 Ke, Ce, Hhd, Hhd, Hhd
Gs, Gd^Es, Gs, Wwg, Wwg, Wwg, Gd, Gd^Es, Gd, Rb^Es, Gd, Rb, Hhd, Hhd, Hhd, Hhd, Rb, Gd, Gd^Es, Rb, Hhd, Hhd, Hhd, Md, Md, Md, Md, Md, Md, Md, Md, Md, Md, Md, Mv, Md, Md, Md, Md, Qlf, Qlf, Qlf, Qlf, Uh, Uh, Xu, Uh, Hhd, Hhd, Hhd, Rb, Ce, Rb, Ce, Gd^Es, Ce, Hhd, Hhd
Gd, Gs, Gs, Gd^Vhr, Wwg, Wwg, Wwg, Gd^Es, Gd^Es, Gd^Es, Rb, Rb, Hhd, Hhd, Hhd, Hhd, Rb, Gd, Gd, Rb, Rb, Hhd, Hhd, Md, Md, Md, Md, Md, Md, Md, Qlf, Md, Md, Md, Md, Md, Md, Md, Md, Md, Uh, Uh, Uh, Qlf, Qlf, Uu, Uu, Uh, Uh, Rb, Rb^Es, Rb^Es, Hhd, Ce, Gd, Rb, Rb, Rb
Hhd, Gd, Gd^Es, Gs, Gs, Wwg, Wwg, Wwg, Gd, Gd^Es, Rb, Hhd, Hhd, Hhd, Hhd^Vhhr, Rb, Rb, Gd, Gd^Es, Gd, Rb, Hhd, Hhd, Hhd, Hhd, Md, Md, Md, Qlf, Qlf, Md, Mv, Md^Xm, Md^Xm, Md^Xm, Md, Md, Md, Md, Md, Hhd, Hhd, Hhd, Uh, Uu, Qlf, Uu, Uh, Xu, Rb, Hhd, Hhd, Rb, Rb, Rb, Gd, Gd, Gd
Hhd, Hhd, Hhd, Gd, Gd, Gs, Wwg, Wwg, Gd, Rb^Es, Rb, Rb, Rb, Hhd, Rb, Rb, Gd, Rb, Rb^Es, Rb, Rb, Rb, Rb, Hhd, Hhd, Md, Md, Qlf, Md, Md, Md, Md, Md^Xm, Md, Md, Md^Xm, Md, Hhd, Hhd, Hhd, Hhd, Hhd, Hhd, Uh, Uu, Qlf, Uu, Uu, Uu, Hhd, Hhd, Hhd, Rb, Gd, Gd, Re^Vct, Gd, Rb^Es
Hhd, Hhd, Hhd, Gd, Gd, Gs^Es, Wwg, Wwg, Rb, Gd, Rb^Es, Gd, Gd, Rb^Es, Rb^Es, Gd^Es, Gd, Gd, Xu, Gd, Gs^Vht, Gd^Es, Rb, Hhd, Hhd, Md, Qlf, Qlf, Md, Md, Md, Md^Xm, Cd, Cd, Cd, Md^Xm, Md, Md, Hhd, Hhd, Hhd, Hhd, Uu, Uu, Qlf, Qlf, Qlf, Uu, Uh, Hhd, Hhd, Rb, Gd, Rb^Es, Rb, Gd, Rb, Rb
Hhd, Hhd, Hhd, Gd, Gd, Gs, Wwg, Wwg, Gd, Rb^Es, Rb^Es, Gd, Rb^Es, Rb, Hhd, Rb, Rb, Gd, Rb, Gd, Gd, Gd, Rb, Hhd, Hhd, Md, Qlf, Md, Md, Md, Md^Xm, Md^Xm, Cd, 2 Kd, Cd, Md^Xm, Md^Xm, Md, Hhd, Hhd, Hhd, Uu, Uu, Uu, Ql, Qlf, Ql, Uu, Uh, Hhd, Hhd, Rb, Rb^Es, Rb, Xu, Gd, Gd, Rb^Es
Hhd, Hhd, Gd, Gd^Es, Gs, Gs, Wwg, Wwg, Gd, Gd^Es, Rb^Es, Rb, Rb, Hhd, Hhd, Hhd, Hhd, Rb, Rb, Rb^Es, Gd^Es, Rb^Es, Rb, Hhd, Uh, Uh, Qlf, Md, Md, Md, Md^Xm, Md, Md, Cd, Md, Md, Md, Hhd, Hhd, Rb, Xu, Uu, Uu, Ql, Ql, Ql, Ql, Ql, Ql, Uh, Hhd, Rb^Es, Gd^Es, Rb, Rb, Rb, Rb, Rb^Es
Gd, Hhd, Gd^Es, Gs, Gs, Wwg, Wwg, Wwg, Rb, Rb, Rb, Gd, Gd^Es, Rb, Rb, Hhd, Hhd, Rb, Rb^Es, Rb, Rb, Rb, Hhd, Hhd, Uu, Qlf, Uh, Uh, Md, Md^Xm, Kd, Md, Rr^Vhc, Cd, Md, Md, Kd, Hhd, Hhd, Rb, Uh, Uu, Uu, Ql, Ql, Ql, Ql, Ql, Uh, Uh, Hhd, Rb, Rb, Rb, Gd, Gd^Es, Rb, Rb
Gs, Gd, Gd, Gd^Vhr, Gd, Wwg, Wwg, Gd, Gd, Gd^Es, Gd, Rb, Rb^Es, Rb, Uu, Hhd, Uh, Uh, Uh, Xu, Rb^Es, Hhd, Hhd, Hhd, Uu, Qlf, Uh, Hhd, Hhd, Md, Cd, Rr^Vhc, Kd, Cd, Kd, Rr^Vhc, Cd, Hhd, Hhd, Rb, Uh, Uh, Uu, Uu, Uh, Ql, Uh, Uh, Hhd, Hhd, Hhd, Hhd, Rb, Rb^Es, Rb, Rb, Gd^Es, Gd
Gs^Es, Gs, Gd, Gd, Gs, Wwg, Wwg, Wwg, Gd, Rb, Rb, Gd, Rb, Xu, Uh, Ql, Ql, Ql, Uh, Uu, Uu, Hhd, Uh, Uh, Qlf, Qlf, Uh, Hhd, Hhd, Hhd, Rb, Cd, Rb, Hhd^Bsb|, Hhd, Cd, Hhd, Hhd, Rb, Rb, Rb, Xu, Hhd, Hhd, Hhd, Uh, Hhd, Hhd, Hhd, Hhd, Rb, Rb, Gd, Gd, Gd, Gd, Gd, Gd
Gd, Gd, Gs, Gd, Gs^Es, Gd, Wwg, Wwg, Gd, Rb^Es, Gd, Rb, Rb, Uu, Uu, Ql, Ql, Qlf, Qlf, Qlf, Qlf, Uh, Qlf, Uh, Qlf, Uh, Uh, Hhd, Hhd, Hhd, Rb^Es, Rb, Gd, Gd^Bsb|, Gd, Hhd, Rb, Rb, Gd^Es, Gd, Rb, Rb, Rb, Hhd, Hhd, Hhd, Hhd, Hhd, Rb, Hhd, Rb, Rb, Rb, Rb, Rb, Rb, Rb^Es, Gd
Gs, Gs, Gs, Gd, Gs, Gs, Wwg, Wwg, Wwg, Gd, Gd, Rb^Es, Rb, Uu, Uu, Ql, Uh, Ql, Uh, Uh, Uh, Qlf, Uh, Qlf, Uu, Qlf, Qlf, Uu, Uu, Hhd, Rb, Rb^Es, Rb^Es, Rb, Gd, Rb, Gd, Gd, Rb, Rb, Rb^Es, Gd, Rb, Hhd, Rb, Hhd, Rb, Rb, Gd, Rb, Gd, Gd, Rb, Rb, Rb, Rb, Gd, Gd
Gd, Gs^Es, Gd, Gd, Gd, Gs, Gs^Es, Wwg, Wwg, Wwg, Gd, Rb, Rb^Es, Rb, Uu, Uu, Rb, Uh, Rb, Hhd, Hhd, Uh, Hhd, Uu, Uh, Uu, Uh, Qlf, Qlf, Uh, Uh, Uh, Uh, Rb, Rb, Gd, Rb, Rb^Es, Rb, Rb, Rb, Gd^Es, Rb^Es, Rb, Gd^Es, Rb, Gd, Rb, Rb, Gd^Es, Rb, Rb, Gd, Rb, Gd, Gd, Rb, Gd
Gs^Es, Gd, Gd, Hhd, Hhd, Gd^Es, Gd^Es, Gs, Wwg, Wwg, Wwg, Gd, Gd, Rb, Rb, Rb, Gd, Rb, Gd, Rb, Rb, Hhd, Hhd, Hhd, Hhd, Uh, Hhd, Uh, Uh, Qlf, Ql, Ql, Ql, Hhd, Rb, Rb, Gd^Es, Rb, Hhd, Hhd, Rb, Rb, Rb, Rb, Gd^Es, Gd, Gd, Gd, Gd, Gd, Rb, Gd, Rb, Gd, Gd, Rb, Rb, Rb^Es
Gs^Es, Gs, Gd, Hhd, Hhd, Hhd, Hhd, Gd, Gs, Wwg, Wwg, Gd, Rb, Rb^Es, Gd, Gd, Rb, Rb^Es, Rb, Gd, Gd, Rb, Rb, Hhd, Hhd, Hhd, Hhd, Hhd, Uh, Ql, Ql, Ql, Uh, Hhd, Rb, Rb^Es, Rb, Rb, Hhd, Hhd, Rb, Rb, Gd^Es, Gd, Rb, Rb, Rb^Es, Rb^Es, Gd, Rb^Es, Rb, Gd, Rb, Gd, Rb, Rb, Gd^Es, Rb^Es
Gs^Es, Gd, Hhd, Hhd, Hhd, Hhd, Hhd, Gd, Gs, Wwg, Wwg, Gd, Gd^Vhr, Rb, Rb, Gd, Rb, Xu, Rb, Gd^Es, Rb, Rb, Rb, Rb^Es, Rb, Rb, Rb, Rb, Uh, Ql, Uh, Ql, Uh, Rb, Hhd, Rb, Hhd, Hhd, Hhd, Hhd, Rb, Gd^Es, Gd, Gd^Vhr, Rb, Gd, Rb, Rb, Rb, Rb, Hhd, Rb, Hhd, Rb, Rb, Gd^Es, Gd, Gd
Gd, Gd, Hhd, Hhd, Hhd, Hhd, Hhd, Gd, Gd, Wwg, Wwg, Wwg, Wwg, Wwg, Wwg, Gd^Es, Gd, Gd, Gd, Rb^Es, Rb, Rb, Hhd^Vhhr, Rb, Rb, Rb^Es, Gd, Rb, Rb, Hhd, Uu, Ql, Hhd, Hhd, Hhd, Hhd, Hhd, Hhd, Hhd, Rb, Gd, Rb^Es, Gd, Gd, Rb, Rb, Rb, Rb, Hhd, Hhd, Hhd, Hhd, Hhd, Hhd, Hhd, Rb, Rb, Rb
Hhd, Hhd, Hhd, Hhd, Hhd, Hhd, Hhd, Hhd, Gd, Gs, Gs, Wwg, Wwg, Wwg, Wwg, Wwg, Wwg, Wwg, Wwg, Gd^Es, Rb, Hhd, Hhd, Hhd, Rb^Es, Rb, Rb, Rb^Es, Rb^Es, Rb, Rb, Hhd, Rb, Hhd, Hhd, Hhd, Hhd^Vhhr, Hhd, Rb, Rb, Rb, Rb^Es, Rb, Rb^Es, Gd, Rb, Hhd, Hhd, Hhd, Hhd, Hhd^Vhhr, Hhd, Md, Hhd, Hhd, Hhd, Hhd, Rb
Hhd, Hhd, Hhd, Hhd, Hhd, Hhd, Gd, Gd, Re^Vct, Gs^Es, Gs^Es, Gs, Gs, Gs, Gs, Wwg, Wwg, Wwg, Wwg, Wwg, Gd, Rb, Hhd, Hhd, Hhd, Rb, Hhd, Rb, Hhd, Rb, Rb, Rb, Rb, Rb, Rb, Rb, Rb, Rb, Gd^Es, Rb, Gd, Rb^Es, Rb, Rb, Rb^Es, Rb, Hhd, Hhd, Md, Md, Md, Md, Md, Md, Md, Hhd, Hhd, Rb
Hhd, Hhd, Gd, Gd, Gd, Gd, Ce, Gs, Gs, Gs, Gd, Gd^Es, Gd, Gd^Es, Gd, Gs, Gs, Gs^Vht, Wwg, Wwg, Wwg, Rb^Es, Rb^Es, Hhd, Hhd, Hhd, Hhd, Hhd, Hhd, Hhd, Rb, Gd, Gd, Gd^Es, Rb, Gd, Gd, Gd, Rb, Rb, Gd, Rb, Rb, Gd^Es, Rb, Hhd, Hhd, Hhd, Md, Md, Md, Md, Md, Md, Md, Hhd, Hhd, Hhd
Hhd, Gd^Fts, Gd^Fts, Gd, Ce, Gs, Ce, Gs, Ce, Gs, Gd, Hhd, Hhd, Hhd, Hhd, Gd, Gd^Es, Gs, Gs, Wwg, Wwg, Gd, Rb, Hhd, Hhd, Hhd, Hhd, Hhd, Hhd, Hhd, Rb, Rb^Es, Rb, Gd, Gd, Rb^Es, Rb, Rb, Gd^Es, Rb, Gd^Vhr, Rb, Rb^Es, Rb, Rb, Hhd, Hhd, Hhd, Md, Md, Md, Md, Md, Md, Md, Hhd, Hhd, Hhd
Gd^Fts, Gd^Fts, Gd, Gd, Gs, Ce, 3 Ke, Ce, Gd, Gs, Gd, Hhd, Hhd, Hhd, Hhd, Hhd, Gd, Gd^Es, Gs^Es, Wwg, Wwg, Gs^Vht, Gd, Rb, Rb^Es, Rb, Rb^Es, Hhd, Hhd, Hhd, Rb, Rb, Gd^Es, Rb, Rb, Rb, Gd^Es, Rb, Gd, Gd, Gd, Rb, Gd, Rb, Rb^Es, Rb, Hhd, Hhd, Md, Md, Md, Md, Md, Md, Hhd, Hhd, Hhd, Rb
Gd^Fts, Gd^Es, Gs, Gs, Ce, Ce, Ce, Ce, Ce, Gd, Gd, Hhd, Hhd, Hhd, Hhd, Hhd, Hhd, Gd^Es, Gs, Wwg, Wwg, Wwg, Wwg, Gd, Wwg, Gd, Gd, Rb^Es, Rb, Rb, Gd, Gd, Gd^Es, Rb, Gd, Gd, Wwg, Gd, Wwg, Rb, Rb, Rb^Es, Gd, Rb^Es, Rb, Rb, Hhd, Hhd, Hhd, Md, Md, Md, Md, Md, Hhd, Hhd, Rb, Rb
Gd, Gd, Gs, Gd, Gs, Gs, Ce, Gs, Gs, Gd, Gs^Es, Gd, Gd, Hhd^Fts, Hhd^Fts, Hhd^Fts, Hhd, Gd, Gd, Gs^Es, Gs, Wwg, Wwg, Wwg, Wwg, Wwg, Wwg, Gd, Wwg, Wwg, Wwg, Wwg, Wwg, Rb, Wwg, Wwg, Wwg, Wwg, Wwg, Wwg, Wwg, Rb, Rb^Es, Gd, Gd^Es, Rb, Rb, Hhd, Hhd, Hhd, Hhd, Md, Md, Md, Hhd, Hhd, Rb, Rb^Es
Gd, Gs^Es, Gs, Re^Vct, Gs, Gd, Gd, Gs, Gd, Gs, Gs^Es, Gd, Gd, Gd^Fts, Hhd^Fts, Hhd, Hhd^Fts, Hhd, Gd, Gd, Gd, Gs, Gs, Wwg, Gd^Es, Wwg, Wwg, Wwg, Wwg, Wwg, Wwg, Wwg, Wwg, Wwg, Wwg, Wwg, Gd^Es, Wwg, Gd, Wwg, Wwg, Wwg, Wwg, Rb, Rb, Rb^Es, Rb, Rb^Es, Rb, Hhd, Hhd, Md, Hhd, Hhd, Hhd, Hhd, Rb^Es, Gd
Hhd, Gd, Gd, Gd, Gd^Es, Gs^Es, Gd, Gd, Gd, Re^Vct, Gd, Gs, Gd, Gd^Fts, Gd^Fts, Hhd, Hhd, Hhd, Gd, Gs, Gs, Gd^Es, Gd, Gd, Hhd, Gd, Gd, Wwg, Gs^Es, Gs, Gs^Es, Gs, Gs, Wwg, Gd, Gd, Hhd, Hhd, Hhd, Gd^Es, Gd^Es, Wwg, Wwg, Wwg, Gd^Vhr, Gd^Es, Gd, Rb, Rb^Es, Hhd, Hhd, Hhd, Hhd, Hhd, Rb, Rb, Gd, Gd
Hhd^Fts, Gd^Fts, Gd^Fts, Gd, Gd, Gd, Gd^Fts, Gd^Fts, Gd^Fts, Gd, Gd, Gs, Gs, Gd, Gd, Hhd, Gd, Hhd, Gd, Gs^Es, Gs^Es, Gd, Hhd, Hhd, Hhd^Fts, Hhd, Gd, Gs, Gd, Gs, Gd, Gs^Es, Gs, Gs, Gd^Es, Hhd, Hhd, Hhd^Vhhr, Hhd, Hhd, Hhd, Gd, Wwg, Wwg, Wwg, Wwg, Wwg, Wwg, Wwg, Rb, Wwg, Hhd, Rb, Rb, Rb, Rb^Es, Gd^Es, Gd
Hhd, Hhd^Fts, Hhd, Hhd, Hhd, Hhd^Fts, Hhd^Fts, Gd^Fts, Gd^Fts, Gd, Gd, Gs, Gs^Es, Gs, Gd, Gd, Gs, Gd, Gs, Gd, Gs, Gd, Gd, Hhd, Hhd, Hhd, Gd, Gs^Es, Gs, Gd^Vhr, Gd, Gd, Gd^Es, Gs, Gd, Gd, Gd^Es, Gd, Gd^Es, Hhd, Hhd, Gd, Gs^Es, Wwg, Wwg, Wwg, Wwg, Wwg, Wwg, Wwg, Wwg, Wwg, Wwg, Gd, Gd, Rb, Rb, Gd
Md, Hhd, Hhd, Hhd, Hhd, Hhd, Hhd^Fts, Gd^Fts, Gd^Fts, Gd^Fts, Gd, Gs^Es, Gs^Es, Gs, Gs, Gs^Es, Gd, Gd, Gd^Vhr, Gs, Gd, Gs, Gd, Gd, Gd, Gd, Gd, Gs^Es, Gd, Gd, Gd^Fts, Gd^Fts, Gd, Gs, Gs, Gs, Gs, Gd^Es, Gd, Gd, Gd, Gd, Gd, Gd^Es, Gd^Fts, Gd^Es, Gd^Fts, Gd^Es, Gd^Es, Wwg, Gd, Wwg, Wwg, Wwg, Gd, Rb, Gd, Rb
Md, Md, Md, Hhd, Md, Hhd, Hhd, Hhd^Fts, Hhd^Fts, Hhd^Fts, Hhd, Gd, Gs, Gd, Gs, Gs^Es, Gd, Gs, Gs, Gd, Gs, Gs^Es, Gs, Gs^Es, Gs, Gs, Gs, Gs, Gd, Gd^Fts, Hhd^Fts, Gd^Fts, Hhd^Fts, Gd, Gd, Gd, Gs, Gs, Gd^Es, Gs, Gd, Gd, Gd^Fts, Gd^Fts, Hhd^Fts, Gd, Gd^Fts, Gd^Fts, Gd^Fts, Gd^Fts, Gd^Fts, Gd^Es, Wwg, Wwg, Gd, Rb^Es, Rb, Gd^Es
Md, Md, Md, Md, Md, Md, Hhd, Hhd, Hhd, Hhd^Fts, Hhd, Gd, Gs, Gd, Gd, Gd, Gd^Es, Gs, Gs, Gs, Gs, Gs, Gs, Gs, Gd, Gd^Es, Gs, Gd, Gd^Fts, Gd^Fts, Hhd, Hhd^Fts, Hhd, Hhd, Hhd, Gd^Es, Gs, Gs, Gs^Es, Gd, Gd, Gd^Fts, Hhd, Hhd^Fts, Hhd, Hhd, Hhd, Hhd^Fts, Gs, Gd^Fts, Gs, Gd^Fts, Wwg, Wwg, Rb, Rb^Es, Rb^Es, Gd
