border_size=1
usage=map

Md^Xm, Md, Md, Md, Md^Xm, Md, Md^Xm, Md, Md^Xm, Md, Md^Xm, Md, Md^Xm, Md, Md, Md, Md, Md, Md, Md, Md, Md, Md, Md, Md, Md, Md, Md, Md, Md, Md, Md, Md, Md, Md, Md, Md^Xm, Md, Md, Md, Md, Md, Md, Md, Md, Md, Md, Md, Md^Xm, Md, Md, Md, Md, Md, Md
Md, Md, Md, Md^Xm, Md, Md^Xm, Md, Md^Xm, Md, Md, Md, Md^Xm, Md, Md^Xm, Md, Md, Md, Md, Md, Md, Md^Xm, Md^Xm, Md, Md, Md, Md, Md, Md^Xm, Md, Md, Md^Xm, Md, Md^Xm, Md, Md, Md, Md, Md, Md, Md^Xm, Md^Xm, Md, Md, Md^Xm, Md, Md, Md, Md, Md, Md^Xm, Md^Xm, Md, Md, Md, Md
Md, Md, Md, Md, Md, Md, Md, Md, Md, Md, Md, Md, Md, Md, Md, Md^Xm, Md, Md, Md, Md^Xm, Md, Md, Md, Mv, Md, Mv, Md, Md, Md, Md, Md, Md^Xm, Md, Md^Xm, Md^Xm, Md, Md, Md, Md, Md, Md, Md^Xm, Md^Xm, Md, Md, Md, Md^Xm, Md, Md, Md, Md, Md^Xm, Md, Md, Md
Md, Md, Md, Md, Md, Md, Md, Md, Md, Md^Xm, Md, Md^Xm, Md, Md^Xm, Md, Md, Md, Md, Md^Xm, Md^Xm, Md, Mv, Md, Md, Md^Xm, Md, Md, Md^Xm, Md, Md^Xm, Md^Xm, Md^Xm, Md, Md, Md, Md, Md, Md, Md, Md, Md, Md, Md, Md, Mv, Md, Md, Md, Md^Xm, Md, Md, Md^Xm, Md, Md, Md
Md, Md, Hh, Md, Md, Md, Md, Md, Md, Md, Md, Md, Md, Md, Md^Xm, Md, Md, Md, Md^Xm, Md, Md, Md, Md, Mv, Md, Md, Md, Md, Md, Md, Md, Md, Md, Md, Md, Md, Md, Md, Md, Md, Md^Xm, Md, Md, Mv, Md, Mv, Md, Md, Md, Md, Md^Xm, Md, Md, Md^Xm, Md
Hh, Hh, Hh, Hh, Hh, Hh, Hh, Hh, Hh, Md, Md, Md, Md, Md, Md, Md^Xm, Md, Md, Md, Md, Md, Md, Md, Md, Md, Md, Md, Md, Md, Md, Md, Md, Md, Md, Md^Xm, Md^Xm, Md, Md, Md, Md, Md, Md, Md, Mv, Md, Md, Mv, Md, Md, Md, Md, Md, Md, Md, Md
Hh, Hh, Hh, Hh, Hh, Hh, Hh, Hh, Hh, Hh, Hh, Hh, Rr^Vd, Md, Md, Md, Md, Md, Md, Md, Md, Md, Md, Md, Md, Md, Md, Md, Md, Md, Md, Md, Md, Md, Md, Md, Md, Md, Md, Md, Md^Xm, Md^Xm, Md, Md, Md, Mv, Md, Md, Md, Md, Md, Md, Md, Md, Md
Hh, Hh, Hh, Hh, Hh, Hh, Hh, Hh, Hh, Hh, Hh, Hh, Md, Md, Md, Md, Md, Md, Md, Md, Md, Md, Md, Md, Md, Md, Md, Md, Md, Md, Md, Md, Md, Md, Md, Md^Xm, Md, Md, Md^Xm, Md, Md, Md, Md, Md, Md, Md, Md, Md, Md, Md, Md, Md, Md, Md, Md
Gs, Gs, Gs, Gs, Gs, Gs, Gs, Hh, Hh, Hh, Hh, Hh, Md, Md, Md, Md^Xm, Md, Md, Md, Md, Md, Md, Md^Xm, Md, Md, Md, Md, Md, Md, Md, Md, Md^Xm, Md, Md, Md, Md, Md, Md, Md, Md, Md, Md, Md, Md, Md, Md, Md, Md, Md, Md, Md, Md, Md, Md, Hh
Gg, Gs, Gs, Gg, Gg, Gg, Gs, Gs, Gs, Hh, Hh, Hh, Md, Md, Md, Md^Xm, Md, Md, Md, Md, Md, Md, Md^Xm, Md, Md, Md, Hh, Md, Md, Md, Md, Md^Xm, Md^Xm, Md, Md, Md, Md, Md, Md, Md, Md, Md, Hh, Hh, Hh, Md, Md, Md, Md, Md, Md, Md, Hh, Hh, Hh
Gg, Gg^Es, Gg, Gg, Gg, Gg, Gg, Gg, Gs, Hh, Hh, Hh, Hh, Md, Md, Md, Md^Xm, Md, Md, Md, Md, Md, Md, Rr^Vd, Md, Hh, Ch, Hh, Md, Rr^Vd, Md, Md^Xm, Md^Xm, Md, Md, Md, Md, Md, Md^Xm, Md, Md, Md, Hh, Hh, Hh, Hh, Hh, Hh, Hh, Hh, Hh, Hh, Hh, Hh, Hh
Gs, Gg, Gg, Gs, Gg, Gg^Es, Gs, Gs, Gs, Hh, Hh, Hh, Hh, Md, Md, Md, Md, Md^Xm, Md, Md, Md, Md^Xm, Md, Md, Md, Ch, 2 Kh, Ch, Md, Md, Md, Md, Md^Xm, Md, Md, Md, Ww, Md^Xm, Md, Md, Md, Md, Hh, Hh, Rr^Vd, Hh, Gs, Hh, Gs, Hh, Gs, Gs, Gs, Gs, Gs
Hh, Gs, Gs, Gs, Gg^Es, Gg, Gs, Gg, Gs, Hh, Hh, Hh, Hh, Hh, Md, Md, Md, Md^Xm, Md^Xm, Md, Md, Md, Ch, Md, Ch, Ch, Ch, Ch, Ch, Md, Ch, Md, Md, Md, Md, Md, Ww, Md^Xm, Md, Md, Md, Md, Hh, Hh, Gs, Gs, Gg, Gs, Gs, Gs, Gg, Gs, Gg^Es, Gg, Gs
Hh, Hh, Hh, Gs, Gg, Gs, Gs, Gg, Gg, Gs, Hh, Hh, Hh, Hh, Hh, Md, Md, Md, Md, Md^Xm, Md, Md, Ch, Ch, Md, Hh, Ch, Gs, Hh, Ch, Ch, Md, Md, Md, Ww, Ww, Md^Xm, Md, Md, Md, Md, Md, Hh, Hh, Gs, Gg^Es, Gs^Es, Gg^Es, Gg, Gs, Ww, Ww, Ww, Gg^Es, Gg
Hh, Hh, Hh, Gs, Gs, Gs, Gg, Gg^Es, Gg, Gs, Gs, Hh, Hh, Hh, Hh, Hh, Hh, Md, Md, Md, Md, Md, Hh, Ch, Hh, Hh, Ch, Gs, Hh, Ch, Md, Md, Md, Md, Ww, Md, Md, Md, Md, Md, Hh, Hh, Hh, Hh, Gs^Es, Gs, Gg, Gg, Ww, Ww, Ww, Ww, Ww, Ww, Ww
Hh, Hh, Hh, Hh, Hh, Gs, Gs, Gg^Es, Gg, Gg, Gs, Hh, Hh, Hh, Hh, Hh, Md, Md, Md, Md, Md, Md, Hh, Hh, Gs, Ch, Ch, Ch, Gs, Hh, Hh, Md, Ww, Ww, Md, Md, Md, Md, Md, Hh, Hh, Hh, Gs, Gs, Gg, Gg, Ww, Ww, Ww, Ww, Gg^Es, Gg, Gs, Ww, Ww
Gs, Hh, Hh, Hh, Hh, Hh, Gs, Gs, Gg, Gs, Gs^Es, Gs, Gs, Hh, Hh, Hh, Hh, Md, Md, Md, Md, Md, Md, Hh, Hh, Gs, Gg, Gg, Gg, Gs, Wwf, Ww, Md, Md, Md, Md, Md, Md, Hh, Hh, Hh, Hh, Gs, Gs^Es, Gg, Ww, Ww, Ww, Gs, Gs^Fds, Gs, Gg^Es, Gs, Gs^Fds, Gs^Fds
Gs, Hh, Hh, Hh, Hh, Hh, Hh, Gs, Gs, Gg, Gs, Gg, Gs, Hh, Hh, Hh, Hh, Rr^Vd, Md, Md, Md, Md, Md, Rr^Vd, Hh, Gs, Gs, Gg, Gs^Es, Gg, Wwf, Md, Md, Md, Md, Md, Md, Md, Md, Hh, Hh, Gs, Gg, Gs^Es, Gg, Ww, Ww, Rr^Vd, Gs^Fds, Gs^Fds, Hh^Fds, Hh, Gs, Gs, Gs
Gs, Hh, Hh, Hh, Hh, Hh, Rr^Vd, Gs, Gg, Gs, Gg, Gg^Es, Gs, Hh, Hh, Hh, Hh, Md, Md, Md, Md, Md, Md, Md, Md, Hh, Gs, Gg^Es, Gs, Rr^Vd, Wwf, Md, Md, Md, Md, Md, Md, Md, Md, Hh, Hh, Gs, Gg^Es, Gs, Gs, Ww, Ww, Gs, Gs^Fds, Hh^Fds, Hh^Fds, Hh, Gs, Gg^Es, Gg
Gg, Gs, Gs, Hh, Hh, Hh, Hh, Gs, Gs, Gg, Gg^Es, Gg, Gs, Hh, Hh, Hh, Hh, Md, Md, Md, Md, Md, Md, Md, Hh, Hh, Gs, Gg, Gg, Wwf, Hh, Md, Md, Md, Md, Md, Md, Md, Hh, Hh, Hh, Gs, Gg^Es, Gg, Gs, Ww, Ww, Gs, Gs^Fds, Hh, Hh, Hh, Gs, Gg, Gg
Gg, Gg, Gs, Hh, Gs, Hh, Gs, Gs, Gg, Gg, Gs, Gs, Gs, Rr^Vd, Hh, Hh, Hh, Hh, Md, Md, Md, Md, Md, Md, Hh, Hh, Gs^Es, Gg, Wwf, Wwf, Hh, Md, Md, Md, Md, Md, Md, Md, Hh, Hh, Rr^Vd, Gs, Gs^Es, Gg, Ww, Ww, Ww, Gs^Fds, Gs^Fds, Gs^Fds, Gs^Es, Gs, Re^Vct, Gg^Es, Gg
Gg, Gg^Es, Gs, Gs, Gg, Gs, Gg, Gs, Gs, Gg^Es, Gg, Gg, Gs, Gs, Hh, Hh, Hh, Hh, Md, Md, Md, Md, Md, Md, Hh, Gs, Gg, Gg, Wwf, Hh, Hh, Hh, Md, Md, Md, Md, Md, Md, Hh, Hh, Gs, Gs, Gg, Gs, Ww, Ww, Ds, Gs^Fds, Gs, Gs^Es, Gs, Gg, Gg, Gs, Gs
Gg, Gs^Es, Gs^Fds, Gg, Gs^Fds, Gs, Gs, Gg, Gs, Gg, Gs, Gg, Gs, Gs, Gs, Hh, Hh, Hh, Hh, Md, Hh, Md, Hh, Md, Hh, Gs, Gg, Gg^Es, Wwf, Hh, Hh, Hh, Md, Md, Md, Md, Md, Md, Hh, Hh, Gs, Gg^Es, Gg, Gs, Ww, Ww, Ss, Gs, Ce, Ce, Ce, Ce, Ce, Gs, Gg
Gg, Gg, Gg, Gs, Gs, Gs^Fds, Gs^Fds, Gs, Gs, Gs, Gg, Gs^Es, Gg, Gg, Gs, Hh, Hh, Hh, Hh, Hh, Hh, Hh, Gs, Hh, Gs, Gs, Ww, Wwf, Gs^Es, Hh, Hh, Md, Md, Md, Md, Md, Md, Md, Hh, Hh, Gs, Gs, Ww, Ww, Ww, Ww, Ss, Gg, Ce, Re^Vct, Ce, 3 Ke, Ce, Gg, Gg^Es
Gs, Gs, Gs^Fds, Gg, Gs^Es, Gs, Gll, Gs^Fds, Gs, Gg, Gs, Gg, Gs, Gg, Gg^Es, Gs, Gs^Es, Hh, Gs, Hh, Hh, Hh, Gs^Es, Gs, Gg, Ww, Ww, Ww, Gs^Es, Gs, Hh, Md, Md, Md, Md, Md, Md, Md, Hh, Hh, Gs, Gs^Es, Ww, Ww, Ss, Ss, Ss, Ss, Ds, Ce, Re^Vct, Ce, Gg, Gs, Gs
Gs, Gs^Fds, Gs, Gg, Gs, Gs^Fds, Gs, Gs^Fds, Gg, Gs, Gg^Es, Gg, Gs, Gs, Gs, Gs^Es, Gs, Gs, Gg^Es, Gs, Gs, Gs, Ww, Rr^Vd, Ww, Ww, Ww, Gg, Gs, Hh, Hh, Md, Md, Md, Md, Md, Md, Md, Hh, Hh, Gs, Gg, Ww, Ww, Ww, Ss, Ww, Ww, Ww, Ce, Ce, Ce, Gg, Gg, Gg^Es
Gg, Gs, Gg, Gg, Ce, Gs, Gg, Gs, Gs, Gg, Gg, Gg^Es, Gs, Gs^Fds, Gs^Fds, Gs^Fds, Gs^Fds, Gs, Gg, Gs, Ww, Ww, Ww, Ww, Ww, Ww, Gs^Fds, Gs, Gs, Hh, Hh, Md, Md, Md, Hh, Md, Md, Hh, Hh, Hh, Gs, Gg, Gs, Ww, Ww, Ww, Ww, Ww, Wwf, Ds, Ds, Gs, Re^Vct, Gg, Gs
Gg, Re^Vct, Gg, Ce, 1 Ke, Ce, Gg, Gg, Gg^Es, Gs, Gs, Gs, Gs^Fds, Gs, Hh, Hh^Fds, Hh^Fds, Gs^Fds, Gs, Wwf, Wwf, Ww, Gs^Fds, Gs^Fds, Gs, Gs^Fds, Gs^Fds, Gs^Es, Gs, Hh, Hh, Md, Hh, Hh, Hh, Hh, Rr^Vd, Hh, Hh, Gs, Gs^Es, Gs^Es, Gs, Gs^Fds, Hh^Fds, Ww, Hh, Hh, Ww, Ww, Ds, Gs, Gg^Es, Gs, Gs^Fds
Gs, Gs, Gg, Ce, Ce, Ce, Gg, Gg, Gg, Gs, Gs^Fds, Gs^Fds, Gs, Hh, Hh^Fds, Hh, Hh, Hh, Gs, Ww, Wwf, Ds, Gs^Fds, Gs^Fds, Gs^Es, Gs^Fds, Gs, Gs^Es, Gs, Rr^Vd, Hh, Hh, Hh, Hh, Gs, Hh, Gs, Hh, Gs, Gs, Gs, Gs^Fds, Hh^Fds, Hh, Md, Hh^Fds, Md, Hh, Ww, Ww, Ww, Gs^Es, Gs, Gs, Gs
Gg, Gs^Fds, Gg, Gg, Gs, Gs, Gg, Gg, Gg, Gs, Gs^Fds, Gll, Gs^Es, Hh, Hh^Fds, Hh^Fds, Hh, Hh, Gs, Wwf, Ww, Ww, Ww, Gs, Gs^Fds, Gll, Gs^Fds, Gs^Es, Gs^Es, Gs, Gs, Hh, Gs, Hh, Gs, Gs, Gg, Gs, Gg^Es, Gg, Gs, Gs, Hh^Fds, Md, Md, Md, Hh, Md, Hh^Fds, Ww, Ww, Gg, Gg, Gs^Fds, Gs^Fds
Gg, Gg, Gg^Es, Gg, Gg, Gs^Fds, Gs, Gg, Gg, Gg, Gs, Gs^Fds, Gs, Hh, Gs^Fds, Gs^Fds, Gs^Es, Gs^Es, Ww, Ww, Ww, Ww, Ww, Ww, Ww, Gs^Fds, Gs, Gs, Gg, Gg, Gg, Gs, Gg, Gs^Es, Gs, Gs^Es, Gs, Gs, Gs, Gg, Gs^Fds, Gs^Fds, Gs^Fds, Hh^Fds, Hh, Hh, Ww, Hh^Fds, Hh^Fds, Ww, Ww, Gs, Gs^Es, Gs, Gg
Gs, Gg^Es, Gg, Gg, Gg, Gs, Gs^Fds, Gg^Es, Gg^Es, Gg, Gs, Gs^Fds, Gs^Fds, Rr^Vd, Gs^Fds, Gg, Ww, Ww, Ww, Ww, Gs^Fds, Gs^Fds, Gs, Ww, Ww, Ww, Ww, Ww, Ww, Gs, Ww, Gg^Es, Ww, Ww, Ww, Gs^Fds, Hh^Fds, Hh, Hh, Gs, Gs^Fds, Gs^Es, Ds, Gs^Fds, Ww, Ww, Ww, Ww, Ww, Ww, Ww, Gs^Fds, Gg, Gs, Gg
Gg^Es, Gs, Gs, Gg, Gg, Gs, Gs, Gg, Gg, Gg, Gg, Gs, Gs, Gs^Fds, Gs, Gs, Ww, Ww, Gs^Fds, Gs, Gs^Fds, Gs^Fds, Gs, Gg^Es, Gg, Ww, Ww, Ww, Ww, Ww, Ww, Ww, Ww, Ww, Ww, Gs^Fds, Hh^Fds, Md, Md, Hh^Fds, Ww, Ds, Ww, Ww, Ww, Ww, Rr^Vd, Ww, Ww, Ww, Gs^Fds, Gs^Fds, Gg, Gs^Es, Gs
Gg, Gg, Gs, Gg, Gs^Fds, Gg, Gg, Gg, Gs, Gg, Gs, Gg, Gg, Gg, Gg^Es, Gg, Ww, Ww, Gs^Fds, Gs, Hh^Fds, Hh, Hh, Gs, Gs, Gg, Gg, Rr^Vd, Gg, Ww, Gg, Ww, Gs^Fds, Ww, Ww, Ww, Ww, Md, Ww, Ww, Ww, Wwf, Ww, Ww, Gs, Gg^Es, Gs, Gg, Gg, Gg, Gs, Gs, Gs^Es, Gs, Gs^Fds
Gs, Gg, Gs, Gs^Fds, Gll, Gs^Fds, Gs, Gs, Gg, Gg^Es, Gg^Es, Gg, Gs, Gs, Gs, Gg, Wwf, Ww, Gs, Hh^Fds, Hh, Hh, Hh, Gs, Gs^Es, Gg, Gg, Gg^Es, Gg, Gg, Gs, Gs, Hh, Gs^Fds, Gs^Fds, Ww, Ww, Ww, Ww, Ww, Gs^Fds, Wwf, Gll, Gs^Fds, Gs^Fds, Gs, Gs^Fds, Gs, Gg^Es, Gs, Gs^Fds, Gs^Fds, Gs, Gs^Es, Gs^Fds
Gs, Gs^Fds, Gs^Fds, Gs, Gs^Fds, Gs^Fds, Gs^Fds, Gs, Gg, Gg, Gg, Gs, Gs^Fds, Gs^Fds, Ww, Ww, Ww, Wwf, Gs, Gs^Fds, Gs^Fds, Hh, Gs, Gs, Gs, Gs, Gs, Gs, Gs, Gg^Es, Gs, Hh, Hh, Hh^Fds, Hh^Fds, Gs^Fds, Wwf, Ww, Ds, Gs^Fds, Gs^Fds, Gs^Fds, Hh^Fds, Gs^Fds, Gs^Es, Gs, Gs^Fds, Gs, Gg, Gs, Gs^Fds, Gs, Gg, Gs^Es, Gs^Fds
Gs, Gs^Fds, Hh^Fds, Gll, Hh^Fds, Hh^Fds, Hh^Fds, Gs, Rr^Vd, Gg, Gg, Gs, Ww, Ww, Ww, Ww, Rr^Vd, Gg, Gs, Gs, Gs, Gs, Gs^Es, Gs, Gs^Fds, Gs^Fds, Gs^Fds, Gs^Fds, Gs, Gs, Gs^Fds, Hh^Fds, Hh^Fds, Hh, Hh^Fds, Gs^Fds, Wwf, Wwf, Ds, Gs^Es, Gs, Hh^Fds, Md, Hh^Fds, Hh, Gs, Gs^Fds, Gs, Gg^Es, Gs, Gs^Fds, Gs, Gs^Fds, Gs, Gs
Gs, Gs^Fds, Hh^Fds, Hh, Hh, Hh, Hh^Fds, Hh, Hh, Gs, Ww, Ww, Ww, Ww, Gs, Gs^Fds, Gg, Gg, Gg^Es, Gg^Es, Gs, Gs, Gs^Fds, Gs^Fds, Hh^Fds, Gll, Hh, Hh^Fds, Gs^Fds, Gs, Gs, Gs^Fds, Hh^Fds, Hh, Hh, Gs^Fds, Ww, Wwf, Ww, Gs, Gs^Fds, Hh, Md, Md, Hh^Fds, Hh^Fds, Gs^Fds, Gs, Gs, Gs, Gs, Gs, Gs, Gg, Gs
Gs^Fds, Gs^Fds, Gll, Hh, Hh^Fds, Hh^Fds, Hh^Fds, Hh, Hh, Gs, Ww, Ww, Gs, Gg, Gg, Gs, Gg, Gs^Es, Gs, Gs, Hh, Hh, Hh^Fds, Hh^Fds, Hh^Fds, Hh, Hh, Hh^Fds, Gs, Gs, Gs^Fds, Gs^Fds, Hh, Hh, Gs^Fds, Ds, Gs^Fds, Wwf, Ww, Rr^Vd, Gs^Fds, Hh^Fds, Hh^Fds, Hh, Hh^Fds, Gs^Fds, Gs, Gs, Rr^Vd, Gs^Fds, Gs^Es, Gg^Es, Gs, Gs, Hh
Gs, Gs^Fds, Gs^Fds, Gs, Gs^Fds, Gs^Fds, Gs^Fds, Gs, Gs^Es, Gs, Ww, Ww, Gg, Gs^Es, Gs, Gs^Es, Gg, Gg, Gs, Hh, Hh^Fds, Hh, Hh, Hh, Hh^Fds, Hh^Fds, Gs^Fds, Gs^Fds, Gs, Gs, Gs^Fds, Hh^Fds, Hh^Fds, Hh^Fds, Gs^Fds, Gs^Es, Ww, Ww, Ww, Gs^Fds, Gs^Fds, Hh^Fds, Hh^Fds, Hh, Gs^Fds, Gs^Fds, Gs, Gs, Gs^Fds, Gs^Fds, Gs, Gs, Gs, Hh, Hh
Gs, Gs^Fds, Ww, Gs, Ww, Gs, Ww, Gs^Es, Ww, Ww, Ww, Ww, Gs, Gs, Gs^Fds, Gs, Gs, Gs^Es, Gs^Fds, Hh^Fds, Gs^Fds, Hh^Fds, Gs, Hh, Gs^Fds, Gs^Fds, Gs^Fds, Gs, Gg, Gs^Es, Gs, Gs^Fds, Gs, Gs^Fds, Ww, Ww, Ww, Ww, Re^Vct, Ce, Gs, Gs, Gs, Gs, Gs, Gs, Gg^Es, Gs, Gs^Fds, Gs, Gs, Gs^Fds, Hh^Fds, Hh, Hh
Ww, Ww, Ww, Ww, Ww, Ww, Ww, Ww, Ww, Ww, Gs^Es, Gg, Gs, Gs^Fds, Hh^Fds, Hh, Gs, Gs, Gs, Gs^Fds, Gs^Fds, Gs^Fds, Gs, Rr^Vd, Gs^Fds, Gs^Fds, Gs, Gs, Gg^Es, Gg, Gs, Gs^Es, Gg, Gs, Ww, Ww, Ds, Ce, Ce, Ce, Ce, Gs, Re^Vct, Gg, Gs, Gg^Es, Gs, Gs, Gs^Es, Gs^Es, Gs^Fds, Gs^Fds, Hh^Fds, Hh, Hh
Ww, Ww, Gg^Es, Ww, Gg, Ww, Gs, Ww, Gs, Gg, Gs^Es, Gs, Gs, Gs^Fds, Gs, Hh, Gs, Gg, Gg^Es, Gs, Gs, Gs, Gs^Fds, Gs^Fds, Gs, Gs, Gs, Gg, Gg, Gg, Gs, Gg^Es, Gg, Ww, Ww, Ww, Ds, Re^Vct, Ce, 4 Ke, Ce, Gg, Gs, Gs^Es, Gs^Fds, Gs, Gs^Fds, Gg, Gs, Gs, Hh^Fds, Hh^Fds, Hh, Hh, Hh^Fds
Ww, Ww, Gs, Gs, Gs^Fds, Gs, Gs^Fds, Gs^Fds, Gs^Fds, Gs, Gs^Fds, Gs^Es, Gg, Gs, Gs, Gs, Gg^Es, Gs, Gs, Gg, Gg, Gs, Gs, Gs, Gg, Gg, Gg^Es, Gs^Es, Gg, Gs, Gs, Gg^Es, Gg, Ww, Ww, Ds, Gs, Ce, Gg^Es, Ce, Gs, Gs, Gs^Fds, Re^Vct, Gs, Gs^Fds, Gs^Fds, Gs^Fds, Hh, Hh, Hh, Hh, Hh, Hh, Hh^Fds
Gg, Gg^Es, Gs, Gs^Fds, Hh^Fds, Hh, Hh^Fds, Hh^Fds, Hh^Fds, Hh^Fds, Hh^Fds, Gs, Gg, Gs^Es, Gg^Es, Gg, Gg, Gg, Gs, Gg, Gg, Gg^Es, Gg^Es, Gg^Es, Gg, Gg, Gg, Gs, Gs, Gs, Gs, Gg, Gg, Ww, Ww, Ds, Gs, Gg, Gg^Es, Gg, Gs, Gs^Fds, Gs^Fds, Gg, Gg, Hh, Hh^Fds, Hh^Fds, Hh, Hh, Hh^Fds, Hh^Fds, Hh, Hh^Fds, Hh^Fds
