border_size=1
usage=map

Gs^Fms, Gs, Gg, Gg, Gg, Gs^Fms, Gs, Gg, Gg, Gg, Gg, Gg, Gs, Gs, Gs^Fms, Gs, Gs, Gs, Gs, Gg, Gg, Gg, Gg, Gg, Gg, Gg, Gg, Gs, Gs^Fms, Gs^Fms, Gll, Hh, Hh, Hh^Fms, Md, Md, Md, Md, Md, Md, Md, Md, Md, Md^Xm, Md^Xm, Md, Md, Md, Md^Xm, Md, Md^Xm, Md, Md, Md, Md, Md
Gs, Gs, Gs, Gs, Gs, Gs, Gg, Gg^Es, Gg, Gg, Gs^Fms, Gg, Gs, Gs^Fms, Gs, Gs, Gs, Gs^Fms, Gs, Gg, Gg, Gg, Gg^Es, Gg, Gg, Gg, Gs, Gs, Gs, Gs^Fms, Gs^Fms, Hh, Hh, Hh^Fms, Hh^Fms, Md, Md, Md, Md, Md, Md, Md, Md, Md, Md, Md, Md, Md^Xm, Md, Md, Md^Xm, Md^Xm, Md^Xm, Md^Xm, Md^Xm, Md
Gs^Fms, Gs, Gs^Fms, Gs^Fms, Gll, Gg, Gg, Gg, Ce, Gs, Gs, Gs, Gg, Gs, Gg, Gg, Gs, Gs^Fms, Gs, Gg, Gg^Efm, Gg, Gs, Gg, Gg, Gg, Gg, Gg, Gs, Gll, Gs^Fms, Hh^Fms, Hh^Fms, Hh, Hh^Fms, Md, Md, Md, Md, Md, Md, Ww, Md, Md, Md, Md, Md, Md, Md, Md^Xm, Md, Md^Xm, Md, Md, Md^Xm, Md
Gg, Gll, Gs, Gs^Fms, Gs, Gs^Fms, Ce, Gs, Ce, Gg, Ce, Gg, Gg, Gs^Vh, Gs, Gs, Gg, Gs, Gg^Es, Gs, Gg^Efm, Gs, Gg^Efm, Gs, Gg, Gg, Gg^Es, Gg, Gs, Gll, Gs^Fms, Gs^Fms, Hh^Fms, Hh, Hh, Hh, Hh^Fms, Hh^Fms, Hh, Hh, Ww, Ww, Md, Md, Md, Md, Md, Md, Md, Md^Xm, Md, Md, Md, Md^Xm, Md^Xm, Md
Gs, Gs, Gs^Fms, Gs, Gg, Gs, Gg, Ce, 3 Ke, Ce, Gg, Gg, Gg, Gg, Gg, Gs^Fms, Gs, Gg, Gg, Gg^Efm, Gg^Efm, Gg^Efm, Gg, Gg, Gg, Gg, Gg, Gg, Gs, Gs^Fms, Gs^Fms, Gll, Gll, Gll, Gs^Fms, Hh^Fms, Hh, Hh, Ww, Ww, Hh, Hh, Md, Md, Md, Md, Md, Md, Md, Md, Md, Md, Md, Md, Md^Xm, Md
Gg, Gs^Fms, Gll, Gg, Gs, Gg, Ce, Ce, Ce, Ce, Ce, Gs, Gg, Gg, Gg, Gs, Gg, Gg, Gs, Gg, Gg, Gg, Gg^Fet, Gg, Gg, Gg, Gg, Gg, Gg, Gs, Gs, Gs^Fms, Gs, Gs^Fms, Gs, Gs, Ww, Ww, Gll, Hh^Fms, Hh, Hh, Md, Md, Md, Md, Md, Md, Md, Md, Md, Md, Md, Md, Md, Md^Xm
Gs, Gs, Gs, Gs^Fms, Gs, Gs, Gg, Gg, Ce, Gg, Gg, Gg, Gg^Es, Gg, Gg, Gg, Gs, Gg^Es, Gg, Gg, Gs, Gg, Gg, Gg, Gs, Gs, Gs, Gs, Gs, Gg, Gg^Es, Gs, Gg, Gs, Gg, Gg, Ww, Gll, Hh^Fms, Hh^Fms, Hh, Md, Md, Md, Md, Md, Md, Md, Md, Md, Md, Md, Md, Md, Md, Md
Gg, Gg, Gg, Gs, Gg, Gg, Gs, Gs, Gs^Fms, Gs, Gg, Gs, Gg, Gg, Gg, Gg, Gg, Gg, Gg, Gg, Gg, Gs, Gg^Efm, Gs^Efm, Gg, Gs^Es, Gg, Gg, Gg, Gg, Gg, Gg, Gg, Gg, Ww, Ww, Gll, Gs^Fms, Hh, Hh, Hh^Fms, Md, Md, Md, Md, Md, Md, Md, Md, Md, Md, Md, Md, Md, Md, Md
Gg, Gg, Gs^Vh, Gg, Gg, Gg^Es, Gs, Gs^Fms, Gs, Gs, Gs, Gg, Gg, Gs^Vh, Gg, Gg, Gg, Gg, Gs^Es, Gg, Gg, Gg, Gg^Efm, Gg, Gg, Gg, Gg, Gg, Gg, Gs, Gs, Gg, Ww, Ww, Ww, Ww, Ce, Gll, Ce, Hh, Hh, Md, Hh^Fms, Hh^Fms, Hh, Hh^Fms, Hh^Fms, Md, Md, Md, Md, Md, Md, Md, Md, Md
Gs, Gs, Gg, Gs, Gg, Gs, Gs^Fms, Gll, Gll, Gg, Gs, Gg, Gg, Gg, Gg, Gg^Fet, Gg, Gg, Gs, Gg, Gg, Gg, Gs, Gg, Gg, Gg^Es, Gs, Gs, Gg^Fet, Gs^Fms, Ww, Ww, Ww, Ww, Gg, Ce, Re^Vct, Ce, Re^Vct, Ce, Hh, Hh^Fms, Hh, Hh, Hh^Fms, Hh, Hh^Fms, Hh^Fms, Hh, Hh^Fms, Hh^Fms, Hh^Fms, Hh, Md, Md, Md
Gs^Fms, Gs, Gs, Gg, Gg, Gs, Gs, Gs, Gs, Gs^Fms, Gs, Gs, Gs, Gg, Gs, Gg, Gs, Gg, Gs, Gg, Gs, Gs, Gs, Gs, Gs^Fms, Gs, Gs, Gs^Fms, Gs^Fms, Gs^Fms, Ww, Ww, Gg^Fet, Gg, Ce, Ce, Ce, Ce, Ce, Ce, Ce, Hh, Gll, Hh^Fms, Gs^Fms, Hh, Hh, Hh, Hh, Hh, Hh, Hh, Hh, Hh^Fms, Hh^Fms, Md
Gg, Gs^Fms, Gs, Gg, Gg, Gg^Es, Gg, Gs, Gg, Gs, Gg, Gg, Gg, Gs, Gg, Gs, Gg, Gg^Efm, Gs, Gs, Gg, Gg, Gs, Gg^Fet, Gs^Fms, Gs, Gg, Gs, Ww, Ww, Ww, Ww, Gg, Gs, Ce, Re^Vct, Ce, 2 Ke, Ce, Re^Vct, Ce, Gll, Gs^Fms, Gs^Fms, Gll, Gll, Gll, Hh, Hh^Fms, Hh^Fms, Hh^Fms, Hh, Hh, Hh, Hh, Hh^Fms
Gs^Fms, Gs^Fms, Gs^Fms, Gs, Gs, Gs, Gs, Gg, Gs, Gg, Gg, Gg, Gg, Gs, Gs^Vh, Gg, Gg^Efm, Gg^Efm, Gg, Gg, Gg, Gg, Gs, Gll, Gll, Gll, Ww, Ww, Ww, Ww, Gg, Gg, Gg, Gg, Gg, Ce, Re^Vct, Ce, Re^Vct, Ce, Gs^Fms, Gll, Gs^Fms, Gs^Fms, Gs^Fms, Gs^Fms, Gs^Fms, Gll, Gs^Fms, Hh, Gs^Fms, Gll, Gll, Hh^Fms, Hh^Fms, Hh
Gll, Gll, Gll, Gs^Fms, Gll, Gs^Fms, Gs^Fms, Gs, Gs^Fms, Gs, Gs, Gg^Es, Gg, Gs, Gs, Gg, Gs, Gs^Efm, Gg, Gg, Ww, Gs^Vh, Wwf, Gs^Fms, Gs^Fms, Gs^Fms, Wwf, Ww, Gg, Gg, Gs, Gg, Gg, Gg, Gg, Ce, Ce, Ce, Ce, Ce, Gs, Gs^Fms, Gs^Fms, Gll, Gll, Gll, Gs^Fms, Gll, Gll, Gll, Gll, Gs^Fms, Gs^Fms, Gs^Fms, Hh^Fms, Hh
Gll, Gll, Gs^Fms, Gll, Gs^Fms, Gll, Gs^Fms, Gs^Fms, Gs^Fms, Gll, Gs^Fms, Gs, Gg, Gg, Gg^Es, Gg, Gg, Gg, Ww, Ww, Wwf, Wwf, Ww, Ww, Wwf, Ww, Ww, Wwf, Gs, Gs^Es, Gg, Gs^Es, Gg, Gg, Gs, Gg, Gg, Gs, Gg, Gg, Gg, Gs, Gs, Gs^Fms, Gs^Fms, Gll, Gs^Fms, Gs^Fms, Gs^Fms, Gll, Gll, Gll, Gll, Gs^Fms, Gll, Hh^Fms
Gll, Gs^Fms, Gg^Fet, Gll, Gs^Fms, Gs^Fms, Gll, Gs^Fms, Gll, Gs^Fms, Gs^Fms, Gs, Gs, Gg, Gs, Gg, Gg, Ww, Ww, Ww, Gs, Wwf, Hh^Fms, Ww, Ww, Wwf, Gg^Fet, Gg, Gs, Gg, Gs^Fms, Gg, Gg, Gs, Gg, Gg, Gg, Gg, Gg^Fet, Gg, Gs, Gg, Gg, Gs, Gs, Gll, Gs, Gll, Gll, Gs^Fms, Gll, Gll, Gll, Gs^Fms, Gs^Fms, Gs^Fms
Gll, Gs^Fms, Gll, Gll, Hh^Fms, Gll, Gs^Fms, Gg^Fet, Gg^Ve, Gll, Gll, Gs^Fms, Gs^Fms, Gs, Gs, Gg, Wwf, Ww, Ww, Gs, Gs^Fms, Hh^Fms, Hh^Fms, Ww, Ww, Ww, Gs^Vc, Gg, Gg, Gs^Fms, Gll, Gs, Gg, Gg, Gg, Gs, Gs, Gg, Gg, Gg, Gg^Es, Gs, Gg, Gg^Es, Gg, Gs, Gg, Gs, Gs, Gs^Fms, Gs^Fms, Gs^Fms, Gs^Fms, Gs^Fms, Gll, Gll
Gs^Fms, Gll, Gll, Hh^Fms, Hh^Fms, Hh^Fms, Gll, Gs^Fms, Gs^Fms, Gll, Gll, Gll, Gll, Gs^Fms, Gs, Gg, Ww, Wwf, Gg, Gs, Gll, Hh^Fms, Hh^Fms, Hh^Fms, Wwf, Wwf, Ww, Gg, Gs, Gll, Gs^Fms, Gs, Gs, Gg, Gg, Gs, Gs, Gs, Gs, Gg, Gs, Gs, Gg, Gg, Gg, Gg, Gs, Gg, Gg^Es, Gs, Gs, Gs^Fms, Gs^Fms, Gs^Fms, Gs^Fms, Gs^Fms
Gs^Fms, Gs^Fms, Gs^Fms, Hh^Fms, Hh^Fms, Hh^Fms, Gs^Fms, Gll, Hh^Fms, Gs^Fms, Hh^Fms, Gll, Gll, Gs^Fms, Ww, Ww, Ww, Ww, Gg, Gs, Gs^Fms, Gs^Fms, Gs^Fms, Gs^Fms, Gs, Ww, Wwf, Wwf, Gg, Gs, Gs, Gs^Fms, Gs, Gg, Gg, Gg, Gg, Gg, Gg, Gs, Gs, Gg, Gg, Gg^Fet, Gg, Gg, Gs, Gg, Gg, Gg, Gg, Gs, Gs, Gs, Gs, Gs
Gll, Gs^Fms, Gg^Fet, Gs^Fms, Gs^Fms, Gll, Hh^Fms, Hh^Fms, Hh^Fms, Hh^Fms, Gs^Fms, Gs^Fms, Gll, Ww, Ww^Ewf, Ww, Gg, Gs, Gs, Gs, Gs, Gs^Fms, Gs, Gs, Gs, Gs, Ww, Ww, Wwf, Gg, Gg, Gs, Gg, Gg, Gg, Gg^Fet, Gg, Gg^Efm, Gg, Gs^Efm, Gs, Gg, Gs, Gg, Gg, Gs, Gg, Gg^Fet, Gg, Gg, Gs, Gg, Gg, Gg^Es, Gg, Gg
Gs^Fms, Gll, Gll^Es, Gll, Gll, Hh^Fms, Hh^Fms, Hh^Fms, Hh^Fms, Hh^Fms, Gs^Fms, Gll, Ww^Ewf, Ww, Ww, Gg, Gs^Efm, Gs^Fms, Gs, Gg^Es, Gg, Gs, Gg, Gs, Gs^Fms, Gll, Gs^Fms, Wwf, Ww, Gs, Gg, Gs, Gg, Gg, Gg, Gg, Gg, Gg^Efm, Gg^Efm, Gg, Gs, Gs^Vc, Gs, Gg, Gs, Gs, Gs, Gs, Gs, Gs, Gg, Gs, Gs, Gg, Gs, Gg
Gs^Fms, Gs^Fms, Gs^Fms, Gll, Gll, Hh^Fms, Gs^Fms, Hh^Fms, Gs^Fms, Gs^Fms, Gll, Ww, Ww^Ewf, Ww, Gs, Gs, Gs^Fms, Gll, Gs^Efm, Gg, Gs^Efm, Gg, Gs, Gs, Gs, Gs^Fms, Gg^Ve, Ww, Ww, Gg^Fet, Gg, Gg^Es, Gg, Gs^Vc, Gs, Gs, Gs, Gg^Es, Gg, Gg, Gs, Gg, Gg, Gs, Gg, Gg, Gg, Gg, Gs, Gs, Gll, Gs, Gg, Gs, Gs^Fms, Gg
Gll, Gs^Fms, Gs^Fms, Gs^Fms, Gs^Fms, Gs^Fms, Gll, Gll, Ww, Gll, Ww, Ww, Ww^Ewf, Gs, Gs^Fms, Gs^Fms, Gg^Fet, Gs^Fms, Gs, Gg, Gg, Gg, Gg, Gg, Gs^Es, Gs^Fms, Gs^Fms, Ww, Ww, Ww, Gg, Gs, Gg, Gg, Gg, Gg, Gs, Gs, Gg, Gs, Gg, Gg, Gg, Gg, Gg, Gg, Gg, Gg, Gs, Gs^Fms, Gll, Gs^Fms, Gll, Gs^Fms, Gs, Gs
Gs^Fms, Gll, Gg^Fet, Gg^Fet, Gs^Fms, Gll, Ww, Ww, Ww^Ewf, Wwf, Ww, Ww^Ewf, Gg^Efm, Gs, Gs^Fms, Gs^Fms, Gg^Ve, Gs, Gg^Efm, Gg, Gs, Gs^Fms, Gg, Gg^Efm, Gg^Efm, Gs, Gg^Fet, Gs^Fms, Ww, Ww, Gg, Gs, Gg, Gg^Fet, Gg, Gg, Gg, Gg, Gg, Gg, Gg, Gg, Gg, Gg, Gg, Gg, Gg, Gg, Gg, Gll, Gs^Fms, Gg^Fet, Gs, Gs, Gg, Gg
Gll, Gll, Gs^Fms, Gg^Fet, Gll, Ww, Ww^Ewf, Ww^Ewf, Gs, Wwf, Gg, Gg, Gg, Gs, Gs, Gg^Fet, Gs^Fms, Gs, Gg^Efm, Gg^Efm, Gg, Gs, Gg^Efm, Gg, Gg, Gs, Gs^Fms, Gs^Fms, Ww, Ww, Gg, Gs, Gs, Gg, Gg, Gg, Gg, Gg, Gg, Gs, Gg, Gg^Es, Gg, Gg, Gg, Gg^Es, Gs, Gg, Gg, Gs, Gg^Fet, Gs, Gg, Gg, Gg, Gs
Gs^Fms, Gll, Gs^Fms, Gs^Fms, Wwf, Ww^Ewf, Ww, Gs, Gs^Fms, Gs, Gs^Efm, Gg^Efm, Gs^Fms, Gg, Gg, Gs, Gs, Gs, Gg^Efm, Gg, Gs, Gg, Gg^Efm, Gg^Efm, Gg, Gs, Gs^Fms, Wwf, Wwf, Ww, Gg, Gg, Gs^Es, Gg, Gg, Gg, Gs, Gg, Gg, Gs, Gs, Gg, Gg, Gs, Gg, Gg, Gs, Gg, Gg, Gs, Gs, Gs, Gg, Gg, Gs, Gg
Gs^Fms, Gg^Fet, Gll, Gll, Ww^Ewf, Wwf, Gs, Gs, Gg^Fet, Gs^Fms, Gs, Gg^Efm, Gg, Gg^Efm, Gg, Gg, Gs, Gs^Efm, Gg, Gg, Gs, Gs^Fms, Gs, Gg^Efm, Gg, Gs, Ww, Ww, Ww, Gg, Gg, Gg, Gs^Vc, Gs, Gs, Gs, Gg, Gg, Gg^Fet, Gs^Fms, Gg, Gg, Gg, Gg, Gg, Gs, Gg, Gs, Gs^Efm, Gg^Efm, Gs^Efm, Gg, Gg, Gs^Es, Gs, Gs
Gs^Fms, Gs^Fms, Ww, Ww, Ww^Ewf, Ww, Gs^Fms, Gs, Gs^Fms, Gs^Fms, Gll, Gs, Gs, Gs, Gg, Gs^Efm, Gg, Gg, Gg, Gg^Es, Gs, Gs^Fms, Gs^Fms, Gs, Gs, Gg^Es, Ww, Ww, Gg^Fet, Gg, Gs, Gs, Gg, Gg, Gs, Gg, Gg, Gg, Gs, Gs, Gs, Gg, Gs, Gg, Gg, Gs, Gs, Gs, Gs^Efm, Gg, Gg, Gg, Gg, Gs, Gg, Gg
Gs^Fms, Gs^Fms, Ww^Ewf, Ww^Ewf, Gg, Gs, Gg, Gll, Gll, Gg^Ve, Gs^Fms, Gs^Fms, Gll, Gs, Gs, Gg^Efm, Gg, Gg, Gs^Efm, Gs, Gg, Gs, Gs^Fms, Gs, Gg, Gg, Ww, Ww, Ww, Gg, Gs, Gg, Gg, Gs^Efm, Gs, Gg, Gg, Gs, Gs^Fms, Gg, Gs, Gs^Fms, Gg, Gg, Gg, Gs, Gs, Gg, Gg, Gg^Efm, Gg^Efm, Gg^Efm, Gg, Gs, Gg, Gg
Gs^Fms, Gs^Fms, Ww^Ewf, Ww, Gs, Gs, Gs^Fms, Gs^Fms, Hh^Fms, Gs^Fms, Gll, Gs^Fms, Gll, Gs, Gs^Fms, Gs^Efm, Gg, Gg^Efm, Gg, Gs^Efm, Gg^Efm, Gs, Gs^Efm, Gs^Efm, Gs^Efm, Gg, Gg^Ve, Ww, Ww, Gs, Gg, Gg, Gs^Efm, Gg, Gg^Es, Gg^Efm, Gg, Gs, Gs, Gs, Gs, Gs^Fms, Gs, Gg, Gg, Gg, Gs, Gg, Gg, Gs, Gg, Gg, Gg^Es, Gs, Gg, Gg
Gs^Fms, Gll, Ww, Ww, Gs, Gs^Fms, Gll, Hh^Fms, Hh^Fms, Hh^Fms, Hh^Fms, Hh^Fms, Hh^Fms, Gll, Gs^Fms, Gs^Fms, Gs^Fms, Gs, Gs, Gg, Gg, Gg^Efm, Gg, Gg, Gs^Fms, Gs, Gg, Ww, Ww, Gs, Gs, Gg, Gs, Gg^Efm, Gg, Gs, Gs, Gg, Gg, Gg, Gg, Gg, Gg, Gg, Gg, Gg, Gg, Gg, Gg, Gg, Gg, Gg, Gg, Gg, Gs, Gg
Gll, Wwf, Wwf, Ww^Ewf, Gs, Gs^Fms, Gll, Hh^Fms, Hh^Fms, Hh^Fms, Hh^Fms, Hh^Fms, Hh^Fms, Gs^Fms, Gll, Gll, Gs^Fms, Gll, Gs^Fms, Gs, Gs, Gg, Gs, Gs, Gs^Fms, Gs, Gs, Ww, Wwf, Gg, Gg, Gg, Gs^Fms, Gs^Efm, Gs, Gs, Gs, Gg, Gg, Gg, Gg, Gg, Gg, Gs, Gs, Gs^Es, Gg, Gg, Gs, Gg, Gg, Gg, Gg, Gg, Gg, Gg
Ww^Ewf, Ww^Ewf, Ww, Gll, Gs, Gs^Fms, Gs^Fms, Gs^Fms, Gs^Fms, Hh^Fms, Hh^Fms, Hh^Fms, Hh^Fms, Hh^Fms, Hh^Fms, Gll, Gs^Fms, Gg^Fet, Gll, Gs^Fms, Gs^Fms, Gs, Gs^Fms, Gg, Gg, Gs^Fms, Gs, Wwf, Ww, Ww, Ww, Gg, Gs, Gs, Gs^Fms, Gs, Gg, Gs^Vc, Gg, Gg, Gs^Efm, Gs, Gg, Gg, Gg, Gg, Gg, Gg, Gs^Fms, Gs, Gg, Gg, Gg, Gg, Gg, Gg
Ww, Ww^Ewf, Gll, Gs, Gs, Gs^Fms, Gg^Fet, Gll, Gs^Fms, Gs^Fms, Gs^Fms, Hh^Fms, Hh^Fms, Hh^Fms, Hh^Fms, Gll, Gg^Fet, Gs^Fms, Gll, Gll, Gs^Fms, Gg, Gs^Fms, Gg, Gg, Gs^Fms, Gs^Fms, Gs, Gs, Ww, Wwf, Wwf, Gs, Gg, Gs^Fms, Gs, Gg, Gs, Gs^Efm, Gg^Efm, Gg^Es, Gg, Gg^Efm, Gg, Gs, Gs, Gs, Gll, Gll, Gg, Gg, Gg, Gs, Re^Vct, Gg, Gg
Ww^Ewf, Ww, Gs, Gs, Gs^Fms, Gll, Gll, Gs^Fms, Gll, Gll, Gs^Fms, Gll, Hh^Fms, Hh^Fms, Hh^Fms, Gs^Fms, Gs^Fms, Gll, Gll, Gll, Gs^Fms, Gg^Fet, Gs^Fms, Gs^Fms, Hh^Fms, Gg, Hh^Fms, Gs^Fms, Gs, Gg, Ww, Ww, Gs, Gg^Fet, Gs^Fms, Gs, Gs, Gg, Gs, Gg^Efm, Gg, Gs, Gg, Gg, Gs, Gs^Fms, Gs^Fms, Gg^Fet, Gs^Fms, Gg, Gg, Gg, Ce, Gg, Gs, Gg
Gs, Gs, Gs^Fms, Gll, Gg^Fet, Gll, Gll, Gll, Gs^Fms, Gs^Fms, Gs^Fms, Gs^Fms, Hh^Fms, Hh^Fms, Hh^Fms, Gll, Gs^Fms, Gll, Gs^Fms, Gll, Gs^Fms, Gg, Hh^Fms, Hh^Fms, Hh^Fms, Hh^Fms, Hh^Fms, Hh^Fms, Gs, Gg, Ww^Ewf, Ww, Gs, Gs, Gs^Fms, Gs^Fms, Gs^Fms, Gs, Gs, Gg, Gg, Gg^Efm, Gs, Gg, Gg, Gs^Fms, Gll, Gs^Fms, Gs, Gg, Gg, Ce, 1 Ke, Ce, Gg, Gg
Gs, Gll, Gs^Fms, Gs^Fms, Gs^Fms, Gll, Gg^Ve, Gs^Fms, Gs^Fms, Gll, Gll, Gs^Fms, Gs^Fms, Gs^Fms, Gll, Gs^Fms, Gg^Ve, Gs^Fms, Gll, Gll, Hh^Fms, Hh^Fms, Hh^Fms, Hh^Fms, Hh^Fms, Hh^Fms, Gs^Fms, Gs, Gs, Wwf, Wwf, Ww, Gs, Gs^Fms, Gll, Gll, Gs^Fms, Gs^Fms, Gg^Fet, Gs, Gg, Gg, Gs, Gg, Gg, Gg, Gg, Gs, Gg, Gs, Gs, Ce, Ce, Ce, Gs, Gg
Gs^Fms, Gs^Fms, Gll, Gll, Gll, Gs^Fms, Gs^Fms, Gs^Fms, Gg^Fet, Gll, Gll, Gs^Fms, Gg^Fet, Gll, Gll, Gs^Fms, Gll, Gll, Gs^Fms, Hh^Fms, Hh^Fms, Hh^Fms, Hh^Fms, Hh^Fms, Hh^Fms, Gs^Fms, Gll, Gs^Fms, Gs, Ww, Ww^Ewf, Gg, Gs, Gs^Fms, Gs^Fms, Gll, Gs^Fms, Gs^Fms, Gs^Fms, Gs, Gs, Gg, Gg, Gg^Es, Gs, Gg, Gg, Gg, Gs, Gg, Gg, Gs, Gg, Gs, Gs, Gg
Gg, Gg^Fet, Gs^Fms, Gs^Fms, Gll, Gs^Fms, Gll, Gs^Fms, Gg^Fet, Gll, Gs^Fms, Gs^Fms, Kv, Gg^Fet, Kv, Gll, Gll, Gll, Gs^Fms, Gs^Fms, Gll, Hh^Fms, Gll, Hh^Fms, Gs^Fms, Gll, Gll, Gll, Gs, Ww, Wwf, Gg, Gg, Gs, Gll, Gll, Gs^Fms, Gll, Gll, Gs^Fms, Gs, Gs, Gs, Gg, Gs, Gs, Gs^Es, Gg, Gg^Es, Gg, Gg, Gg, Gg, Gg, Gg, Gg
Gg^Fet, Gs^Fms, Gs^Fms, Gll, Gll, Gs^Fms, Gs^Fms, Gll, Gll, Gll, Gs^Fms, Gll, Cv, Cv, Cv, Gs^Fms, Gll, Gs^Fms, Gs^Fms, Gs^Fms, Gll, Gll, Gll, Gll, Gs^Fms, Gs^Fms, Gs^Fms, Gs^Fms, Gs, Wwf, Ww^Ewf, Ww, Gg, Gs, Gs^Fms, Gs^Fms, Gs^Fms, Gll, Gll, Gll, Gs, Gg, Gg, Gs, Gs, Gg, Gg, Gg, Gs, Gg, Gg, Gg, Gs, Gg, Gs^Fms, Gg
Gg^Fet, Gs^Fms, Gll, Gll, Gg^Fet, Gs^Fms, Gs^Fms, Gll, Gll, Gs^Fms, Gll, Kv, Cv, 4 Kv, Cv, Kv, Gll, Gs^Fms, Gs^Fms, Gs^Fms, Gs^Fms, Gll, Gs^Fms, Gs^Fms, Gs^Fms, Gg^Fet, Gll, Gs^Fms, Gs, Gg^Ve, Ww, Ww, Gg, Gs, Gs^Fms, Gll, Gll, Gs^Fms, Gll, Gs^Fms, Gll, Gs, Gs, Gg, Gg, Gg, Re^Vct, Gs, Gs, Gs, Gs, Gs^Fms, Gg, Gll, Gll, Gg
Gg, Gs^Fms, Gs^Fms, Gll, Gll, Gs^Fms, Gs^Fms, Gll, Gg^Fet, Gs^Fms, Gs^Fms, Gs^Fms, Kv, Cv, Kv, Gs^Fms, Gll, Gll, Gll, Gll, Gll, Gll, Gll, Gll, Gs^Fms, Gs^Fms, Gs^Fms, Gll, Gs, Wwf, Wwf, Ww, Gs, Gs, Gg^Fet, Gs^Fms, Hh^Fms, Hh^Fms, Hh^Fms, Gs^Fms, Gs^Fms, Gs^Fms, Gs^Fms, Gs, Gs, Gg, Gg, Gg, Gg, Gs, Gg, Gs, Gg, Gs^Fms, Gs^Fms, Gg
Hh^Fms, Gs^Fms, Hh^Fms, Hh^Fms, Gll, Gll, Gll, Gs^Fms, Gll, Gs^Fms, Gs^Fms, Gs^Fms, Gs^Fms, Gg^Fet, Gs^Fms, Gll, Gs^Fms, Gs^Fms, Gs^Fms, Gll, Gs^Fms, Gll, Gg^Fet, Gll, Gs^Fms, Gs^Fms, Gll, Gs^Fms, Gs, Ww, Ww^Ewf, Gg, Gs, Gs^Fms, Gll, Gs^Fms, Hh^Fms, Hh^Fms, Hh^Fms, Hh^Fms, Hh^Fms, Gll, Gs^Fms, Gs^Fms, Gs^Fms, Gs, Gs, Gg, Gg, Ce, Ce, Ce, Gg, Gg^Fet, Gs, Gg
Hh^Fms, Hh^Fms, Hh^Fms, Hh^Fms, Gs^Fms, Gs^Fms, Gg^Fet, Gs^Fms, Gg^Ve, Gs^Fms, Gll, Gll, Gll, Gs^Fms, Gs^Fms, Gll, Gll, Gg^Ve, Gs^Fms, Gll, Gs^Fms, Gs^Fms, Gs^Fms, Gs^Fms, Gs^Fms, Gll, Gll, Gs^Fms, Gs, Ww, Ww^Ewf, Ww, Gg, Gs, Gs^Fms, Gll, Gs^Fms, Hh^Fms, Hh^Fms, Hh^Fms, Hh^Fms, Hh^Fms, Hh^Fms, Gs^Fms, Gs^Fms, Gs^Fms, Gs^Fms, Gs, Ce, Ce, 5 Ke, Ce, Ce, Gs, Re^Vct, Gg
Hh^Fms, Hh^Fms, Hh^Fms, Gs^Fms, Gll, Gll, Gs^Fms, Gs^Fms, Gg^Fet, Gs^Fms, Gll, Gs^Fms, Gll, Gs^Fms, Gs^Fms, Gs^Fms, Gll, Gll, Gs^Fms, Gll, Gll, Gs^Fms, Gll, Gs^Fms, Gs^Fms, Gs^Fms, Gs^Fms, Gll, Gs, Gg, Ww, Ww^Ewf, Ww, Gs, Gs, Gs, Gs^Fms, Gll, Gs^Fms, Hh^Fms, Hh^Fms, Hh^Fms, Hh^Fms, Gll, Gs^Fms, Gs^Fms, Gll, Gs, Gs, Ce, Ce, Ce, Gs, Gg, Gg, Gg
Hh^Fms, Hh^Fms, Hh^Fms, Gs^Fms, Gll, Gs^Fms, Gs^Fms, Gs^Fms, Gg^Fet, Gs^Fms, Gs^Fms, Gg^Fet, Gll, Gll, Gg^Fet, Gs^Fms, Gll, Gll, Gg^Fet, Gs^Fms, Gs^Fms, Gs^Fms, Gs^Fms, Gs^Fms, Gs^Fms, Gll, Gs^Fms, Gs^Fms, Gll, Gs, Gs, Ww^Ewf, Ww, Ww, Ww, Gg, Gs, Gs^Fms, Gs^Fms, Gll, Gs^Fms, Hh^Fms, Hh^Fms, Hh^Fms, Gs^Fms, Gg^Fet, Gll, Gs, Gs, Ce, Gs, Ce, Gs, Gs, Gg, Gg
Hh^Fms, Hh^Fms, Hh^Fms, Hh^Fms, Gs^Fms, Gll, Gll, Gs^Fms, Gs^Fms, Gs^Fms, Gs^Fms, Gs^Fms, Gg^Ve, Gs^Fms, Gs^Fms, Gs^Fms, Gll, Gs^Fms, Gll, Gs^Fms, Gs^Fms, Gs^Fms, Gs^Fms, Gll, Gll, Gg^Fet, Gs^Fms, Gs^Fms, Gs^Fms, Gll, Gs^Fms, Gs^Fms, Gs^Fms, Ww, Ww, Ww^Ewf, Ww, Gs, Gs, Gs^Fms, Gg^Fet, Hh^Fms, Hh^Fms, Hh^Fms, Gs^Fms, Gll, Gll, Gs^Fms, Gs, Gg, Gs, Gg, Gg, Gg, Gg, Gg
Hh^Fms, Hh^Fms, Hh^Fms, Hh^Fms, Hh^Fms, Gs^Fms, Gs^Fms, Gs^Fms, Gll, Gs^Fms, Gs^Fms, Gs^Fms, Gll, Gs^Fms, Gll, Gll, Gs^Fms, Gs^Fms, Gll, Gs^Fms, Gs^Fms, Gg, Gs^Fms, Gll, Gs^Fms, Gg^Fet, Gs^Fms, Gll, Gs^Fms, Hh^Fms, Hh^Fms, Hh^Fms, Hh^Fms, Gs, Gs, Ww, Ww^Ewf, Ww, Gs, Gs^Fms, Gs^Fms, Hh^Fms, Hh^Fms, Hh^Fms, Gll, Gs^Fms, Gll, Gs^Fms, Gs^Fms, Gs, Gg^Es, Gs, Gg^Es, Gs, Re^Vct, Gg
Gs^Fms, Gll, Hh^Fms, Hh^Fms, Hh^Fms, Hh^Fms, Gs^Fms, Gs^Fms, Gll, Gs^Fms, Gg^Fet, Gs^Fms, Gs^Fms, Gs^Fms, Gs^Fms, Gll, Gs^Fms, Gll, Gs^Fms, Gll, Gs^Fms, Gg^Fet, Gs^Fms, Gll, Gs^Fms, Gg^Fet, Gs^Fms, Gs^Fms, Hh^Fms, Hh^Fms, Hh^Fms, Hh^Fms, Hh^Fms, Gs^Fms, Gs^Fms, Gs, Ww, Ww^Ewf, Ww, Gs, Gs, Gs^Fms, Gll, Gs^Fms, Gll, Gs^Fms, Gs^Fms, Gll, Gs^Fms, Gs, Re^Vct, Gg, Gg, Gs, Gg, Gg
Gs^Fms, Gs^Fms, Gll, Hh^Fms, Gll, Gs^Fms, Gs^Fms, Gll, Gs^Fms, Gs^Fms, Gs^Fms, Gll, Gll, Gs^Fms, Gg^Fet, Gs^Fms, Gll, Gll, Gs^Fms, Gs^Fms, Gs^Fms, Gs^Fms, Gs^Fms, Gll, Gs^Fms, Gs^Fms, Gs^Fms, Gll, Hh^Fms, Hh^Fms, Gs^Fms, Hh^Fms, Hh^Fms, Hh^Fms, Gs^Fms, Gs, Gg, Ww, Ww^Ewf, Gg, Gs, Gs^Fms, Gll, Gs^Fms, Gs^Fms, Gll, Gs^Fms, Gll, Gs^Fms, Gs, Gg, Gg, Gg, Gs, Gg, Gg
Gs^Fms, Gs^Fms, Gll, Gs^Fms, Gs^Fms, Gs^Fms, Gs^Fms, Gs^Fms, Gs^Fms, Gs^Fms, Gs^Fms, Gll, Gs^Fms, Gs^Fms, Gs^Fms, Gs^Fms, Gll, Gs^Fms, Gll, Gll, Gll, Gs^Fms, Gs^Fms, Gs^Fms, Gg, Gs^Fms, Gg, Gs^Fms, Gs^Fms, Hh^Fms, Gg, Gs^Fms, Gs^Fms, Gs^Fms, Gs^Fms, Gs, Gg, Ww, Ww^Ewf, Ww, Gg, Gs, Gs^Fms, Gs^Fms, Gs^Fms, Gll, Gs^Fms, Gs^Fms, Gg, Gs, Gg, Gg, Gs, Gs, Gg, Gg
