border_size=1
usage=map

Mm, Mm, Mm, Mm, Mm^Xm, Md, Md, Md, Md, Md, Md, Md, Md, Mm^Xm, Md, Md, Md, Md, Mm^Xm, Md, Md, Md, Md, Md, Md, Md, Md, Md, Md, Md, Md, Md, Md, Md, Md, Md, Md, Md, Md, Md, Md, Md, Md, Md, Md, Hh, Gs, Wwg, Gs^Ftp, Hh, Md, Md, Md, Md, Md, Md, Md, Md, Mm^Xm, Mm, Mm^Xm, Mm^Xm, Mm^Xm, Mm, Mm^Xm
Mm, Mm, Mm^Xm, Mm^Xm, Md, Md, Mm^Xm, Mm^Xm, Mm^Xm, Mm^Xm, Mm^Xm, Mm^Xm, Md, Md, Md, Md, Md, Md, Md, Mm^Xm, Mm^Xm, Md, Md, Mm^Xm, Mm^Xm, Md, Md, Md, Md, Md, Md, Md, Md, Md, Md, Md, Md, Md, Md, Md, Md, Md, Md, Md, Md, Hh, Gs^Ftp, Wwg, Gs^Ftp, Hh^Ftp, Hh, Md, Md, Md, Md, Mm^Xm, Mm^Xm, Md, Md, Mm^Xm, Md, Md, Md, Mm^Xm, Md
Mm^Xm, Mm^Xm, Md, Md, Md, Mm^Xm, Md, Md, Md, Md, Md, Md, Md, Md, Mm^Xm, Md, Md, Md, Mm^Xm, Md, Md, Md, Mm^Xm, Md, Md, Mm^Xm, Md, Md, Mm^Xm, Mm^Xm, Md, Md, Md, Md, Md, Md, Md, Md, Md, Md, Md, Md, Md, Md, Hh, Hh^Ftp, Gs^Ftp, Wwg, Gg, Gs^Ftp, Gs, Hh, Md, Md, Md, Md, Md, Mm^Xm, Mm^Xm, Md, Mm^Xm, Md, Mm^Xm, Md, Md
Md, Md, Md, Md, Md, Md, Md, Md, Md, Md, Md, Md, Mm^Xm, Md, Md, Mm^Xm, Mm^Xm, Md, Md, Mm^Xm, Mm^Xm, Md, Md, Md, Md, Md, Md, Mm^Xm, Md, Md, Md, Md, Hh^Ftp, Md, Md, Md, Md, Md, Md, Md, Md, Md, Hh^Ftp, Hh, Gg, Gs^Ftp, Ds, Wwg, Ds, Gg, Gs^Ftp, Hh^Ftp, Hh^Ftp, Md, Md, Md, Md, Md, Md, Mm^Xm, Md, Md, Md, Md, Md
Mm^Xm, Md, Md, Md, Md, Md, Md, Md, Md, Md, Md, Md, Md, Md, Mm^Xm, Mm^Xm, Md, Md, Md, Md, Md, Md, Mm^Xm, Md, Md, Mm^Xm, Mm^Xm, Md, Md, Mm^Xm, Md, Hh^Ftp, Gs^Ftp, Hh^Ftp, Hh, Md, Md, Md, Md, Md, Md, Hh^Ftp, Gs^Ftp, Gs^Ftp, Ds, Ds, Wwg, Wwg, Wwg, Ds, Ds, Gs^Ftp, Gs^Ftp, Hh, Hh, Md, Md, Md, Md, Md, Md, Md, Md, Mm^Xm, Md
Mm^Xm, Md, Md, Hh^Ftp, Hh^Ftp, Md, Hh^Ftp, Hh^Ftp, Hh^Ftp, Md, Md, Md, Hh, Md, Md, Mm^Xm, Md, Mm^Xm, Mm^Xm, Md, Md, Md, Md, Mm^Xm, Mm^Xm, Md, Md, Mm^Xm, Md, Md, Md, Hh, Gs^Ftp, Gs^Ftp, Gs^Ftp, Hh^Ftp, Hh^Ftp, Hh^Ftp, Hh, Hh, Hh, Hh^Ftp, Gs^Ftp, Gs^Ftp, Ds, Wwg, Wwg, Wwg, Wwg, Wwg, Ds, Gg, Gs^Ftp, Gs, Gs, Hh, Hh^Ftp, Hh^Ftp, Hh, Md, Md, Md, Md, Md, Md
Mm^Xm, Md, Md, Hh, Gs^Ftp, Hh^Ftp, Gs^Ftp, Gs^Ftp, Gs^Ftp, Hh^Ftp, Hh^Ftp, Hh, Hh^Ftp, Md, Md, Md, Mm^Xm, Mm^Xm, Md, Mm^Xm, Md, Md, Hh^Ftp, Md, Md, Mm^Xm, Md, Md, Mm^Xm, Md, Md, Hh^Ftp, Hh^Ftp, Gs^Ftp, Gg, Gs^Ftp, Gs^Ftp, Gs, Gs, Gs, Ds, Gs^Ftp, Ds, Ds, Wwg, Wwg, Wwg, Wwg, Wwg, Wwg, Wwg, Ds, Ds, Gg, Gs^Ftp, Gs, Gg, Gs^Ftp, Hh, Md, Md, Md, Md, Md, Md
Md, Md, Md, Hh^Ftp, Hh^Ftp, Gs^Ftp, Gs, Gs^Ftp, Gs^Ftp, Gs, Gs, Gs, Gs^Ftp, Hh^Ftp, Hh, Md, Md, Md, Md, Md, Hh, Hh^Ftp, Gs^Ftp, Hh^Ftp, Hh, Md, Mm^Xm, Md, Md, Md, Md, Md, Hh^Ftp, Gs^Ftp, Ce, Gg^Es, Gg^Es, Gs^Ftp, Ds, Ds, Wwg, Ds, Wwg, Wwg, Wwg, Wwg, Wog, Wog, Wog, Wwg, Wwg, Wwg, Ds, Gg, Gs^Ftp, Gs^Ftp, Gg, Gs, Hh^Ftp, Md, Md, Md, Md, Md, Md
Md, Md, Md, Md, Hh^Ftp, Hh^Ftp, Gs, Gs^Ftp, Gs^Ftp, Gs^Es, Gs^Ftp, Gs^Ftp, Gs, Gs^Ftp, Hh, Hh^Ftp, Hh^Ftp, Md, Md, Hh, Hh, Gs^Ftp, Gs^Ftp, Gs^Ftp, Hh, Md, Md, Mm^Xm, Mm^Xm, Md, Md, Hh, Gg, Ce, 1 Ke, Ce, Gs^Ftp, Gs^Ftp, Ds, Wwg, Wwg, Wwg, Wwg, Wwg, Wwg, Wog, Wog, Wog, Wog, Wwg, Wwg, Wwg, Wwg, Ds, Gs, Gs^Ftp, Gs^Ftp, Gs^Ftp, Hh^Ftp, Hh, Md, Md, Md, Md, Md
Md, Md, Md, Md, Md, Hh, Hh^Ftp, Gs^Ftp, Gs^Es, Gs^Ftp, Gs, Gs^Ftp, Gs, Gs^Ftp, Gs^Ftp, Gs^Ftp, Gs, Hh, Hh^Ftp, Hh^Ftp, Gs, Gg, Gg^Es, Gg, Gs, Hh, Hh, Md, Md, Md, Hh, Hh, Gs, Ce, Ce, Ce, Ds, Ds, Wwg, Wwg, Wwg, Wwg, Wog, Wog, Wog, Wog, Wog, Wog, Wog, Wog, Wwg, Wwg, Wwg, Ds, Gg, Gs^Ftp, Hh, Hh^Ftp, Md, Md, Md, Md, Md, Md, Md
Md, Mm^Xm, Md, Md, Md, Md, Md, Hh, Gs^Es, Gs, Gs^Ftp, Gs^Es, Gs^Ftp, Gs^Ftp, Gs^Ftp, Gs^Ftp, Gs, Gs^Ftp, Gg, Gs, Gs, Gg, Gs, Gs, Gs, Gs, Gs^Es, Hh, Hh, Hh, Gs, Re^Vct, Gs, Gg, Gs, Ds, Wwg, Wwg, Wwg, Wwg, Wog, Wog, Wog, Wog, Wog, Wog, Wog, Wog, Wog, Wog, Wwg, Wwg, Ds, Ds, Gs^Ftp, Gg, Hh, Md, Md, Mm^Xm, Mm^Xm, Md, Md, Mm^Xm, Md
Md, Md, Md, Mm^Xm, Md, Md, Md, Hh^Ftp, Gs^Ftp, Gs^Ftp, Gs^Ftp, Gs^Es, Gs^Es, Gs, Gs^Ftp, Ce, Gs^Ftp, Gs^Ftp, Gg, Gs, Gg, Gg^Es, Gs, Gs, Hhd, Gs^Es, Gs, Gs, Uu, Uu, Uu, Gs, Gs, Gs^Es, Gs^Es, Ds, Wwg, Wwg, Wog, Wog, Wog, Wog, Wog, Wog, Wog, Wog, Wog, Wog, Wwg, Wwg, Wwg, Wwg, Ds, Gs^Ftp, Gg, Hh^Ftp, Md, Md, Md, Md, Md, Mm^Xm, Md, Mm^Xm, Mm^Xm
Md, Md, Md, Mm^Xm, Md, Md, Md, Hh, Gs, Gs^Ftp, Gs, Gs^Ftp, Gs, Ce, Ce, Ce, Ce, Ce, Gs, Re^Vct, Gs, Gs, Hhd, Hhd, Md, Hhd, Hhd, Gs, Hhd, Uu, Hhd, Gs, Hhd, Gs, Gs, Ds, Wwg, Wog, Wog, Wog, Uu, Uu, Uu, Wog, Wog, Wog, Wog, Wog, Wwg, Wwg, Ds, Ds, Gs^Ftp, Gs^Ftp, Gs^Ftp, Hh^Ftp, Hh^Ftp, Md, Md, Md, Md, Md, Md, Mm^Xm, Md
Md, Md, Md, Mm^Xm, Md, Md, Md, Hh^Ftp, Gs^Ftp, Gs^Ftp, Gs^Ftp, Gs^Ftp, Gs, Gs^Ftp, Ce, 3 Ke, Ce, Gg, Gs, Gg, Gs, Gs, Hhd, Md, Md, Md, Md, Hhd, Md, Uh, Md, Hhd, Md, Hhd, Gs, Ds, Wwg, Wwg, Wwg, Uu, Uu, Uu, Uu, Uu, Wwg, Wog, Wwg, Wwg, Wwg, Wwg, Ds, Gs^Ftp, Gg, Gs^Ftp, Gs, Gs^Ftp, Gg, Hh, Md, Md, Md, Md, Mm^Xm, Mm^Xm, Md
Md, Md, Md, Mm^Xm, Md, Md, Md, Hh^Ftp, Hh^Ftp, Gs^Ftp, Gs^Ftp, Gs, Gs^Ftp, Ce, Gg, Ce, Gg, Ce, Gs, Gg^Es, Gs, Hhd, Md, Md, Md, Md, Md, Md, Md, Mv, Md, Md, Md, Hhd, Gs, Ds, Ds, Wwg, Ds, Ds, Uu, Qlf, Uu, Uu, Wwg, Wwg, Ds, Wwg, Wwg, Wwg, Ds, Gs^Ftp, Gs^Ftp, Gg, Gs, Gs^Ftp, Gs^Ftp, Hh^Ftp, Hh, Md, Md, Mm^Xm, Mm^Xm, Md, Md
Md, Md, Md, Md, Md, Md, Md, Md, Md, Hh, Hh, Gg, Gg, Gg, Gg, Ce, Gg, Gs, Gg^Es, Gg, Gs, Hhd, Md, Md, Md, Md, Md, Md, Md, Md, Md, Md, Md, Hhd, Gs, Gs, Gs, Ds, Gd, Ds, Qlf, Qlf, Uu, Wwg, Ds, Wwg, Ds, Wwg, Ds, Wwf, Wwf, Gs, Gg^Es, Gs^Ftp, Gs^Ftp, Gs^Ftp, Gg, Hh^Ftp, Md, Md, Md, Md, Md, Mm^Xm, Md
Md, Md, Md, Md, Md, Md, Md, Md, Md, Md, Md, Hh, Gs, Gg^Es, Gs, Gs, Re^Vct, Gg, Gs, Gs, Hhd, Hhd, Md, Md, Md, Md, Md, Md, Md, Md, Hhd, Md, Hhd, Rr^Vd, Gs, Gs^Es, Gs, Gs, Gd, Qlf, Gd, Ds, Ds, Ds, Rr^Vd, Ds, Gs, Ds, Uu, Ds, Gs, Wwg, Wwf, Gg, Gs^Ftp, Gs^Ftp, Gg, Hh, Md, Md, Md, Md, Md, Md, Md
Md, Md, Mm^Xm, Md, Md, Md, Mm^Xm, Md, Md, Md, Md, Hh, Gs, Re^Vct, Gg, Gs^Es, Gs, Gs, Gs, Hhd, Md, Md, Md, Mv, Md, Md, Md, Md, Md, Hhd, Hhd, Hhd, Gs, Gs, Gg, Gg, Gs^Es, Gd, Qlf, Qlf, Gd, Gs, Gs^Es, Gs, Gs, Gs, Uu, Uu, Uu, Uu, Gs, Gs^Es, Gs, Wwf, Gg, Gs^Ftp, Gs^Ftp, Hh^Ftp, Hh^Ftp, Md, Md, Md, Md, Mm^Xm, Md
Md, Md, Md, Md, Md, Mm^Xm, Mm^Xm, Md, Md, Md, Md, Hh, Hh, Gs, Gg, Gs, Gs, Gs, Hhd, Hhd, Md, Md, Md, Md, Md, Md, Md, Md, Hhd, Hhd, Gs, Gs, Gs, Gs, Gs, Gg, Gs, Gd, Qlf, Gd, Gs, Gs^Es, Gs, Gs, Hhd, Uu, Uh, Uu, Gs, Uu, Gs, Gs, Gs^Es, Wwg, Gs^Es, Gg, Gs^Ftp, Gs^Ftp, Gs^Ftp, Hh, Hh^Ftp, Md, Md, Md, Md
Md, Md, Md, Md, Md, Md, Md, Mm^Xm, Md, Md, Rr^Vd, Hh, Hh, Gs, Gg, Gs, Uu, Uu, Uh, Md, Md, Md, Md, Md, Hhd, Md, Hhd, Hhd, Gs, Gs, Gs, Gg, Gs^Es, Gg, Gg, Gs^Es, Gs, Gd, Qlf, Gd, Gs^Es, Gs, Hhd, Hhd, Md, Uh, Mv, Uh, Rr^Vd, Gs, Gs, Gs, Gs, Wwg, Wwg, Gg^Es, Gg, Gs^Ftp, Gs^Ftp, Gs^Ftp, Hh^Ftp, Md, Md, Md, Md
Mm^Xm, Md, Md, Md, Md, Md, Md, Md, Md, Md, Md, Hh, Hh, Gs, Gs^Es, Gs, Uu, Uh, Md, Mv, Md, Md, Md, Hhd, Gs, Hhd, Gs, Gs, Gs^Es, Gg, Gg, Gs^Es, Gs, Gg, Gs, Gs, Gs, Gd, Qlf, Gd, Gd, Hhd, Md, Md, Md, Md, Md, Md, Md, Hhd, Hhd, Uu, Uu, Gs, Wwg, Gs, Gg, Gs^Ftp, Gs^Ftp, Hh^Ftp, Md, Md, Md, Md, Md
Md, Mm^Xm, Md, Md, Md, Md, Mm^Xm, Mm^Xm, Md, Md, Md, Hh^Ftp, Gs^Ftp, Gg, Gs^Es, Gs, Uu, Uh, Uh, Md, Hhd, Hhd, Hhd, Hhd, Gs, Gs, Gs, Gs, Gs, Gs, Gs, Gs, Gs, Gs, Gs, Gs^Es, Gs, Gd, Gd, Qlf, Qlf, Rr^Vd, Hhd, Md, Md, Md, Md, Md, Md, Md, Uh, Uu, Uu, Gs, Gs, Wwf, Wwf, Gg, Gg, Hh, Md, Md, Md, Md, Md
Md, Md, Md, Mm^Xm, Md, Mm^Xm, Md, Md, Md, Md, Hh^Ftp, Hh^Ftp, Gs^Ftp, Gg, Gs, Gs, Gs, Uu, Uu, Hhd, Gs, Gs, Gs, Gs, Gs^Es, Gs^Es, Gs, Gs, Gs, Gs, Gs, Gs, Hhd, Rr^Vd, Hhd, Hhd, Hhd, Hhd, Hhd, Gd, Gd, Qlf, Qlf, Hhd, Hhd, Md, Ch, Ch, Ch, Md, Md, Uh, Uh, Uu, Uu, Gs^Es, Wwg, Gs^Es, Gs^Es, Hh, Hh, Md, Md, Md, Md
Mm^Xm, Mm^Xm, Mm^Xm, Mm^Xm, Md, Md, Md, Md, Md, Hh, Gs, Gs^Ftp, Gs, Gs, Gs, Gs^Es, Gs, Gs, Gs, Gs, Gs^Es, Gs, Gs^Es, Gs, Gs, Gs, Uu, Uu, Hhd, Hhd, Hhd, Hhd, Md^Xm, Md, Md, Md, Md, Md^Xm, Md^Xm, Hhd, Uh, Uu, Uu, Qlf, Uh, Md, Ch, 4 Kh, Md, Md, Mv, Md, Uh, Uh, Uu, Gs^Es, Gs, Wwg, Gg, Gg, Hh^Ftp, Md, Hh, Md, Md
Mm^Xm, Md, Mm^Xm, Md, Mm^Xm, Md, Mm^Xm, Md, Md, Hh, Hh^Ftp, Gs^Ftp, Gs^Ftp, Gs, Gs, Gs, Gg, Gs, Gg, Gs, Gg, Gs, Gs, Gs, Uu, Uu, Uu, Uh, Uh, Hhd, Md, Md, Md, Md^Xm, Md^Xm, Md, Md, Md, Md, Md^Xm, Md, Uh, Uu, Qlf, Uu, Uh, Ch, Ch, Md, Md, Md, Md, Uh, Uu, Hhd, Gs, Gs^Es, Wwf, Wwf, Gs^Ftp, Gs^Ftp, Hh^Ftp, Hh, Md, Hh
Md, Md, Md, Md, Md, Mm^Xm, Md, Mm^Xm, Md, Md, Hh^Ftp, Gs^Ftp, Gg, Gg, Gs^Es, Gs, Gg, Gs^Ftp, Gs^Ftp, Gg, Gs^Ftp, Gg, Gg, Gs, Uu, Uu, Uh, Uh, Uh, Md, Md^Xm, Md, Md, Md, Md, Md, Md, Mv, Md, Md, Md^Xm, Uh, Uh, Qlf, Uu, Uh, Md, Md, Md, Md, Md, Md, Md, Hhd, Hhd, Gs, Gs^Es, Ds, Wwf, Ds, Ds, Gs^Ftp, Wwg, Hh, Wwg
Md, Md, Md, Md, Md, Md, Md, Mm^Xm, Md, Md, Hh^Ftp, Gs^Ftp, Gg, Gs, Gs, Gs, Gs^Ftp, Gs^Ftp, Hh^Ftp, Gs^Ftp, Gs^Ftp, Gs^Ftp, Gg, Gs^Es, Hhd, Uh, Md, Md, Mv, Md, Md, Md, Hhd, Hhd, Uh, Md, Uh, Md, Uh, Md, Md, Md, Uh, Qlf, Qlf, Uh, Uh, Md, Md, Md, Md, Md, Md, Md, Rr^Vd, Gs, Gs, Ds, Wwf, Wwf, Wwf, Wwg, Wwg, Wwg, Hh
Mm^Xm, Mm^Xm, Md, Mm^Xm, Md, Mm^Xm, Md, Md, Hh, Hh^Ftp, Gs, Gg, Gs, Gs^Es, Gs, Gs, Hh^Ftp, Hh^Ftp, Mm, Hh, Hh^Ftp, Gs^Ftp, Hh^Ftp, Gs^Es, Hhd, Md, Md^Xm, Md, Md, Md, Qlf, Uh, Uh, Uh, Qlf, Qlf, Qlf, Qlf, Qlf, Uh, Uh, Md, Uh, Uu, Qlf, Uu, Uu, Rr^Vd, Md, Md, Md, Md, Md, Md, Hhd, Gs, Wwg, Wwf, Ds, Ds, Gs^Ftp, Gs^Ftp, Gs^Ftp, Hh, Md
Md, Md, Mm^Xm, Md, Md, Md, Hh^Ftp, Hh^Ftp, Gg, Gg, Gs^Es, Gs, Gs, Gs, Hh^Ftp, Hh, Mm, Mm, Mm, Mm, Mm, Hh^Ftp, Hh, Gs, Hhd, Md, Md, Md^Xm, Md^Xm, Md, Uh, Qlf, Qlf, Qlf, Qlf, Uh, Mv, Qlf, Uh, Qlf, Qlf, Uh, Uu, Uu, Qlf, Uu, Uu, Uh, Md, Mv, Md, Md, Md, Md, Hhd, Gs^Es, Wwg, Gs^Ftp, Gg^Es, Gs^Ftp, Gg, Gg, Hh^Ftp, Hh, Md
Md, Md, Md, Md, Md, Hh^Ftp, Hh^Ftp, Gs^Ftp, Gg^Es, Gs^Es, Gs, Gs, Gs^Ftp, Gs^Ftp, Hh^Ftp, Mm, Mm, Mm, Mm, Mm, Mm, Mm, Hh, Gs, Hhd, Md, Md^Xm, Md, Md, Md, Rr^Vd, Qlf, Uh, Uh, Qlf, Md, Md, Md, Md, Uh, Uu, Qlf, Qlf, Qlf, Uu, Uu, Uu, Uh, Uh, Md, Uh, Hhd, Hhd, Md, Hhd, Gs, Wwg, Gs^Ftp, Gs^Ftp, Gs^Ftp, Hh, Hh^Ftp, Md, Md, Md
Mm^Xm, Md, Md, Mm^Xm, Md, Md, Hh^Ftp, Gs^Ftp, Gs^Ftp, Gs, Gs, Gs, Gs^Ftp, Gg, Hh, Mm, Mm, Mm, Mm, Mm, Mm, Hh, Gs, Gs, Hhd, Md, Md, Md^Xm, Md^Xm, Md, Md, Qlf, Mm, Mm, Ch, Mv, Md, Md, Md, Uh, Uh, Uu, Uu, Uu, Uu, Uu, Uu, Uh, Gs, Uh, Uu, Gs, Gs, Hhd, Gs, Gs, Wwg, Gs^Ftp, Hh, Gs^Ftp, Hh^Ftp, Md, Md, Md, Md
Md, Md, Md, Mm^Xm, Mm^Xm, Md, Md, Hh^Ftp, Gs, Gs, Gg^Es, Gs^Ftp, Gg^Es, Hh^Ftp, Mm, Mm, Mm, Mm, Mm, Mm, Mm, Hh, Gs, Gs^Es, Gs, Hhd, Md, Md, Md, Md, Md, Mv, Ch, Ch, Kh, Ch, Ch, Md, Md, Hhd, Md, Uh, Uh, Uu, Uh, Uu, Uh, Uh, Gs, Uu, Uu, Gs, Gs^Es, Gs, Gs^Es, Gs, Wwg, Gs^Ftp, Hh^Ftp, Hh^Ftp, Md, Md, Md, Md, Md
Md, Mm^Xm, Md, Md, Mm^Xm, Md, Md, Rr^Vd, Gs, Gs^Es, Gg^Es, Gs^Ftp, Hh^Ftp, Hh^Ftp, Mm, Mm, Mm, Mm, Mm, Mm, Hh, Hh, Gs, Gs^Es, Gs, Hhd, Hhd, Md, Md, Md, Md, Ch, Kh, Ql, Ch, Ql, Kh, Ch, Md, Md, Md, Mv, Md, Uh, Md^Xm, Uh, Mm, Hhd, Gs^Es, Gs, Gs, Gs, Gs, Gs, Gg, Gg, Wwg, Gs^Ftp, Hh^Ftp, Md, Md, Md, Md, Md, Md
Md, Mm^Xm, Mm^Xm, Mm^Xm, Md, Md, Md, Hh^Ftp, Gs^Ftp, Gs, Gg, Gs^Ftp, Hh, Mm, Mm, Mm, Mm, Mm, Mm, Mm, Hh, Gs^Es, Gs, Gs^Es, Gs, Gs^Es, Gs^Es, Rr^Vd, Hhd, Md, Md, Ch, Ql, Ch, 2 Kh, Ch, Ql, Ch, Md, Mv, Md, Md, Md, Md, Md, Md^Xm, Md^Xm, Hhd, Rr^Vd, Gs^Es, Gs^Es, Gs, Gs^Es, Gs, Gs^Ftp, Gs^Ftp, Gs^Ftp, Wwg, Wwg, Hh, Md, Md, Md, Md, Md
Md, Mm^Xm, Md, Md, Md, Md, Hh^Ftp, Hh^Ftp, Gs^Ftp, Gs, Gs^Es, Gg, Hh, Mm, Md, Mm, Mm, Mm, Mm, Rr^Vd, Gs, Gs^Es, Gs, Gs, Hhd, Hhd, Hhd, Gs^Es, Gs, Hhd, Hhd, Ch, Kh, Ch, Ch, Ch, Kh, Ch, Md, Md, Md, Md, Md, Md, Md, Md, Md, Md, Hhd, Gs, Gs, Gs, Gs, Gg^Es, Gg, Gs^Ftp, Hh^Ftp, Gs^Ftp, Wwg, Md, Md, Md, Md, Md, Md
Md, Md, Md, Md, Hh^Ftp, Md, Hh^Ftp, Gs^Ftp, Gg, Gs, Gs^Ftp, Hh^Ftp, Hh^Ftp, Mm, Mm, Mm, Mm, Mm, Md, Hh, Hh, Gs, Hhd, Hhd, Md, Md, Hhd, Gs^Es, Gs, Gs, Gs, Ch, Ch, Ql, Kh, Ql, Ch, Ch, Md, Md, Md, Md, Md, Md, Md, Md, Md, Md, Hhd, Gs, Gg^Es, Gs^Ftp, Gg, Gs^Ftp, Gg^Es, Hh^Ftp, Md, Hh, Wwg, Hh^Ftp, Hh, Md, Md, Md, Md
Md, Mm^Xm, Md, Md, Hh^Ftp, Hh^Ftp, Gg, Gs^Ftp, Gg, Gs^Es, Gg, Gs^Ftp, Hh, Mm, Mm, Mm, Mm, Mm, Mm, Mm, Hh, Gs, Hhd, Md, Md, Md, Hhd, Gs, Gs, Gs^Es, Gs, Gs, Hhd, Ch, Ch, Ch, Uh, Md, Uh, Md, Md, Md, Md, Md, Md, Md, Md, Md, Hhd, Gs^Es, Gg, Gs^Ftp, Gg, Gs^Ftp, Gs, Hh, Md, Hh^Ftp, Gs^Ftp, Wwg, Hh, Md, Md, Md, Md
Md, Md, Md, Md, Hh^Ftp, Gs^Ftp, Gs^Ftp, Gs^Ftp, Gs, Gs^Es, Gg, Gs^Ftp, Gs^Ftp, Hh^Ftp, Mm, Mm, Mm, Mm, Mm, Hh, Hh, Gs^Es, Hhd, Md, Md, Md, Md, Hhd, Hhd, Gs, Gs, Gs^Es, Gs^Es, Hhd, Uu, Uh, Uu, Uh, Uh, Md, Md, Md, Md, Md, Md, Md, Hhd, Hhd, Gs, Gs, Gs^Ftp, Gs^Ftp, Gg, Gs, Hh, Hh, Md, Hh^Ftp, Hh, Wwg, Gs^Ftp, Hh^Ftp, Md, Md, Md
Md, Mm^Xm, Mm^Xm, Md, Md, Hh^Ftp, Hh^Ftp, Gs^Ftp, Gg^Es, Gs, Gs^Ftp, Gs^Ftp, Gs^Ftp, Hh^Ftp, Mm, Mm, Mm, Mm, Mm, Mm, Hh, Gs^Es, Hhd, Md, Md, Md, Md, Md, Md, Hhd, Hhd, Gs, Gs^Es, Gs, Gs, Uu, Uu, Uu, Uh, Md, Mv, Md, Md, Md, Md, Md, Md, Hhd, Gs, Gg, Gg, Gg, Gs^Es, Gs, Hh, Md, Md, Md, Hh, Wwg, Wwg, Hh^Ftp, Md, Md, Md
Md, Mm^Xm, Md, Mm^Xm, Md, Md, Hh^Ftp, Gs^Ftp, Gg^Es, Gs, Gs^Ftp, Gs^Ftp, Hh, Hh^Ftp, Mm, Mm, Mm, Mm, Mm, Mm, Hh, Gs, Hhd, Md, Md, Md, Mv, Md, Md, Rr^Vd, Hhd, Gs, Gs, Gs^Es, Gs, Uu, Gs, Hhd, Md, Md, Md, Md, Md, Md, Md, Md, Hhd, Hhd, Gs, Gs^Ftp, Gs^Es, Gs, Hh, Hh, Md, Md, Md, Md, Md, Hh, Wwg, Hh, Md, Md, Md
Md, Md, Md, Mm^Xm, Md, Md, Hh, Gg, Gs^Es, Gs, Hh^Ftp, Hh^Ftp, Mm, Mm, Mm, Mm, Mm, Mm, Mm, Mm, Hh, Gs, Gs, Hhd, Md, Md, Md, Md, Md, Md, Md, Hhd, Hhd, Gs, Gs^Es, Gs, Gs, Hhd, Hhd, Md, Md, Md, Md, Md, Rr^Vd, Hhd, Gs, Gs, Gs^Ftp, Gs^Ftp, Gg^Es, Gs, Hh, Md, Md, Md, Mm^Xm, Md, Md, Hh, Wwg, Hh, Hh, Md, Md
Md, Md, Md, Mm^Xm, Md, Hh, Gs^Ftp, Gs, Gs, Gs, Hh^Ftp, Mm, Mm, Mm, Mm, Mm, Mm, Mm, Hh, Hh, Gs, Gs, Gs, Hhd, Md, Md, Md, Md, Md, Md, Md, Md, Md, Hhd, Rr^Vd, Gs, Gs, Gs, Hhd, Md, Md, Md, Md, Md, Md, Hhd, Hhd, Gg^Es, Gs^Ftp, Gg, Gs, Hh, Md, Md, Md, Md, Md, Md, Md, Hh, Wwf, Ds, Ds, Hh, Hh
Mm^Xm, Mm^Xm, Md, Md, Md, Hh, Gs^Ftp, Gs^Ftp, Gg, Rr^Vd, Mm, Mm, Mm, Mm, Mm, Mm, Hh^Ftp, Hh^Ftp, Gs, Gs, Gg, Gs^Es, Gs, Hhd, Rr^Vd, Md, Md, Md, Md, Md, Md, Md, Md, Md, Hhd, Gs, Gs^Es, Gs, Gs^Es, Hhd, Hhd, Md, Md, Md, Md, Md, Hhd, Gs^Es, Gg, Gs, Hh^Ftp, Hh, Md, Md, Md, Mm^Xm, Md, Md, Hh, Hh, Ds, Wwf, Ds, Gs^Ftp, Gg
Md, Md, Mm^Xm, Md, Md, Hh^Ftp, Hh, Gs^Ftp, Gg^Es, Hh^Ftp, Mm, Mm, Mm, Mm, Mm, Hh^Ftp, Gs^Ftp, Gs^Ftp, Gg, Gs, Gs^Es, Gs, Gs, Hhd, Md, Md, Md, Mv, Md, Md, Md^Xm, Md, Md, Md, Hhd, Gs, Gs^Es, Gs, Gs, Gs, Gs^Es, Hhd, Hhd, Md, Hhd, Hhd, Gs, Gs, Gg, Gs^Ftp, Hh^Ftp, Md, Md, Mv, Mm^Xm, Mm^Xm, Md, Md, Hh, Hh, Ds, Wwf, Wwf, Gs^Ftp, Gs^Ftp
Mm^Xm, Md, Md, Mm^Xm, Md, Md, Hh^Ftp, Gs^Ftp, Gg, Hh^Ftp, Mm, Mm, Mm, Mm, Mm, Hh, Gg, Gs^Ftp, Gg^Es, Gs, Gg, Gs, Hhd, Hhd, Md, Md, Qlf, Md, Md, Md, Md, Md^Xm, Md^Xm, Hhd, Hhd, Gs, Gs, Gs, Uu, Gs, Gs, Gs^Es, Gs, Hhd, Gs, Gs, Gs^Ftp, Gs^Es, Gs^Ftp, Gs^Ftp, Rr^Vd, Hh^Ftp, Md, Md, Mm^Xm, Md, Md, Md, Hh, Hh^Ftp, Gs^Ftp, Ds, Wwg, Gg, Gs^Ftp
Md, Md, Mm^Xm, Mm^Xm, Md, Md, Hh^Ftp, Gs^Ftp, Gs, Hh, Mm, Mm, Mm, Mm, Mm, Hh^Ftp, Hh^Ftp, Gs^Ftp, Gg, Gs, Gg, Gs, Hhd, Hhd, Uh, Qlf, Md, Md, Md, Md, Md, Md, Md, Md, Md^Xm, Hhd, Hhd, Uu, Uh, Uu, Gs, Gs, Gs, Gs^Es, Gs, Rr^Vd, Gs^Ftp, Gg^Es, Gs^Ftp, Gg, Hh^Ftp, Md, Md, Md, Md, Md, Md, Md, Hh^Ftp, Hh^Ftp, Gs^Ftp, Wwg, Wwg, Gs^Ftp, Gg
Md, Mm^Xm, Md, Wwg, Wwg, Hh^Ftp, Gs^Ftp, Gs^Ftp, Gg^Es, Hh^Ftp, Hh^Ftp, Mm, Mm, Mm, Mm, Mm, Hh^Ftp, Gg, Gs^Es, Gs, Gs, Gs, Ds, Hhd, Uu, Qlf, Uh, Md, Md, Md, Md, Ch, Ch, Md, Md, Md^Xm, Md^Xm, Uh, Md, Hhd, Hhd, Hhd, Hhd, Hhd, Hhd, Gs, Gs, Gg, Gs^Ftp, Gg, Hh^Ftp, Md, Md, Md, Md, Md, Md, Md, Hh, Gs^Ftp, Gg, Wwg, Gs^Ftp, Gs^Ftp, Hh^Ftp
Mm^Xm, Md, Md, Md, Md, Wwg, Wwg, Ds, Gs^Ftp, Gg^Es, Hh^Ftp, Hh, Hh^Ftp, Mm, Hh^Ftp, Hh, Gs, Gs, Gs, Gs, Ds, Gs, Ds, Wwg, Uu, Uu, Gs^Ftp, Rr^Vd, Md, Md, Md, Md, Ch, 5 Kh, Ch, Md, Md, Md, Mv, Md, Md, Md, Md, Md, Mv, Hhd, Hhd, Gs, Gs^Ftp, Gs^Ftp, Gg^Es, Hh, Hh^Ftp, Md, Hh, Md, Hh^Ftp, Hh^Ftp, Gs^Ftp, Gs^Ftp, Wwg, Wwg, Gs^Ftp, Hh^Ftp, Md
Md, Md, Md, Md, Md, Hh, Ds, Wwg, Gs^Ftp, Gs^Ftp, Gs^Ftp, Hh, Ds, Hh^Ftp, Re^Vct, Gg, Gs, Gs, Ds, Ds, Wwg, Ds, Wwg, Wwg, Wwg, Wwg, Wwg, Gs^Ftp, Md, Md, Md, Md^Xm, Md^Xm, Ch, Md, Ch, Md, Md, Md, Md, Md, Md, Md, Md, Md, Md, Hhd, Gs, Gs^Ftp, Gs^Ftp, Gs^Ftp, Gg^Es, Gs^Ftp, Hh^Ftp, Gg, Hh, Gg, Gs^Ftp, Gg, Wwg, Wwg, Wwg, Gs^Ftp, Hh^Ftp, Md
Md, Md, Hh^Ftp, Md, Hh^Ftp, Hh^Ftp, Ds, Wwg, Wwf, Ds, Wwg, Wwf, Wwf, Wwf, Wwg, Wwf, Wwf, Gs, Wwg, Wwg, Wwg, Wwg, Wwg, Wwg, Wog, Wwg, Wwg, Wwg, Wwg, Md, Md, Md, Md, Md^Xm, Md, Md, Md, Md, Mv, Qlf, Qlf, Md, Md, Md, Md, Hhd, Gs, Gg^Es, Gg, Gs^Ftp, Ds, Gg, Gs^Ftp, Gs^Ftp, Gg, Gs, Gs, Gs^Ftp, Wwg, Wwg, Gs^Ftp, Gg, Hh^Ftp, Hh, Md
Md, Hh^Ftp, Gs^Ftp, Hh, Gg, Gs^Ftp, Wwg, Wwg, Ds, Wwf, Ds, Gs^Ftp, Ce, Ce, Ce, Gs^Ftp, Gs^Ftp, Wwg, Ds, Wwg, Wwg, Wwg, Wog, Wog, Wog, Wog, Wwg, Wwg, Wwg, Hhd, Hhd, Md, Md, Md, Md, Md, Md, Md, Md, Md, Md, Qlf, Qlf, Md, Uh, Hhd, Gd^Es, Gs^Es, Ds, Ds, Wwg, Ds, Ds, Gs^Ftp, Wwg, Wwf, Wwf, Wwf, Gs^Ftp, Gs^Ftp, Hh^Ftp, Hh, Md, Md, Md
Md, Hh, Gs^Ftp, Gs^Ftp, Wwg, Wwg, Gs^Ftp, Ds, Re^Vct, Ds, Ce, Hh^Ftp, Ce, 6 Ke, Ce, Hh^Ftp, Ce, Re^Vct, Ds, Wwg, Wwg, Wog, Wog, Wog, Wog, Wog, Wwg, Wwg, Wwg, Ds, Gs, Hhd, Hhd, Md, Md, Md, Md, Md, Md, Md, Md, Uh, Uh, Qlf, Qlf, Uu, Ds, Ds, Uu, Wwg, Wwg, Wwg, Wwg, Wwg, Gs, Gg, Gg, Gs^Ftp, Hh, Hh^Ftp, Md, Md, Md, Md, Md
Hh^Ftp, Hh^Ftp, Gg, Wwg, Gs^Ftp, Gg, Hh^Ftp, Gs^Ftp, Hh^Ftp, Hh^Ftp, Md, Ce, Mm, Ce, Md, Ce, Gg, Gs^Ftp, Ds, Wwg, Wwg, Wog, Wog, Wog, Wog, Wwg, Wwg, Wwg, Ds, Ds, Gg, Gs, Gs, Hhd, Hhd, Md, Hhd, Hhd, Hhd, Md, Hhd, Hhd, Gd, Uu, Uu, Qlf, Qlf, Uu, Uu, Wog, Wog, Wwg, Wwg, Ds, Gs^Ftp, Gs^Ftp, Hh^Ftp, Hh^Ftp, Md, Md, Md, Md, Md, Md, Mm^Xm
Gs^Ftp, Gs^Ftp, Wwg, Wwg, Gs^Ftp, Gs^Ftp, Hh^Ftp, Hh, Md, Md, Md, Md, Mm^Xm, Ce, Md, Hh, Hh^Ftp, Gs^Ftp, Gs^Ftp, Ds, Wwg, Wwg, Wog, Wog, Wwg, Wwg, Ds, Ds, Gg, Gs^Ftp, Gs^Ftp, Gg, Gs, Gs, Gs, Rr^Vd, Gs, Gs, Gs, Hhd, Gs, Gs, Gs, Gd, Wwf, Uu, Uu, Uu, Wog, Wog, Wog, Wwg, Wwg, Ds, Gs^Ftp, Gs, Hh^Ftp, Md, Md, Md, Md, Md, Md, Md, Md
Wwg, Wwg, Gs^Ftp, Gs^Ftp, Gg, Hh^Ftp, Md, Md, Md, Md, Md, Md, Md, Md, Md, Md, Hh^Ftp, Gs^Ftp, Gs^Ftp, Ds, Ds, Wwg, Wwg, Wwg, Wwg, Ds, Ds, Gg, Gs^Ftp, Gs^Ftp, Hh^Ftp, Gs^Ftp, Hh, Gs, Gg, Gs, Gg, Gs, Gs, Gs, Wwf, Wwg, Wwg, Wwf, Gs, Uu, Uu, Wog, Wog, Wog, Wwg, Wwg, Wwg, Ds, Gs^Ftp, Gs^Ftp, Hh, Md, Md, Md, Md, Md, Mm^Xm, Md, Md
Gs, Gs^Ftp, Gg, Gs^Ftp, Hh^Ftp, Hh^Ftp, Md, Md, Md, Md, Md, Md, Md, Md, Md, Md, Hh^Ftp, Gs^Ftp, Gs^Ftp, Gg, Gg, Ds, Wwg, Wwg, Ds, Ds, Gs^Ftp, Gs, Hh, Hh^Ftp, Md, Hh^Ftp, Md, Hh, Hh^Ftp, Gs^Ftp, Gs^Ftp, Gg, Wwg, Wwf, Gs^Ftp, Gs^Ftp, Gs^Ftp, Re^Vct, Gs, Ds, Ds, Wwg, Wwg, Wog, Wwg, Wwg, Ds, Ds, Hh^Ftp, Hh^Ftp, Md, Md, Md, Md, Mm^Xm, Md, Mm^Xm, Md, Md
Hh^Ftp, Hh^Ftp, Hh, Hh^Ftp, Md, Md, Md, Md, Md, Md, Mm^Xm, Md, Mm^Xm, Md, Md, Md, Md, Hh^Ftp, Gg, Gs^Ftp, Gs^Ftp, Wwg, Wwg, Wwg, Ds, Gs^Ftp, Hh^Ftp, Hh^Ftp, Md, Hh^Ftp, Md, Md, Md, Md, Md, Hh^Ftp, Wwf, Wwg, Hh, Hh, Hh, Hh, Hh^Ftp, Gs^Ftp, Gs^Ftp, Ce, Ds, Wwg, Wwg, Wwg, Ds, Wwg, Ds, Gs^Ftp, Hh^Ftp, Md, Md, Md, Md, Md, Mm^Xm, Mm^Xm, Mm^Xm, Mm^Xm, Md
Md, Md, Md, Md, Md, Md, Md, Md, Md, Mm^Xm, Mm^Xm, Md, Md, Mm^Xm, Md, Md, Md, Hh, Hh^Ftp, Gs^Ftp, Gs^Ftp, Wwg, Wwg, Ds, Gs^Ftp, Gg, Hh, Md, Md, Md, Md, Md, Md, Md, Md, Hh^Ftp, Wwf, Hh^Ftp, Md, Md, Md, Md, Md, Ce, Ce, Ce, Ce, Ce, Wwg, Ds, Gs^Ftp, Ds, Gs^Ftp, Hh, Md, Md, Md, Md, Md, Md, Mm^Xm, Md, Mm^Xm, Mm^Xm, Md
Md, Md, Mm^Xm, Mm^Xm, Md, Mm^Xm, Md, Md, Mm^Xm, Md, Md, Md, Md, Md, Md, Md, Md, Md, Md, Hh^Ftp, Gs^Ftp, Wwg, Wwg, Gs^Ftp, Gs^Ftp, Hh^Ftp, Md, Md, Md, Md, Md, Md, Md, Hh^Ftp, Hh^Ftp, Hh, Wwg, Hh^Ftp, Md, Md, Md, Md, Md, Hh^Ftp, Ce, 7 Ke, Ce, Gs^Ftp, Wwg, Re^Vct, Gs^Ftp, Gs, Hh^Ftp, Hh^Ftp, Md, Md, Md, Mm^Xm, Mm^Xm, Mm^Xm, Mm^Xm, Md, Md, Mm^Xm, Md
Md, Md, Md, Md, Md, Md, Md, Md, Mm^Xm, Md, Mm^Xm, Md, Mm^Xm, Md, Mm^Xm, Md, Md, Md, Md, Hh^Ftp, Gs^Ftp, Gg, Gs^Ftp, Wwg, Gs^Ftp, Hh^Ftp, Hh, Md, Md, Md, Md, Md, Md, Hh^Ftp, Wwf, Wwf, Hh^Ftp, Hh, Md, Md, Mm^Xm, Md, Md, Md, Hh, Ce, Gs^Ftp, Gs^Ftp, Wwg, Gs^Ftp, Hh^Ftp, Hh, Md, Md, Md, Md, Mm^Xm, Md, Mm^Xm, Md, Md, Md, Mm^Xm, Mm^Xm, Md
Mm^Xm, Md, Md, Md, Md, Md, Mm^Xm, Mm^Xm, Md, Md, Md, Mm^Xm, Md, Mm^Xm, Md, Mm^Xm, Md, Md, Md, Hh, Hh^Ftp, Gs^Ftp, Gs^Ftp, Wwg, Wwg, Gs^Ftp, Gs^Ftp, Hh^Ftp, Md, Md, Md, Md, Md, Hh, Wwf, Hh^Ftp, Md, Md, Md, Md, Mm^Xm, Md, Md, Md, Md, Hh^Ftp, Hh^Ftp, Re^Vct, Wwg, Hh^Ftp, Md, Md, Md, Md, Md, Mm^Xm, Md, Mm^Xm, Mm^Xm, Mm^Xm, Mm^Xm, Mm^Xm, Md, Mm^Xm, Md
Mm^Xm, Md, Md, Md, Md, Md, Md, Md, Md, Md, Md, Md, Md, Mm^Xm, Md, Md, Md, Md, Md, Md, Md, Hh^Ftp, Gs^Ftp, Ds, Wwg, Gs^Ftp, Gs^Ftp, Hh^Ftp, Hh, Md, Md, Md, Hh^Ftp, Hh, Wwg, Hh^Ftp, Md, Md, Md, Md, Mm^Xm, Md, Md, Md, Md, Md, Hh^Ftp, Gs^Ftp, Wwg, Hh^Ftp, Md, Md, Md, Md, Mm^Xm, Mm^Xm, Md, Md, Mm^Xm, Mm^Xm, Md, Md, Md, Mm^Xm, Md
Md, Mm^Xm, Md, Md, Md, Mm^Xm, Mm^Xm, Md, Md, Md, Md, Md, Md, Md, Md, Mm^Xm, Md, Md, Md, Md, Md, Hh^Ftp, Hh, Gs^Ftp, Gs^Ftp, Wwg, Wwg, Gs^Ftp, Hh, Md, Hh, Md, Hh^Ftp, Gs^Ftp, Wwg, Hh, Md, Md, Md, Mm^Xm, Md, Mm^Xm, Md, Md, Md, Md, Hh, Gs^Ftp, Wwg, Hh, Hh^Ftp, Md, Md, Md, Mm^Xm, Mm^Xm, Md, Md, Mm^Xm, Mm^Xm, Md, Md, Md, Mm^Xm, Md
Md, Md, Md, Md, Mm^Xm, Md, Mm^Xm, Md, Md, Md, Md, Md, Md, Md, Mm^Xm, Md, Md, Md, Md, Md, Md, Md, Hh^Ftp, Gs^Ftp, Gs^Ftp, Gs^Ftp, Gs^Ftp, Wwg, Wwg, Hh, Gs^Ftp, Hh, Wwg, Wwg, Gs^Ftp, Hh, Md, Md, Md, Md, Mm^Xm, Md, Mm^Xm, Md, Md, Md, Md, Hh, Wwg, Hh^Ftp, Hh^Ftp, Md, Md, Md, Md, Mm^Xm, Mm^Xm, Md, Md, Mm^Xm, Mm^Xm, Md, Md, Mm^Xm, Md
Md, Md, Mm^Xm, Md, Md, Md, Md, Md, Mm^Xm, Md, Md, Md, Mm^Xm, Mm^Xm, Md, Md, Mm^Xm, Md, Md, Md, Md, Md, Md, Hh^Ftp, Hh^Ftp, Hh, Hh^Ftp, Wwg, Wwg, Gs^Ftp, Wwg, Wwg, Gs^Ftp, Gs^Ftp, Hh^Ftp, Hh^Ftp, Md, Md, Md, Mm^Xm, Mm^Xm, Md, Mm^Xm, Md, Md, Md, Md, Hh^Ftp, Hh^Ftp, Wwg, Wwg, Hh^Ftp, Hh^Ftp, Md, Md, Md, Md, Mm^Xm, Mm^Xm, Md, Md, Md, Mm^Xm, Mm^Xm, Md
Md, Mm^Xm, Md, Md, Md, Md, Md, Md, Mm^Xm, Md, Md, Md, Md, Md, Md, Md, Md, Mm^Xm, Md, Md, Md, Md, Md, Md, Md, Md, Hh^Ftp, Gs^Ftp, Gs^Ftp, Wwg, Wwg, Gs^Ftp, Gs^Ftp, Gs, Hh, Md, Md, Md, Mm^Xm, Mm^Xm, Md, Md, Md, Mm^Xm, Md, Md, Md, Md, Hh^Ftp, Gs^Ftp, Wwg, Gs^Ftp, Hh^Ftp, Md, Md, Md, Md, Md, Md, Mm^Xm, Md, Mm^Xm, Mm^Xm, Mm^Xm, Md
Mm^Xm, Md, Md, Md, Md, Mm^Xm, Mm^Xm, Md, Md, Md, Md, Md, Mm^Xm, Md, Md, Md, Mm^Xm, Mm^Xm, Md, Md, Md, Md, Md, Md, Md, Md, Md, Hh^Ftp, Gs, Gs^Ftp, Wwg, Gs^Ftp, Gs, Hh^Ftp, Md, Md, Md, Md, Mm^Xm, Md, Md, Mm^Xm, Md, Mm^Xm, Md, Md, Md, Hh^Ftp, Gs, Gs^Ftp, Wwg, Gs^Ftp, Gs, Hh, Md, Md, Md, Md, Md, Md, Md, Md, Md, Mm^Xm, Md
