border_size=1
usage=map

Rp, Gs, Gs, Gs, Gs, Gs, Gs^Es, Gll, Gll^Fmf, Gll, Gll^Fmf, Hhd, Hhd^Fmf, Hhd, Hhd^Fmf, Hhd, Hhd, Hhd, Hhd, Hhd, Hhd^Fmf, Hhd, Hhd, Gll^Fmf, Gll^Fmf, Gll, Gll^Fmf, Gll, Gs, Gs, Ww, Wo, Ww, Gs, Gll, Gll^Fmf, Gll, Gll, Gll^Fmf, Gll, Gll, Gll, Gll, Gll
Gs, Rp, Rp, Gs, Gs, Re^Vct, Gs, Ce, Gll, Gll^Fmf, Gll^Em, Gll^Fmf, Hhd^Fmf, Hhd^Fmf, Hhd, Hhd^Fmf, Hhd, Hhd^Fmf, Hhd^Fmf, Hhd^Fmf, Hhd, Hhd^Fmf, Hhd, Gll^Fmf, Gll, Gll, Gll^Fmf, Gll, Gd^Es, Gd^Es, Ww, Wo, Ww, Gs, Gll, Gll^Fmf, Gll^Fmf, Gll, Hhd, Gll^Fmf, Gll^Fmf, Gll^Es, Gll, Gll^Fmf
Gs, Gd, Gs, Rp, Rp, Ce, Ce, Ce, Ce, Ce, Gll^Fmf, Gll^Fmf, Gll^Em, Hhd, Gll^Fmf, Hhd^Fmf, Gll^Fmf, Hhd^Fmf, Gll^Em, Hhd, Gll^Fmf, Hhd^Fmf, Gll^Fmf, Gll^Fmf, Gll^Fmf, Gll^Fmf, Gll, Gs, Ww, Ww, Wo, Wo, Ww, Gll, Gll^Es, Gll^Es, Gll^Fmf, Hhd, Hhd^Fmf, Gll^Fmf, Gll^Fmf, Gll^Fmf, Gll^Es, Gll
Gll, Gd^Es, Gs^Es, Re^Vct, Rp, Gs, Ce, 3 Ke, Ce, Gs, Gll, Gll^Fmf, Gll^Fmf, Gll^Fmf, Gll^Em, Gll^Fmf, Gll^Em, Gll^Fmf, Gll^Fmf, Gll^Fmf, Gll, Gll^Fmf, Gll, Gll^Em, Gs, Gll, Gs, Ww, Wo, Ww, Ww, Ww, Gs, Gll, Gll^Fmf, Gll^Fmf, Hhd, Hhd, Hhd^Fmf, Hhd^Fmf, Hhd, Gll, Gll^Es, Gll
Gll^Fmf, Gll^Es, Gs, Gd, Gd, Rp, Rp, Ce, Gs, Ce, Gd^Es, Gll, Gs, Gll, Gd, Gll^Em, Gll, Gll^Es, Gll^Fmf, Gll^Fmf, Gll^Fmf, Gll, Gs, Gll^Es, Gs, Gs, Wwf, Ww, Ww, Wo, Ww, Gd, Gll^Es, Gll^Es, Gll^Fmf, Gll^Fmf, Gll^Fmf, Hhd^Fmf, Hhd^Fmf, Hhd^Fmf, Hhd, Gll^Fmf, Gll^Em, Gll
Gll, Gll^Fmf, Gll^Fmf, Gs, Gd, Gs, Re^Vct, Rp, Rp, Gs, Gd, Re^Vct, Gs^Es, Gd^Es, Gs, Gs, Gll, Gll^Fmf, Gll^Fmf, Gll^Em, Gll^Es, Gll^Fmf, Gs^Vl, Gd, Gs, Ww, Ww, Wwf, Wwf, Ww, Ww, Gs, Gll, Gll^Fmf, Gll^Em, Gll^Fmf, Gll^Fmf, Gll^Fmf, Hhd, Gll^Fmf, Gll, Gll, Gll^Fmf, Gll
Gll^Fmf, Gll^Em, Gll^Fmf, Gll, Gll, Gs, Gd^Es, Gs^Es, Gs, Rp, Gs, Gd^Es, Gs, Gs, Ww, Ww, Ww, Gll^Fmf, Gll, Gll, Gll^Fmf, Gll^Fmf, Ww, Gd, Ww, Ww, Wo, Ww, Wwf, Ww, Gll, Gll, Gll^Fmf, Gll, Gll, Gll^Fmf, Gll, Gll, Gll, Gll^Em, Gll^Fmf, Gll, Gll^Fmf, Gll
Gll^Fmf, Gll^Fmf, Gll^Fmf, Gll^Em, Gll^Fmf, Gs^Es, Gs, Gs, Gs, Rp, Gs, Gd, Ww, Ww, Wo, Wo, Wo, Ww, Ww, Ww, Ww, Ww, Ww, Ww, Wo, Wo, Ww, Ww, Gs, Gll^Fmf, Gll, Gll^Fmf, Gll^Fmf, Gll^Fmf, Gll^Fmf, Gll^Fmf, Gll, Gll^Fmf, Gll^Fmf, Gll, Gll^Fmf, Gll^Fmf, Gll, Gll
Gll, Gll^Em, Gll^Fmf, Gll^Fmf, Gll, Gs, Ww, Ww, Ww, Rp, Ww^Bsb\, Gs, Ww, Wo, Ww, Ww, Ww, Wo, Wo, Wo, Wo, Wo, Wo, Wo, Ww, Ww, Ww, Gs^Vc, Gd, Gll^Fmf, Gll, Gll^Em, Gll^Fmf, Gll^Fmf, Gll^Em, Gll^Fmf, Gll^Em, Gll^Em, Gll^Fmf, Gll^Fmf, Gll^Fmf, Gll, Gll^Es, Gll
Ww, Gll, Gs^Vl, Gll, Ww, Wwf, Wwf, Wo, Wo, Ww, Ww, Ww^Bsb\, Ww^Bsb\, Ww, Gs, Gs^Vc, Gd, Ww, Ww, Ww, Ww, Ww, Ww, Ww, Ww, Ww, Gs, Gd, Gd, Gll^Fmf, Gll^Fmf, Gll^Fmf, Gll^Fmf, Gll^Fmf, Gll, Gll^Fmf, Gll^Fmf, Gll^Fmf, Gll, Gll^Fmf, Gll^Fmf, Gll^Fmf, Gll^Fmf, Gll
Wo, Ww, Ww, Ww, Wo, Wwf, Wwf, Wo, Ww, Ww, Ww, Wo, Ww, Rp, Rp, Gd, Gs, Gd^Es, Gd, Gll^Fp, Gs, Gll^Fp, Gs, Gs, Gd, Gs, Gll^Fp, Gs^Es, Gs, Gs, Gd, Gs, Gd, Gs, Gs, Gll^Fmf, Gs, Gll, Gs, Gll, Gs, Gll^Fmf, Gll, Gll
Wo, Wo, Wo, Wo, Ww, Ww, Gs, Ww, Ss, Ww, Ww, Ww, Ss, Gs, Gs, Rp, Rp, Gs, Rp, Gs, Rp, Gs^Es, Rp, Gd, Gs, Gs, Gll^Fp, Gll^Fp, Gs, Gd, Gd, Gd, Gd^Es, Gs, Gs, Gs, Gd, Gs^Es, Gd, Gs, Gd, Gs, Gs^Es, Gs
Ww, Wo, Ww, Ww, Gs^Es, Gd^Es, Gs^Es, Gs^Vc, Gs, Ss, Wwg, Ss, Ss, Gs, Gd, Gd^Es, Gd, Rp, Gd, Rp, Gs, Rp, Gs, Rp, Gs, Gs^Es, Gd, Gd, Gd, Gs^Es, Gd, Gs^Es, Gd, Gs^Es, Gd, Gd, Gs, Gd, Gs, Gs, Gs, Gd^Es, Gs, Gs^Es
Gs, Ww, Gs, Gs, Gd, Gd, Gd, Gd^Es, Gs, Ss, Wwg, Sm, Ss, Gs, Sm, Gs, Gs, Gd^Es, Gd, Gs, Wwg, Gd^Es, Gs, Rp, Gs, Gd, Wwg, Gs, Gs, Gs, Gs, Gd, Gs, Gd, Gd, Gs^Es, Gs, Gs, Rb^Gvs, Rb^Gvs, Rb^Gvs, Gs, Gs, Gs
Gd, Gs^Es, Gd, Gd, Gs, Gs, Gd, Gs^Es, Gs, Sm, Sm, Wwg, Sm, Sm, Wwg, Wwg, Wwg, Gs, Wwg, Wwg, Ch, Wwg, Wwg, Wwg^Bsb|, Wwg, Wwg, Ch, Wwg, Wwg, Gs, Wwg, Wwg, Wwg, Gd, Gs, Gs, Rb^Gvs, Rb^Gvs, Rb^Gvs, Rb^Gvs, Rb^Gvs, Rb^Gvs, Rb^Gvs, Gs
Hhd, Gd, Hhd, Gs, Hhd, Gs, Hhd, Gs, Gs, Gs, Ss, Wwg, Sm, Wwg, Ch, Ch, Ch, Wwg, Ch, Ch, Gd, Kh, Gs, Rr, Gs, Kh, Gs, Ch, Ch, Wwg, Ch, Ch, Ch, Wwg, Gs, Rb^Gvs, Rb^Gvs, Rb^Gvs, Rb^Gvs, Rb^Gvs, Rb^Gvs, Rb^Gvs, Rb^Gvs, Rb^Gvs
Hhd, Hhd, Hhd^Fmf, Hhd, Hhd, Hhd, Hhd, Hhd, Gd, Gd, Ss, Wwg, Ss, Wwg, Ch, Kh, Rr, Ch, Gs, Gs, Gd, Rr, Gs, Ch, Gs, Rr, Gs, Gs, Gd, Ch, Rr, Kh, Ch, Wwg, Wwg, Wwg, Wwf, Rb^Wm, Rb^Gvs, Rb^Gvs, Rb^Gvs, Rb^Gvs, Rb^Gvs, Rb^Gvs
Hhd^Fmf, Hhd^Fmf, Hhd^Fmf, Hhd^Fmf, Hhd^Fmf, Hhd^Fmf, Hhd, Hhd, Gd, Gs, Sm, Wwg, Sm, Wwg, Ch, Rr, Rr, Gs, Gll^Fmf, Rr^Vhc, Rr, Rr, Ch, Kh, Ch, Rr, Rr, Gll^Fmf, Gd, Rr^Vhc, Rr, Rr, Ch, Wwg, Ss, Ss, Ss, Wwf, Wwg, Rb^Gvs, Rb^Gvs, Rb^Gvs, Rb, Rb
Hhd^Fmf, Hhd^Fmf, Hhd^Fmf, Hhd^Fmf, Hhd^Fmf, Hhd^Fmf, Hhd^Fmf, Hhd, Gs, Gs, Sm, Wwg, Wwg, Wwg, Ch, Gs, Rr, Rr, Rr, Rr, Rr^Vhc, Gs, Gs, Ch, Gs, Gd, Gll^Fmf, Rr, Rr, Rr, Rr, Gll^Fmf, Ch, Wwg, Sm, Sm, Rb, Rb, Sm, Wwf, Wwf, Wwg, Wwg, Wwf
Hhd^Fmf, Hhd^Fmf, Hhd, Hhd^Fmf, Hhd, Hhd^Fmf, Hhd^Fmf, Hhd, Gs, Gd, Gd, Sm, Ss, Wwg, Wwg, Gs, Wwg^Bsb|, Gd, Gll^Fmf, Gll^Fmf, Wwg, Wwg, Wwg, Rr, Wwg, Wwg, Wwg, Gll^Fmf, Gd, Gs, Rr, Gs, Ch, Wwg, Sm, Rb, Ss, Ss, Sm, Sm, Wwf, Wwg, Rb^Gvs, Gs
Hhd, Hhd, Hhd, Hhd, Hhd, Hhd^Fmf, Hhd, Hhd, Hhd, Gs, Gs, Gs, Sm, Wwg, Ch, Wwg, Rr, Wwg, Wwg, Wwg, Ch, Ch, Kh, Wwg^Bsb|, Kh, Ch, Ch, Wwg, Wwg, Rr^Vhc, Rr, Gd, Ch, Wwg, Ss, Ss, Sm, Rb, Wwf, Wwg, Rb^Gvs, Rb^Gvs, Rb^Gvs, Rb^Gvs
Gs, Hhd, Gs, Gs, Gs, Hhd, Hhd, Hhd, Gs, Gd, Gd, Gs^Es, Sm, Wwg, Ch, Gs, Rr, Gll^Fmf, Wwg, Kh, Ch, Kh, Rrc, Rrc, Rrc, Kh, Ch, Kh, Wwg, Gll^Fmf, Rr, Gll^Fmf, Ch, Wwg, Sm, Ss, Wwf, Wwf, Rb^Gvs, Rb^Gvs, Rb^Gvs, Rb^Gvs, Rb^Gvs, Rb^Gvs
Gs, Gs, Gd^Es, Gs, Gd, Gs, Gd, Gs^Es, Gs^Es, Gd, Gs, Gs, Wwg, Wwg, Ch, Rr^Vhc, Rr, Gll^Fmf, Wwg, Ch, Rrc, Rrc, Rrc, Rrc, Rrc, Rrc, Rrc, Ch, Wwg, Gll^Fmf, Rr, Gll^Fmf, Ch, Wwg, Wwg, Wwg, Rb^Wm, Rb^Gvs, Rb^Gvs, Rb^Gvs, Rb^Gvs, Rb^Gvs, Rb^Gvs, Rb^Gvs
Gs, Gd, Gs, Gs, Gs, Gd, Gs, Gs, Gs, Gs, Gs, Gs, Wwg, Kh, Gs, Gd, Rr, Gd, Wwg, Kh, Rrc, Rrc, Ch, Ch, Ch, Rrc, Rrc, Kh, Wwg, Gs, Rr, Gd, Rr, Kh, Wwg, Gs, Gs, Gs^Vc, Rb^Gvs, Rb^Gvs, Rb^Gvs, Rb^Gvs, Rb^Gvs, Rb^Gvs
Rp, Rp, Rp, Rp, Rp, Rp, Rp, Rp, Rp, Rp, Rp, Rp, Wwg^Bsb\, Rr, Rr, Gs, Rr, Rr, Wwg^Bsb\, Rrc, Rrc, Rrc, Ch, 2 Kh, Ch, Rrc, Rrc, Rrc, Wwg^Bsb/, Rr, Rr, Rr, Gd, Rr, Wwg^Bsb\, Gs, Rb, Gs, Rb, Rb^Gvs, Rb^Gvs, Rb^Gvs, Rb^Gvs, Gs^Vc
Gs, Gs, Gd, Gs, Gs^Es, Gs, Gs, Gs, Gs, Gs, Gd, Rp, Wwg, Rr, Gs, Rr, Rr, Gd, Wwg, Kh, Rrc, Rrc, Rrc, Ch, Rrc, Rrc, Rrc, Kh, Wwg, Gs, Rr, Rr, Rr, Rr, Wwg, Rb, Gd, Rb, Gs, Rb, Rb, Rb^Gvs, Rb, Rb
Hhd, Hhd, Hhd, Hhd, Hhd, Gll, Gll^Fmf, Gs, Gs, Gd^Es, Gd, Gd, Wwg, Kh, Ch, Gd, Rr, Gd, Wwg, Ch, Ch, Rrc, Rrc, Rrc, Rrc, Rrc, Ch, Ch, Wwg, Gd, Rr, Gd, Ch, Kh, Wwg, Gs, Gs^Es, Gs, Rb^Gvs, Rb^Gvs, Rb^Gvs, Rb, Gs, Gs
Mm, Mm, Mm, Mm, Mm, Hhd^Fmf, Hhd^Fmf, Hhd^Fmf, Hhd, Gs, Gs, Gd, Gs, Wwg, Ch, Rr^Vhc, Rr, Gs, Wwg, Kh, Ch, Kh, Kh, Rrc, Kh, Kh, Ch, Wwg, Gll^Fmf, Gd, Rr, Gd, Ch, Wwg, Gs, Gs, Rb^Wm, Rb^Gvs, Rb^Gvs, Rb^Gvs, Rb^Gvs, Rb^Gvs, Rb^Gvs, Gs
Mm, Mm, Mm^Xm, Mm, Mm, Hhd^Fmf, Mm, Mm, Mm, Hhd, Hhd^Fmf, Gs, Gs, Wwg, Ch, Gs, Rr, Rr^Vhc, Gs, Wwg, Wwg, Ch, Wwg, Wwg^Bsb|, Wwg, Ch, Wwg, Wwg, Gll^Fmf, Gll^Fmf, Rr, Gs, Ch, Wwg, Gs, Gs, Gs^Es, Rb^Gvs, Rb^Gvs, Rb^Gvs, Rb^Gvs, Rb^Gvs, Gs, Gs
Mm, Mm, Mm^Xm, Mm^Xm, Mm, Mm, Mm, Mm, Mm, Mm, Hhd, Gs, Gs, Wwg, Ch, Gd, Gll^Fmf, Rr, Rr, Gll^Fmf, Gll^Fmf, Wwg, Gll^Fmf, Rr, Gll^Fmf, Wwg, Gd, Gs, Rr, Rr, Gll^Fmf, Gs, Ch, Wwg, Gs, Gd, Gd^Es, Gs, Gs, Gs^Vc, Gs, Gs, Gll^Fmf, Gll
Mm, Mm, Mm, Mm, Mm, Mm, Mm, Mm, Mm, Mm, Hhd, Gd, Gs^Es, Wwg, Ch, Gd, Rr, Rr, Rr^Vhc, Rr, Rr, Gd, Rr, Rr, Rr, Gd, Rr, Rr, Gll^Fmf, Rr, Rr, Gs, Ch, Wwg, Gs, Gs, Gd, Gs, Gs^Es, Gs, Gll^Fmf, Gll^Fmf, Gll, Gg
Hhd^Fmf, Hhd^Fmf, Hhd^Fmf, Hhd^Fmf, Hhd^Fmf, Mm, Mm, Mm^Xm, Mm, Hhd^Fmf, Gll, Gd, Gs, Wwg, Ch, Rr, Rr, Gd, Gd, Gll^Fmf, Gd, Rr, Gs, Rr, Gs, Rr, Gll^Fmf, Rr^Vhc, Gs, Gs, Rr, Rr, Ch, Wwg, Gs, Gs^Es, Gd, Gs, Gs, Gll, Gll^Fmf, Gll, Gll^Fmf, Gll
Gll^Fmf, Gll^Fmf, Gll^Fmf, Gll^Fmf, Gll^Fmf, Hhd^Fmf, Mm, Mm, Mm, Hhd^Fmf, Gll^Fmf, Gll, Gs, Wwg, Ch, Kh, Ch, Ch, Ch, Gs, Gs, Rr, Gs, Rr, Gs, Rr, Gs, Gs, Ch, Ch, Ch, Kh, Ch, Wwg, Gs, Gd^Es, Gs, Gs, Gs, Gll^Fmf, Gll^Fmf, Gll^Fmf, Gll, Gll^Fmf
Gll^Fmf, Gll^Fmf, Gll^Fmf, Gll, Gll^Fmf, Hhd^Fmf, Mm, Mm, Hhd^Fmf, Hhd^Fmf, Gll^Fmf, Gs^Vl, Gs, Wwg, Wwg, Ch, Wwg, Wwg, Wwg, Ch, Ch, Kh, Gs, Rr, Gs, Kh, Ch, Ch, Wwg, Wwg, Wwg, Ch, Wwg, Wwg, Gd, Gd, Gs, Gs, Gll^Es, Gll, Gll^Fmf, Gg^Fet, Gll, Gll
Hhd^Fmf, Hhd^Fmf, Gll^Fmf, Gll, Gll^Fmf, Hhd^Fmf, Hhd^Fmf, Hhd^Fmf, Gll^Fmf, Gll^Fmf, Gll, Gll, Gd^Es, Gs, Gs, Wwg, Gs, Gs, Gs, Wwg, Wwg, Wwg, Wwg, Wwg^Bsb|, Wwg, Wwg, Wwg, Wwg, Gs, Gs, Gs, Wwg, Gs, Gd, Gs, Gs, Gs, Gll, Gll^Fmf, Gll^Fmf, Gll^Em, Gll^Fmf, Gll^Fmf, Gll
Mm, Hhd^Fmf, Hhd^Fmf, Gll^Fmf, Gll^Fmf, Gll^Fmf, Gll^Fmf, Gll^Fmf, Gll, Gll, Gll^Fmf, Gll^Fmf, Gll, Gs, Hhd, Hhd, Hhd, Gd, Hhd, Gs, Gs, Gs, Gs, Rp, Gs, Gs, Gs, Gs, Gd^Es, Gd, Gd, Gs, Gd, Gd, Gll, Gll, Gll^Fmf, Gll^Fmf, Gll^Fmf, Gll^Em, Gll^Fmf, Gll^Fmf, Gll^Fmf, Gll
Mm, Mm, Mm, Hhd^Fmf, Gll^Fmf, Gll^Fmf, Gll^Fmf, Gll^Em, Gll^Em, Gll^Es, Gll, Gll, Gll, Gll, Hhd^Fmf, Mm, Mm, Hhd, Mm, Hhd, Gd, Gd, Gs^Es, Rp, Gs, Gs, Gd, Gs, Gd, Gs, Gs, Gd, Gs^Es, Gs^Es, Gll^Fmf, Gll^Fmf, Hhd, Gll^Fmf, Gg^Fet, Gll, Gll, Gg^Ve, Gll^Fmf, Gll^Fmf
Mm, Mm, Mm, Hhd^Fmf, Hhd^Fmf, Hhd^Fmf, Gll^Fmf, Gll^Em, Gll^Fmf, Gll^Em, Gll^Fmf, Gll, Gll^Fmf, Gll^Fmf, Hhd^Fmf, Mm, Mm, Mm, Mm, Hhd, Hhd, Gd^Es, Gs, Rp, Gs, Gs, Gd, Gs^Es, Gs, Gs, Gs, Gs^Es, Gll^Fmf, Gll^Fmf, Gll^Em, Hhd, Hhd, Gll^Fmf, Gll^Fmf, Gll^Fmf, Gll^Fmf, Gll^Fmf, Gg^Fet, Gll
Mm, Mm, Mm, Mm, Mm, Hhd^Fmf, Gll^Fmf, Gll^Fmf, Hhd^Fmf, Gll^Fmf, Hhd^Fmf, Gll^Fmf, Gll^Fmf, Gll^Fmf, Gll, Hhd, Mm, Mm, Mm, Mm, Mm, Hhd, Gs, Rp, Gs, Gs^Es, Gd, Gs, Gs, Gs^Es, Gll, Gll, Gll^Fmf, Gll, Hhd^Fmf, Hhd^Fmf, Hhd^Fmf, Hhd^Fmf, Hhd, Gll^Em, Gll^Em, Gll^Fmf, Gll^Fmf, Gll
Mm, Mm, Mm, Mm, Mm, Hhd^Fmf, Hhd^Fmf, Hhd^Fmf, Mm, Hhd^Fmf, Mm, Hhd^Fmf, Hhd^Fmf, Gll, Gll, Hhd, Hhd, Mm, Hhd, Mm, Hhd, Hhd, Gs, Rp, Gs, Gs, Gs, Gs^Es, Gs, Gs, Gll, Gll^Fmf, Gg^Fet, Gll^Fmf, Hhd^Fmf, Hhd^Fmf, Hhd^Fmf, Hhd^Fmf, Hhd, Gll, Gll, Gll, Gll^Fmf, Gll
Mm, Mm, Mm, Mm, Mm, Mm, Mm, Mm, Mm, Mm, Mm, Mm, Mm, Hhd^Fmf, Hhd^Fmf, Gll, Gll, Hhd^Fmf, Gll, Hhd, Gs, Gd, Gs, Rp, Gs, Gs^Vc, Gd, Gs^Es, Gs, Gs, Gll^Fmf, Gll^Fmf, Gll^Fmf, Gll^Fmf, Hhd^Fmf, Hhd^Fmf, Gll^Fmf, Gll^Fmf, Gll^Fmf, Re^Vct, Gll^Fmf, Gll^Fmf, Gll^Fmf, Gll
Mm^Xm, Mm, Mm, Mm, Mm, Mm, Mm, Mm, Mm, Mm, Mm, Mm, Mm, Mm, Mm, Hhd^Fmf, Gll^Fmf, Gll^Fmf, Gll, Gs, Gs^Es, Gs^Es, Gs, Rp, Gs, Gd, Gs, Gs^Es, Gs, Gll^Fmf, Hhd, Gll^Fmf, Gll^Fmf, Gll^Em, Hhd, Hhd^Fmf, Gll, Gll^Es, Ce, Gll, Gs, Re^Vct, Gll, Gll^Fmf
Mm^Xm, Mm, Mm, Mm, Mm, Mm, Mm^Xm, Mm^Xm, Mm^Xm, Mm, Mm, Mm, Mm, Mm, Mm, Hhd^Fmf, Gll^Fmf, Gll, Gll, Gs, Gd^Es, Gd, Gs, Rp, Gs, Gd, Gs^Es, Gs, Hhd, Hhd, Hhd^Fmf, Hhd, Hhd, Gll, Gll^Fmf, Gll^Fmf, Gll^Fmf, Ce, Ke, Ce, Ce, Gll, Gll, Gll^Fmf
Mm, Mm^Xm, Mm^Xm, Mm, Mm, Mm, Mm, Mm, Mm^Xm, Mm, Mm, Mm, Mm, Mm, Hhd^Fmf, Hhd^Fmf, Gll^Fmf, Gll, Gs, Gs, Gd, Gs, Gs, Rp, Gs, Gs^Es, Gs, Hhd, Hhd^Fmf, Hhd^Fmf, Hhd^Fmf, Hhd^Fmf, Hhd, Gll^Fmf, Gg^Fet, Gll, Gll^Fmf, Ce, Ce^Kov, 1 Ke, Ce, Gs, Gll^Fmf, Gll^Fmf
Mm, Mm, Mm^Xm, Mm^Xm, Mm, Mm, Mm, Mm, Mm^Xm, Mm, Mm, Mm, Hhd^Fmf, Hhd^Fmf, Gll^Fmf, Gll^Fmf, Gll, Gll, Gs, Gd^Es, Gs^Es, Gs, Gs, Rp, Gs, Gs, Gs, Hhd, Hhd, Hhd, Hhd, Hhd, Gll^Fmf, Gll, Gll^Fmf, Gll^Fmf, Gll, Gll, Gs, Ce, Gll, Gll, Gll, Gll
Mm^Xm, Mm, Mm, Mm^Xm, Mm, Mm, Mm, Mm, Mm^Xm, Mm, Mm, Mm, Mm, Hhd^Fmf, Gll^Fmf, Gll, Gll^Fmf, Gll^Fmf, Gs^Vl, Gs, Gll^Es, Gs, Gs^Es, Rp, Gs, Gd, Gd, Gs, Gs, Gs, Gs, Hhd, Gll^Fmf, Gll^Fmf, Gs, Gs, Gd^Es, Gs, Gs, Gs, Gll^Fmf, Gll^Fmf, Gll, Gll^Em
Mm, Mm, Mm, Mm^Xm, Mm, Mm, Mm, Mm, Mm, Mm^Xm, Mm, Mm, Mm, Hhd^Fmf, Gll^Fmf, Gll, Gll, Gll, Gll, Gll, Gll^Fmf, Gll, Gs^Es, Rp, Rp, Gd, Gs, Gd, Gd^Es, Gs, Gs, Gll^Fmf, Gll, Gll, Gs, Gd, Gs, Re^Vct, Gll^Fmf, Gll^Fmf, Gll, Gg^Fet, Gll^Fmf, Gll
Mm^Xm, Mm^Xm, Mm, Mm^Xm, Mm^Xm, Mm, Mm, Mm, Mm, Mm^Xm, Mm, Mm, Mm, Hhd^Fmf, Hhd^Fmf, Gll^Fmf, Gll^Fmf, Gll^Fmf, Gll^Fmf, Gll^Fmf, Gll^Fmf, Gll, Gll, Gd, Gs, Rp, Gs, Gs^Es, Gs, Gs, Gd, Gs, Gs, Gs, Gs, Gs, Gll^Es, Gll, Hhd^Fmf, Gll, Hhd, Gll, Gg^Ve, Gll
Mm, Mm, Mm, Mm, Mm, Mm, Mm, Mm, Mm, Mm, Mm, Mm, Mm, Hhd^Fmf, Mm, Hhd^Fmf, Hhd^Fmf, Hhd^Fmf, Hhd^Fmf, Hhd^Fmf, Hhd^Fmf, Gll^Fmf, Gll, Gs, Gs, Rp, Rp, Gs, Rp, Gs, Gs, Gs, Gs, Gll, Gll^Fmf, Gll^Fmf, Gg^Fet, Gll^Fmf, Hhd^Fmf, Hhd^Fmf, Hhd^Fmf, Hhd, Gll, Gll^Fmf
Mm, Mm, Mm, Mm^Xm, Mm, Mm, Mm, Mm^Xm, Mm^Xm, Mm, Mm, Mm, Mm, Mm, Mm, Mm, Mm, Mm, Mm, Hhd^Fmf, Hhd^Fmf, Gll^Fmf, Gll^Fmf, Gll, Gs, Gs^Vc, Gs, Rp, Gs, Rp, Rp, Gs, Gs, Gll^Es, Gll, Gll, Gll^Fmf, Hhd^Fmf, Hhd^Fmf, Hhd^Fmf, Hhd^Fmf, Hhd^Fmf, Hhd, Gll^Fmf
Mm^Xm, Mm^Xm, Mm, Mm, Mm^Xm, Mm, Mm, Mm, Mm, Mm, Mm, Mm, Mm, Mm, Mm, Mm^Xm, Mm, Mm, Mm, Mm, Mm, Hhd^Fmf, Gll^Fmf, Gll, Gs, Gd, Gd, Gs, Gs, Gs, Rp, Gs, Gs, Gs, Gs, Gll^Fmf, Gll, Hhd, Gll^Fmf, Hhd^Fmf, Hhd^Fmf, Hhd^Fmf, Hhd, Gll^Fmf
Mm^Xm, Mm, Mm, Mm^Xm, Mm, Mm^Xm, Mm, Mm^Xm, Mm, Mm^Xm, Mm, Mm, Mm, Mm, Mm, Mm, Mm, Mm, Mm, Mm, Mm, Hhd^Fmf, Gll^Fmf, Gll, Gll, Gs, Gd^Es, Gs, Gd, Gs, Rp, Gs, Gd, Gs, Gll^Es, Gll^Fmf, Gll^Fmf, Gll, Gll^Fmf, Hhd, Hhd, Hhd, Gll^Fmf, Gll
Mm, Mm^Xm, Mm, Mm^Xm, Mm^Xm, Mm, Mm, Mm, Mm^Xm, Mm, Mm^Xm, Mm, Mm^Xm, Mm, Mm, Mm, Mm, Mm, Mm, Mm, Mm, Hhd^Fmf, Gll^Fmf, Gll^Fmf, Gll, Gs^Es, Gs, Gd, Gs, Gs, Rp, Gd, Gs^Es, Gs^Es, Gll, Gll^Fmf, Gll, Gll^Fmf, Gll, Gll, Gll, Gll^Fmf, Gll, Gll
Mm, Mm, Mm, Mm, Mm, Mm^Xm, Mm, Mm, Mm, Mm^Xm, Mm, Mm^Xm, Mm, Mm^Xm, Mm, Mm, Mm, Mm, Mm, Mm, Mm, Hhd^Fmf, Gg, Gll^Fmf, Gll, Gs, Gs, Gd, Gs, Gs, Rp, Gd, Gs, Gs, Gll, Gll, Gg, Gll, Gll^Fmf, Gll^Fmf, Gg, Gll, Gll, Gll
