border_size=1
usage=map

Mm^Xm, Mm^Xm, Mm, Mm, Mm^Xm, Mm, Mm, Mm, Mm^Xm, Mm, Mm^Xm, Mm, Mm, Mm, Mm, Mm, Mm^Xm, Mm, Mm, Mm, Mm^Xm, Mm, Mm^Xm, Mm, Mm^Xm, Mm, Mm, Mm, Mm^Xm, Mm, Mm^Xm, Mm^Xm, Mm, Mm, Mm, Mm, Mm, Mm, Mm, Mm, Mm^Xm, Mm^Xm, Mm^Xm, Mm
Mm^Xm, Mm, Mm, Mm^Xm, Mm^Xm, Mm, Mm, Mm, Mm^Xm, Mm, Mm, Mm, Mm, Mm, Mm, Mm, Mm, Mm, Mm, Mm^Xm, Mm, Mm, Mm, Mm, Mm, Mm, Mm, Mm^Xm, Mm, Mm, Mm, Mm, Mm, Mm^Xm, Mm, Mm, Mm^Xm, Mm, Mm^Xm, Mm, Mm, Mm, Mm, Mm^Xm
Mm^Xm, Mm, Mm^Xm, Mm, Mm, Mm, Mm^Xm, Mm^Xm, Mm, Mm, Mm, Mm, Mm, Mm, Mm, Mm, Mm, Mm, Mm, Mm, Mm, Mm, Mm^Xm, Mm, Mm, Mm, Mm, Mm, Mm, Mm, Mm, Mm, Mm, Mm, Mm, Mm, Mm, Mm^Xm, Mm, Mm^Xm, Mm^Xm, Mm, Mm^Xm, Mm^Xm
Mm^Xm, Mm, Mm, Mm, Mm^Xm, Mm^Xm, Mm^Xm, Mm, Mm, Mm, Mm, Mm, Mm, Mm, Wwf, Mm, Hhd^Fmf, Mm, Mm, Mm, Mm, Mm, Mm, Mm, Mm, Mm, Mm, Mm, Mm, Mm, Mm, Mm, Mm, Mm^Xm, Mm, Mm, Mm, Mm, Mm, Mm, Mm^Xm, Mm, Mm, Mm
Mm^Xm, Mm, Mm, Mm^Xm, Mm, Mm, Mm^Xm, Mm, Mm, Mm, Mm, Mm, Mm, Mm, Mm, Wwf, Wwf, Mm, Mm, Mm, Mm, Mm, Mm^Xm, Mm, Mm, Mm, Mm, Mm, Mm, Mm, Mm, Mm, Mm, Mm, Mm, Mm, Mm, Mm, Mm, Mm, Mm, Mm^Xm, Mm, Mm^Xm
Mm^Xm, Mm, Mm^Xm, Mm^Xm, Mm^Xm, Mm^Xm, Mm, Mm, Mm, Mm, Mm, Mm, Mm, Mm, Mm, Hhd^Fmf, Wwf, Hhd^Fmf, Hhd^Fmf, Mm, Mm, Mm^Xm, Mm, Mm, Hhd^Fmf, Wwf, Hhd^Fmf, Mm, Mm, Mm^Xm, Mm^Xm, Mm, Mm, Mm^Xm, Mm, Mm, Mm, Mm, Mm, Mm, Mm^Xm, Mm^Xm, Mm^Xm, Mm^Xm
Mm^Xm, Mm^Xm, Mm, Mm, Mm, Mm, Mm, Mm, Mm, Mm, Mm, Mm, Mm, Mm, Mm, Mm, Ww, Ww, Hh^Vhh, Hhd^Fmf, Hhd^Fmf, Mm, Hhd^Fmf, Hhd^Fmf, Gll^Fmf, Wwf, Wwf, Mm, Mm, Mm, Mm, Mm^Xm, Mm, Mm, Mm, Mm, Mm, Mm^Xm, Mm, Mm^Xm, Mm^Xm, Mm, Mm, Mm
Mm^Xm, Mm^Xm, Mm, Mm, Mm, Mm, Mm, Mm, Mm, Mm, Mm, Mm, Mm, Mm, Mm, Hhd^Fmf, Ww, Ww, Mm, Hhd^Fmf, Hhd^Fmf, Hhd^Fmf, Mm, Hhd^Fmf, Hhd^Fmf, Gll^Fmf, Wwf, Hhd^Fmf, Mm, Mm, Mm, Mm, Mm, Mm, Mm, Mm, Mm, Mm, Mm, Mm, Mm, Mm^Xm, Mm^Xm, Mm
Mm, Mm, Mm, Mm, Mm, Mm, Mm, Mm, Mm, Mm, Hhd, Mm, Hhd^Fmf, Hhd^Fmf, Wwf, Ww, Mm, Mm, Mm, Mm, Mm, Mm, Mm, Mm, Mm, Hhd^Fmf, Ww, Hhd^Fmf, Hhd^Fmf, Mm, Mm, Mm, Co, Co, Co, Mm, Mm, Mm, Mm, Mm, Mm, Mm^Xm, Mm, Mm^Xm
Mm, Mm, Mm, Mm, Mm, Mm, Mm, Mm, Hhd^Fmf, Hhd^Fmf, Gs^Es, Hh^Vhh, Ww, Wwf, Mm, Mm, Mm, Mm, Mm, Mm, Mm, Mm, Mm, Mm, Mm, Hhd^Fmf, Ww, Hhd^Fmf, Mm, Mm, Mm, Mm, Co, 3 Ko, Co, Mm, Mm, Mm, Mm, Mm, Mm, Mm, Mm, Mm
Mm, Mm, Mm, Mm, Mm, Mm^Xm, Mm, Hhd, Gll, Gll^Em, Ww, Ww, Mm, Mm, Mm, Mm, Mm, Mm, Mm, Mm, Mm, Mm, Mm, Mm, Mm, Hhd^Fmf, Wwf, Mm, Mm, Mm, Mm, Mm, Mm, Co, Mm, Mm, Mm, Mm, Mm, Mm, Mm, Mm, Mm, Mm
Mm, Mm, Wwf, Mm, Mm, Mm, Hhd^Fmf, Hhd^Fmf, Gs^Es, Ww, Mm, Mm, Mm, Ko, Mm, Mm, Mm, Mm, Hhd^Fmf, Hhd^Fmf, Hhd^Fmf, Mm, Mm, Mm, Hhd, Wwf, Hhd^Fmf, Mm, Mm, Mm, Mm, Mm, Mm, Mm, Mm, Mm, Mm, Mm, Wwf, Mm, Mm, Mm, Mm, Mm
Mm, Mm, Mm, Wwf, Mm, Mm, Hhd^Fmf, Gll^Fmf, Gd, Ww, Mm, Ko, Co, Co, Co, Ko, Mm, Mm, Hh^Vhh, Gll^Fmf, Gll, Hhd^Fmf, Hhd^Fmf, Hhd, Ww, Wwf, Gs, Hhd, Hhd, Hhd^Fmf, Hh^Vhh, Hhd, Hhd, Mm, Mm, Mm, Hhd^Fmf, Hhd^Fmf, Gll^Fmf, Wwf, Hhd^Fmf, Mm, Mm, Mm
Mm, Mm, Mm, Wwf, Wwf, Mm, Hhd^Fmf, Gll^Fmf, Gs, Ww, Wwf, Mm, Co, 2 Ko, Co, Mm, Hhd^Fmf, Hhd, Ww, Ww, Ww, Ww, Wwf, Ww, Gs, Gd, Gs^Es, Gs, Gd, Gs, Gs, Gll, Gll, Hhd^Fmf, Mm, Hhd^Fmf, Gll^Fmf, Gll^Fmf, Wwf, Wwf, Hhd^Fmf, Mm, Mm, Mm
Mm, Mm, Mm, Mm, Ww, Hhd^Fmf, Gd, Gll^Es, Gll^Em, Gll, Ww, Co, Gll^Fmf, Co, Ww, Co, Ww, Ww, Hhd, Gll^Fmf, Hhd^Fmf, Gll^Fmf, Hhd^Fmf, Gll, Hhd, Gs, Gs, Gs^Vc, Gs, Gs, Wwf, Gs^Es, Gs, Hhd^Fmf, Hhd^Fmf, Hhd^Fmf, Gll^Fmf, Gll^Fmf, Ww, Gll^Fmf, Hhd^Fmf, Mm, Mm, Mm
Mm, Mm, Mm, Mm, Hhd^Fmf, Wwf, Wwf, Gs, Gll^Fmf, Gll^Fmf, Ww, Ww^Bw|, Ww, Ww, Gs, Ww, Hhd^Fmf, Hhd, Mm, Hhd^Fmf, Mm, Hhd^Fmf, Mm, Hhd^Fmf, Mm^Xm, Hhd, Hhd^Fmf, Gs, Gs, Wwf, Gs^Vc, Wwf, Ww, Gs, Gs, Gll, Wwf, Ww, Hhd^Fmf, Hhd^Fmf, Mm, Mm, Mm, Mm
Hhd^Fmf, Hhd^Fmf, Hhd^Fmf, Hhd^Fmf, Gll^Fmf, Gs^Vc, Gs, Ww, Wwf, Ww, Ww, Ww, Gll^Fmf, Gs, Gs^Vc, Hhd^Fmf, Mm, Mm, Mm, Mm, Mm, Mm, Mm, Mm, Mm, Mm, Hhd, Gs^Es, Wwf, Ww, Gll, Gd, Gs, Ww, Ww, Wwf, Gll^Fmf, Hhd^Fmf, Mm, Mm, Mm, Mm, Mm, Mm
Gll^Fmf, Gll^Fmf, Gll^Fmf, Gll^Fmf, Gll^Es, Gll, Gll^Fmf, Gll, Gs^Es, Gll^Fmf, Gll^Fmf, Ww, Gs, Gll^Es, Gd, Hhd, Mm, Mm, Mm, Mm, Mm, Mm, Hhd, Mm, Hhd^Fmf, Hhd^Fmf, Gd, Gs, Wwf, Gll^Fmf, Hhd^Fmf, Gll^Fmf, Hhd^Fmf, Gs, Gll, Gll^Fmf, Hhd^Fmf, Hhd^Fmf, Mm, Mm, Mm, Mm, Mm, Mm
Gll, Gll, Gll, Gll, Gll, Gll^Fmf, Hhd^Fmf, Gll^Fmf, Hhd^Fmf, Gll, Gll, Ww, Ww, Gs, Gs, Hhd, Hhd^Fmf, Mm, Hhd, Hhd^Fmf, Hhd^Fmf, Hhd, Gll, Hhd, Gs, Gs, Ww, Wwf, Gll, Hhd, Mm, Hhd^Fmf, Hhd^Fmf, Gll, Gs^Es, Hh^Vhh, Mm, Mm, Mm, Mm, Mm, Mm, Mm, Mm
Gll^Fmf, Gll, Gll^Fmf, Gll^Fmf, Hhd^Fmf, Hhd^Fmf, Mm, Hhd^Fmf, Mm, Hhd^Fmf, Hhd^Fmf, Gs, Gd, Ww, Ww, Gs^Es, Gd, Hhd, Gs, Gll, Gs, Gd, Ww, Gs^Es, Wwf, Wwf, Gs, Gs, Gll^Fmf, Hhd, Mm, Mm, Hhd^Fmf, Gll^Fmf, Gd, Hhd^Fmf, Mm, Mm, Mm, Mm, Mm, Mm, Mm, Mm
Hhd^Fmf, Gll^Fmf, Hhd^Fmf, Hhd^Fmf, Mm, Mm, Mm, Mm, Mm, Mm, Hhd, Gs, Gd, Gs^Es, Ww, Ce, Ket, Ce, Gs, Gs^Efm, Ww, Ww, Hhd^Fmf, Wwf, Gll^Fmf, Gs, Gd^Es, Gs, Gll^Fmf, Hhd^Fmf, Hhd^Fmf, Mm, Mm, Hhd^Fmf, Gs^Es, Hhd^Fmf, Hhd^Fmf, Mm, Mm, Mm, Mm, Mm, Mm, Mm
Mm, Hhd^Fmf, Mm, Mm, Mm, Mm, Mm, Mm, Mm, Mm, Mm, Hhd, Hhd^Fmf, Gs, Ww, Ww^Bw|, Ww^Bw|, Ww^Bw|, Ww, Ww, Hhd, Hhd^Fmf, Mm^Xm, Hhd^Fmf, Hhd^Fmf, Gll^Fmf, Gs, Gs, Gll^Efm, Gll^Fmf, Hhd^Fmf, Mm, Hhd, Hhd, Gll, Gll^Fmf, Gll^Fmf, Hhd^Fmf, Hhd^Fmf, Hhd^Fmf, Hhd^Fmf, Hhd^Fmf, Hhd^Fmf, Mm
Mm, Mm, Mm, Mm, Mm, Mm, Mm, Mm, Mm, Mm, Mm, Mm, Mm, Hhd^Fmf, Wwf, Ww, Ww, Ww, Hhd^Fmf, Hhd, Mm, Mm, Mm, Mm, Hhd, Gll^Es, Gs, Re^Vct, Gs^Efm, Gll, Hhd^Fmf, Mm, Hh^Vhh, Gll, Gs, Gll^Fmf, Gll^Fmf, Gll^Fmf, Gll^Fmf, Gll^Fmf, Gll^Fmf, Gll^Fmf, Gll^Fmf, Hhd^Fmf
Mm, Mm, Mm, Mm, Mm, Mm, Mm, Mm, Mm, Mm, Mm, Mm, Mm, Hhd, Gs, Ww, Ww, Gll^Fmf, Hhd^Fmf, Mm, Mm, Mm, Mm, Mm, Hhd, Gll, Gs, Gs, Gs, Gll^Fmf, Gs, Hhd^Fmf, Gll, Gs^Efm, Gll^Fmf, Gll^Fmf, Hhd^Fmf, Hhd^Fmf, Hhd^Fmf, Hhd^Fmf, Hhd^Fmf, Gll^Fmf, Gll^Fmf, Gll^Fmf
Mm, Mm, Mm, Mm, Mm, Mm, Mm, Mm, Mm, Mm, Hhd^Fmf, Hhd^Fmf, Hhd^Fmf, Hh^Vhh, Gd, Ww, Ww, Gll^Fmf, Gll^Fmf, Hhd^Fmf, Mm, Mm, Mm, Mm, Hhd^Fmf, Gll^Fmf, Ce, Ce, Ce, Gd, Gs, Gs, Gll^Fmf, Gll^Efm, Hhd^Fmf, Hhd^Fmf, Mm, Mm, Mm, Mm, Mm, Hhd^Fmf, Hhd^Fmf, Hhd^Fmf
Mm, Mm, Mm, Mm, Mm, Mm, Hhd^Fmf, Mm, Hhd^Fmf, Hhd^Fmf, Gll^Fmf, Gll^Fmf, Gll^Fmf, Gll^Es, Gd, Ww, Ww, Gs^Efm, Gs, Hhd^Fmf, Mm, Mm, Mm, Hhd^Fmf, Gll^Fmf, Gll^Fmf, Ke, 1 Ke, Ke, Gs, Hhd^Fmf, Gll^Fmf, Hhd^Fmf, Hhd^Fmf, Mm, Mm, Mm, Mm, Mm, Mm, Mm, Mm, Mm, Mm
Mm, Mm, Mm, Mm, Mm, Mm, Hhd^Fmf, Hhd^Fmf, Gll^Fmf, Gll^Fmf, Gll^Fmf, Gll, Gll, Gll, Gs^Efm, Ww, Ww, Gs, Gs, Hhd^Fmf, Hhd^Fmf, Hhd^Fmf, Hhd^Fmf, Hhd^Fmf, Gs, Ce, Ce, Ce^Kov, Ce, Hhd^Fmf, Mm, Hhd^Fmf, Mm, Mm, Mm, Mm, Mm, Mm, Mm, Mm, Mm, Mm, Mm, Mm
Mm, Mm, Mm, Mm, Mm, Mm, Mm, Hhd^Fmf, Gll^Fmf, Gs^Vl, Gll^Fmf, Gll^Es, Gll, Gll^Fmf, Gs^Efm, Ww, Ww, Gs^Vc, Gs^Efm, Gll^Fmf, Gll, Gll^Fmf, Gll, Gll^Fmf, Re^Vct, Gd^Efm, Gs, Ce, Ce, Hhd, Mm, Mm, Mm, Mm, Mm, Mm, Hhd^Fmf, Hhd^Fmf, Hhd^Fmf, Mm, Hhd^Fmf, Hhd^Fmf, Hhd^Fmf, Hhd^Fmf
Mm, Mm, Mm, Mm, Mm, Mm, Mm, Hhd^Fmf, Hhd^Fmf, Gll^Fmf, Gll^Fmf, Gll^Fmf, Gll^Fmf, Gll^Fmf, Gs, Ww, Ww, Ww, Gs, Gs, Gs, Gs, Gs^Es, Gs, Gs, Gd^Efm, Gll^Fmf, Gs, Gll, Hhd, Hhd^Fmf, Hhd^Fmf, Hhd^Fmf, Hhd^Fmf, Hhd^Fmf, Hhd^Fmf, Gll^Fmf, Gll^Fmf, Gll^Em, Hhd^Fmf, Gll, Gll^Fmf, Gll^Fmf, Gll^Fmf
Mm, Mm, Mm, Mm, Mm, Mm, Mm, Hh^Vhh, Mm, Hhd^Fmf, Hhd^Fmf, Gll^Fmf, Hhd^Fmf, Gll^Em, Gs, Gd, Ww, Ww, Ww, Gs^Efm, Gs^Efm, Gd, Gs, Gs^Es, Gs, Gll^Fmf, Hhd^Fmf, Gll, Hhd, Gll, Gll, Gll, Gll^Fmf, Gll^Em, Gll^Fmf, Gll^Fmf, Gll^Fmf, Gll^Fmf, Gll^Fmf, Gll^Fmf, Gll^Fmf, Gll^Fmf, Hhd^Fmf, Hhd^Fmf
Mm, Mm, Mm, Mm, Mm, Mm, Mm, Mm, Mm, Mm, Mm, Hhd^Fmf, Mm, Hhd^Fmf, Hhd, Gd, Gs^Es, Ww, Ww, Ww, Ww, Gs, Gs, Gll^Fmf, Hhd^Fmf, Hhd^Fmf, Mm, Hhd, Mm, Hhd, Hhd^Fmf, Gll, Gll, Gll^Fmf, Gll, Gll, Gll, Gll^Em, Hhd^Fmf, Gll, Hhd^Fmf, Hhd^Fmf, Mm, Mm
Mm, Mm, Mm, Mm, Mm, Mm, Mm, Mm, Mm, Mm, Mm, Mm, Mm, Mm, Hh^Vhh, Gll, Gll, Gd, Gs, Ww, Ww, Ww, Ww, Gll^Fmf, Hhd^Fmf, Mm, Mm, Mm, Mm, Mm, Hhd^Fmf, Gll^Fmf, Gll, Gll, Gll, Gll, Hhd, Hhd^Fmf, Mm, Hhd^Fmf, Mm, Mm, Mm, Mm
Mm, Mm, Mm, Mm, Mm, Mm, Cud, Mm, Mm, Mm, Mm, Mm, Mm, Mm, Mm, Hhd^Fmf, Gll^Fmf, Gll^Fmf, Gll^Fmf, Gs, Gs^Es, Ww, Ww, Ww, Hhd^Fmf, Mm, Mm, Mm, Mm, Mm, Hhd^Fmf, Gll^Fmf, Gll, Gll^Fmf, Gll, Hhd, Mm, Mm, Mm, Mm, Mm, Mm, Mm, Mm
Mm, Mm, Mm, Mm, Mm, Cud, 4 Kud, Cud, Mm, Mm, Mm, Mm, Mm, Mm, Mm, Hhd^Fmf, Hhd^Fmf, Hhd^Fmf, Hhd^Fmf, Gll, Gll^Fmf, Ww, Ww, Ww, Gll^Fmf, Hhd^Fmf, Hhd^Fmf, Mm, Mm, Mm, Hhd^Fmf, Gll^Em, Gll^Fmf, Gll^Fmf, Hhd^Fmf, Hhd, Mm, Mm, Mm, Mm, Mm, Mm, Mm, Mm
Mm, Mm, Mm, Mm, Mm, Cud, Cud, Cud, Mm, Mm, Mm, Mm, Mm, Mm, Mm, Mm, Mm, Mm, Mm, Hhd^Fmf, Gll, Ww, Ww, Ww, Gll^Fmf, Gll^Fmf, Hhd, Mm, Hhd^Fmf, Hhd^Fmf, Gll^Fmf, Gll, Hhd^Fmf, Hhd^Fmf, Mm, Mm, Mm, Mm, Mm, Mm, Mm, Mm, Mm, Mm
Mm, Mm, Mm, Mm, Mm, Mm, Mm, Mm, Mm, Mm, Mm, Mm, Mm, Mm, Mm, Mm, Mm, Mm, Mm, Hhd, Gll^Em, Ww, Ww, Ww, Ww, Gll^Fmf, Gll, Hhd^Fmf, Gll^Em, Gs^Vl, Gll^Fmf, Gll, Hhd^Fmf, Mm, Mm, Mm, Mm, Mm, Mm, Mm, Mm, Mm, Mm, Mm
Mm, Mm, Mm, Mm, Mm, Mm, Mm, Mm, Mm, Mm, Mm, Mm, Mm, Mm, Mm, Mm, Mm, Mm, Mm, Hhd^Fmf, Gll^Fmf, Ww, Ww, Ww, Ww, Gll^Es, Gll, Gll^Fmf, Gll^Fmf, Gll^Fmf, Hhd^Fmf, Hhd^Fmf, Mm, Mm, Mm, Mm, Mm, Mm, Mm, Mm, Mm, Mm, Mm, Mm
Mm, Mm, Mm, Mm, Mm, Mm, Mm, Mm, Mm, Mm, Mm, Mm, Mm, Mm, Mm, Mm, Mm, Mm, Hhd^Fmf, Hhd^Fmf, Gll^Fmf, Ww, Ww, Ww, Ww, Ww, Gll^Fmf, Gll, Gll, Gll, Hhd^Fmf, Mm, Mm, Mm, Mm, Mm, Mm, Mm, Mm, Mm, Mm, Mm, Mm, Mm
Mm, Mm, Mm, Mm, Mm, Mm, Mm, Mm, Mm, Mm, Mm, Mm, Mm, Mm, Mm, Mm, Mm, Mm, Mm, Hhd^Fmf, Gg, Ww, Ww, Ww, Ww, Ww, Ww, Gll^Fmf, Hhd^Fmf, Hhd^Fmf, Mm, Mm, Mm, Mm, Mm, Mm, Mm, Mm, Mm, Mm, Mm, Mm, Mm, Mm
