border_size=1
usage=map

Aa, Tyb, Aa, Tyb, Aa, Tyb, Aa, Tyb, Aa^Vaa, Tyb, Tyb, Tyb, Aa, Aa, Rb, Rb, Gs, Gs, Aa, Gs, Aa^Fma, Gs, Gs, Gll^Fmf, Gs, Gs, Aa^Fma, Gll, Gll^Fmf, Gll, Gll, Gll^Fmf, Aa^Fma, Gll, Gll, Gg^Fet, Gll^Fmf, Gll, Gll, Gll, Gll^Fmf, Gs, Gll^Fmf, Gll, Gll^Fmf, Gll
Tyb, Tyb, Aa, Aa^Es, Ce, Aa, Ce, Tyb, Tyb^Es, Tyb, Gd, Aa, Gd^Es, Aa, Rb, Gs, Gs, Gd, Gd, Gs, Gs^Es, Aa, Gll, Gll^Fmf, Gll, Gll, Gll^Fmf, Gll^Fmf, Gll, Gll, Gll, Gll, Gll, Gll^Es, Gll^Fmf, Gg^Fet, Aa^Fma, Gll^Em, Gll, Gg^Fet, Gll, Aa^Fma, Gll, Gll, Gg^Fet, Gll
Aa, Aa, Tyb, Ce, 4 Ke, Ce, Tyb, Tyb, Aa, Tyb, Gd, Gd, Aa, Aa, Rb, Rb, Aa, Gs, Gll, Gs, Gs, Gd, Gs, Gll, Gll, Gll^Fmf, Gll^Fmf, Gll^Fmf, Ha^Fma, Aa^Fma, Aa^Fma, Gll^Fmf, Gll^Fmf, Gll^Es, Gll^Fmf, Gll, Gll, Gll, Gll^Fmf, Gll, Gll^Fmf, Gll^Es, Gll^Fmf, Gll^Fmf, Gll, Gll^Fmf
Aa, Aa, Ce, Ce, Ce, Ce, Gd, Gd, Tyb, Aa, Aa^Vaa, Aa, Gd, Gd, Aa, Rb, Aa, Gd, Aa^Fma, Gll^Fmf, Aa, Gs, Gd, Gll^Fmf, Gll, Aa^Fma, Ha^Fma, Hhd^Fmf, Ha^Fma, Hhd^Fmf, Ha^Fma, Aa, Aa^Fma, Gll^Fmf, Gg^Fet, Gll^Em, Gll, Gll^Fmf, Gg^Fet, Gll, Gll, Gll, Gll^Em, Gll^Fmf, Gll^Fmf, Gll
Aa, Tyb^Es, Gd, Tyb, Aa, Ce, Tyb, Tyb, Gd, Gd, Rb, Gd, Rb, Gd, Gs, Gs, Gd, Gd, Aa^Fma, Aa, Aa, Gd, Gs, Gg^Ve, Gll, Aa^Fma, Ha^Fma, Hhd^Fmf, Hhd^Fmf, Hhd^Fmf, Ha^Fma, Aa^Fma, Gll^Fmf, Aa^Fma, Gll, Gll^Fmf, Gll^Fmf, Gll, Aa, Gll^Fmf, Gll^Fmf, Gll, Gll^Fmf, Gll, Gll^Fmf, Gll
Tyb, Tyb, Gd, Gd, Tyb, Gd, Rb, Gd, Rb, Aa, Rb, Gd, Aa, Aa, Gd, Gs, Aa^Es, Gs, Gs, Aa, Gs, Aa^Fma, Gs, Gll, Gs, Aa^Fma, Gll^Fmf, Ha^Fma, Ha^Fma, Hhd^Fmf, Hhd^Fmf, Hhd^Fmf, Gll^Em, Gll^Fmf, Gll, Aa, Aa^Fma, Gll^Fmf, Gll^Fmf, Aa^Fma, Gll^Fmf, Gll^Fmf, Gg^Fet, Gll, Gll^Fmf, Gll^Fmf
Aa, Aa, Aa, Aa, Gd, Aa, Aa, Aa, Aa, Aa, Gs, Gs, Aa, Gd, Gd, Aa, Gs, Gs, Gs, Gll^Fmf, Gg^Fet, Gd, Gs, Gll^Fmf, Gll, Gll, Gll^Fmf, Aa^Fma, Gll^Fmf, Aa^Fma, Gll^Fmf, Gll^Fmf, Gll^Fmf, Gg^Fet, Gll, Aa^Es, Aa^Fma, Gg^Fet, Gll^Fdf, Aa^Fma, Aa, Gll, Gll^Fmf, Gll, Gll^Fmf, Gll^Fmf
Aa^Es, Aa^Vaa, Rb, Rb, Aa, Rb, Gd, Rb, Aa, Aa^Es, Gd, Gd, Gs, Aa, Aa, Gs, Gs, Gd, Gs, Aa, Gg^Fet, Gs, Gs, Gs, Gll, Gll^Fmf, Gll, Gll, Gll^Fmf, Aa^Fma, Gll, Gll, Gll^Em, Gll, Gll^Fmf, Gll^Fmf, Gll, Gll^Fmf, Aa, Aa^Fma, Gll^Fmf, Gll^Fmf, Gll, Gll, Aa^Fma, Gll
Rb, Aa, Aa, Aa, Gs, Gd, Gs^Es, Aa^Vaa, Gd, Gd, Gs, Gs, Aa, Aa, Aa^Fma, Gs, Gs, Gll^Fmf, Gll, Gs^Es, Gll, Gll, Gll^Em, Gll^Fmf, Gg^Fet, Gll, Aa^Fma, Gg^Fet, Gll, Aa^Fma, Gll, Gg^Ve, Gll^Fmf, Gll^Fmf, Gll^Fmf, Gll, Aa^Fma, Gll^Fmf, Gll, Gll^Fmf, Gll, Gll^Fmf, Aa^Fma, Gll^Fmf, Aa^Fma, Gll
Aa, Rb, Rb, Rb, Gd, Gd, Aa, Gs, Gs, Gs, Aa, Gs, Gd, Aa, Gll^Fmf, Gs, Gs, Gll, Gll^Fmf, Gll^Fmf, Gll^Fmf, Gll^Fmf, Gll, Aa^Fma, Gll^Fmf, Gll^Em, Aa, Gll^Fmf, Gll, Aa^Fma, Gll^Fmf, Gll, Gll^Fmf, Gll^Fmf, Aa^Fma, Gll^Fmf, Gll^Fmf, Gll^Fmf, Gll, Gll, Aa^Fma, Gll^Fmf, Aa^Fma, Aa, Gll, Gll
Aa, Gs, Gd, Gs, Gd, Gs, Aa, Gs, Gd, Aa, Gs, Gd, Gs^Es, Gs, Gll, Gll^Fmf, Aa, Aa^Fma, Aa, Aa^Fma, Aa, Gll^Fmf, Gll, Aa, Gll^Fmf, Gll, Aa^Fma, Gll^Em, Gll^Fmf, Gll, Aa^Fma, Gg^Fet, Gll, Gll^Fmf, Gll, Aa, Aa, Aa^Fma, Aa^Fma, Gll, Aa^Fma, Aa^Fma, Gll^Fmf, Gll^Fmf, Gg^Fet, Gll
Gll^Fmf, Gs, Gs, Gs, Aa, Gd, Gs, Gs, Gs, Aa, Gs, Gg^Ve, Gll^Fmf, Aa, Gs, Gll^Fmf, Gll, Gll^Fmf, Gll, Aa, Aa^Fma, Gll^Fmf, Aa, Aa^Fma, Aa^Fma, Aa, Aa, Gll, Gll^Fmf, Gll^Fmf, Gll^Fmf, Gll^Fmf, Gll^Fmf, Gll, Aa^Fma, Aa^Fma, Gll^Fmf, Gll^Fdf, Gll^Fmf, Gll, Aa^Fma, Gll^Fmf, Gll^Fmf, Gll^Fmf, Gll, Gll
Gs, Gll^Fmf, Gs^Es, Aa, Gs, Aa, Gd, Gll^Fmf, Gd, Gd, Aa, Gll, Aa, Aa, Gs, Gs, Gs, Gll, Gll^Fmf, Gll, Gll, Aa, Aa^Fma, Gll, Gll^Fmf, Gg^Ve, Aa^Fma, Gll^Fmf, Gll^Fmf, Gll, Gll^Es, Gll, Gll, Gll, Gll, Gll^Fmf, Gll^Fmf, Gll, Gll^Fmf, Gll^Fmf, Gll^Fdf, Gll^Fmf, Gll, Aa, Aa^Fma, Gll
Gs, Aa, Gd, Gd, Gs, Gd, Gg^Fet, Gll, Gs, Gs, Aa, Gs, Gll, Gs, Gll, Gs, Gll, Gll, Gll^Fmf, Gll^Fmf, Aa^Fma, Aa, Gll, Gll^Fmf, Gll, Gll, Gll, Gll, Gll, Gll, Aa^Fma, Gll^Fmf, Gll, Gll^Fmf, Gll^Fmf, Gll, Gll^Fmf, Re^Vct, Gg^Fet, Aa^Fma, Aa, Aa^Fma, Gll^Fmf, Aa, Gll^Em, Gll
Gs, Gs, Gs, Gs, Aa, Gs, Gll^Fmf, Gll^Fmf, Gs, Gs, Gll^Fmf, Gll^Fmf, Gll, Gll^Fmf, Gll^Fmf, Gll^Fmf, Gll^Fmf, Gll^Fmf, Aa^Fma, Aa^Fma, Aa, Gg^Fet, Gg^Fet, Gll, Aa^Fma, Gll^Fmf, Gg^Fet, Gll^Es, Aa, Aa, Aa^Fma, Gll, Gll, Gg^Fet, Gll^Fmf, Aa^Fma, Ha^Fma, Aa^Fma, Aa^Fma, Aa^Fma, Gll^Fmf, Gll^Fdf, Gll^Fmf, Gll^Fdf, Gll, Gll
Gd, Gd, Gd, Aa, Gs, Aa, Gs, Gd, Gs, Gll, Aa, Gll^Fmf, Aa, Gll^Fmf, Gll, Gg^Fet, Gll, Aa^Fma, Gll, Gll, Gll^Fmf, Aa, Aa^Fma, Aa^Fma, Aa^Fma, Gll, Gll, Aa^Fma, Gll, Gg^Ve, Aa, Gll, Gll^Fmf, Gll^Fmf, Gll, Hhd^Fmf, Hhd^Fmf, Ha^Fma, Hhd^Fmf, Aa, Gll^Fmf, Gll^Fdf, Gll^Fdf, Gll, Aa^Fma, Aa^Fma
Gll^Fmf, Gd, Gs, Aa, Aa, Gs, Aa, Gs, Aa, Gll, Gll^Fmf, Aa, Aa^Fma, Gll^Fmf, Gll^Fmf, Gll^Fmf, Gg^Fet, Gll, Gll, Gll^Fmf, Gll^Fmf, Gll^Fmf, Aa^Fma, Aa^Fma, Gll^Fmf, Gd, Gs^Em, Gd, Gll^Fmf, Aa, Gll^Fmf, Gll^Fmf, Aa^Fma, Gll, Gll, Hhd^Fmf, Ha^Fma, Ha^Fma, Ha^Fma, Gll^Fmf, Gll, Gg^Fet, Aa^Fma, Aa^Fma, Gll^Fmf, Aa^Fma
Gll^Fmf, Gd, Gs^Es, Gs, Gll^Fmf, Gs, Gll, Gll, Gll^Fmf, Gll^Fmf, Gll^Fmf, Gg^Fet, Ha^Fma, Ha^Fma, Hhd^Fmf, Gll^Fmf, Gll^Fmf, Gll^Fmf, Gll^Fmf, Aa^Fma, Gll, Aa^Fma, Gll, Gll^Fmf, Gll, Gll, Gll^Em, Gll^Em, Aa^Fma, Aa, Aa^Fma, Aa^Fma, Aa^Fma, Gll, Gll, Aa^Fma, Gll^Fmf, Hhd^Fmf, Ha^Fma, Gll^Fmf, Aa, Aa, Gll^Fmf, Gll, Gg^Fet, Gll
Gll, Gs, Gll, Gll^Fmf, Gg^Ve, Gll^Fmf, Gll^Fmf, Gll^Fmf, Aa^Fma, Aa^Fma, Hhd^Fmf, Hhd^Fmf, Mm, Mm, Mm, Hhd^Fmf, Aa^Fma, Gg^Fet, Gll^Fmf, Gll, Gd, Gll^Es, Gll, Gll^Fmf, Gll^Fmf, Aa^Fma, Gll^Fmf, Gll^Fmf, Aa^Fma, Gll^Fmf, Gg^Fet, Aa^Fma, Gll^Fmf, Gg^Fet, Gll^Fmf, Aa^Fma, Gll^Fmf, Hhd^Fmf, Aa^Fma, Aa^Fma, Aa^Fma, Gll^Fmf, Gg^Fet, Gll, Gll, Gll^Fmf
Gll^Fmf, Gll, Gll^Fmf, Gll, Aa^Fma, Gll^Fmf, Aa^Fma, Aa, Aa^Fma, Gll^Fmf, Hhd^Fmf, Mm, Mm, Mm, Mm, Ha^Fma, Aa^Fma, Gll^Fmf, Gll, Gll, Aa^Fma, Gg^Ve, Gll^Fmf, Gll^Fmf, Gll, Gll^Fmf, Aa, Aa^Fma, Gll^Fmf, Aa, Gll, Gll, Gll, Gll, Gll, Gll, Gll, Gll^Fmf, Aa^Fma, Gg^Fet, Aa, Aa, Gll, Gll^Es, Gll^Fmf, Gll
Gll^Fmf, Gll^Fmf, Gll^Fmf, Gll, Gll, Gg^Fet, Gg^Fet, Gll^Em, Gll^Fmf, Hhd^Fmf, Mm, Mm, Mm, Mm, Mm, Ha^Fma, Ha^Fma, Gll^Es, Gll^Fmf, Gg^Fet, Gll^Fmf, Gll^Es, Gll, Gll^Fmf, Aa, Gll^Em, Gll^Fmf, Aa^Fma, Gg^Fet, Gll, Gll, Gs, Gd, Gll^Fmf, Gll^Fmf, Gll, Aa^Fma, Gll^Fmf, Aa^Fma, Aa, Gll^Em, Aa^Fma, Aa^Fma, Aa, Gll^Fmf, Gll
Aa^Fma, Aa, Aa, Aa^Fma, Gll^Em, Gll, Gll^Fmf, Gll^Fmf, Aa^Fma, Ha^Fma, Mm, Mm, Mm, Mm, Mm, Mm, Hhd^Fmf, Gll^Fmf, Aa^Fma, Gll, Gg^Fet, Gll^Fmf, Gll^Fmf, Aa^Fma, Aa^Fma, Aa^Fma, Aa^Fma, Aa^Fma, Aa, Gll^Fmf, Gg^Ve, Gd, Aa, Gll, Gll^Fmf, Gll^Fmf, Gll, Aa, Gll^Fmf, Gll^Fmf, Gll^Fmf, Gll^Fmf, Gll^Fmf, Aa^Fma, Gll^Fmf, Gll
Gll^Fmf, Gll^Fmf, Gll^Fmf, Gll^Fmf, Aa^Fma, Gg^Fet, Gg^Fet, Aa, Aa^Fma, Ha^Fma, Ha^Fma, Mm, Mm, Mm, Mm, Mm, Mm, Ha^Fma, Aa^Fma, Aa^Fma, Gll^Fmf, Gll^Em, Gll^Fmf, Aa^Fma, Aa^Fma, Gll^Fmf, Gll^Fmf, Gll^Fmf, Aa^Fma, Gg^Fet, Gll^Fmf, Gll^Fmf, Aa^Fma, Gll^Fmf, Gll^Fmf, Gll, Gll^Fmf, Gll, Gll^Fmf, Aa^Fma, Aa, Gll^Fmf, Gg^Fet, Aa, Gll^Fmf, Gll
Gll^Fmf, Gll, Aa^Fma, Aa^Fma, Aa^Fma, Gll^Fmf, Gll^Fmf, Aa^Fma, Aa^Fma, Aa^Fma, Aa, Hhd^Fmf, Mm, Mm, Mm, Mm, Mm, Ha^Fma, Gll^Fmf, Gll^Fmf, Gll^Fmf, Aa^Fma, Gll^Fmf, Kv, Aa^Fma, Aa, Gll, Aa, Gll^Fmf, Gll, Aa, Aa, Gll, Gll^Fmf, Gll^Fmf, Gll, Gll^Fmf, Gg^Ve, Gll^Fmf, Aa^Fma, Gll^Fmf, Aa^Fma, Gll^Fmf, Gll^Fmf, Gll^Fmf, Gll^Fmf
Aa^Fma, Gll^Fmf, Aa, Gg^Ve, Aa, Gll^Fmf, Gll, Gll^Fmf, Aa, Gll^Fmf, Aa^Fma, Ha^Fma, Hhd^Fmf, Mm, Mm, Mm, Hhd^Fmf, Hhd^Fmf, Gll^Fmf, Gg^Fet, Aa^Fma, Kv, Cv, Cv, Cv, Kv, Gll^Fmf, Aa^Fma, Gll, Gll^Fmf, Aa^Fma, Aa, Gll^Es, Gll^Es, Gll^Fmf, Gll, Gll, Gg^Fet, Gg^Fet, Gll, Gll^Fmf, Aa, Aa^Fma, Gll^Em, Gll, Gll
Aa^Fma, Gll^Fmf, Gll^Fmf, Gll^Fmf, Aa^Fma, Gll^Fmf, Gll^Es, Gll^Fmf, Aa^Fma, Gll^Em, Gll^Fmf, Hhd^Fmf, Mm, Mm, Mm, Hhd^Fmf, Gll^Fmf, Gg^Fet, Aa, Gll^Fmf, Aa^Fma, Gll^Fmf, Cv, 2 Kv, Cv, Aa^Fma, Aa, Gll^Fmf, Aa^Fma, Aa^Fma, Gll^Fmf, Gll, Gll^Fmf, Gll, Gll^Fmf, Aa^Fma, Gg^Fet, Gll^Fmf, Gg^Fet, Gll^Fmf, Gll^Fmf, Gll^Em, Aa, Gll, Gll^Fmf, Gg^Fet
Gll^Fmf, Gll^Fmf, Aa^Fma, Gll^Fmf, Gll^Fmf, Aa^Fma, Gg^Fet, Gg^Fet, Aa^Fma, Gll^Fmf, Gll, Hhd^Fmf, Hhd^Fmf, Mm, Hhd^Fmf, Ha^Fma, Aa^Fma, Gll, Aa^Fma, Aa^Fma, Aa^Fma, Kv, Gll, Cv, Gll^Fmf, Kv, Aa^Fma, Gll^Fmf, Aa^Fma, Gll^Fmf, Gll, Gg^Fet, Gll, Gll^Fmf, Aa^Fma, Aa, Gll^Fmf, Gll^Fmf, Gll^Fmf, Aa^Fma, Gll, Gll, Gll^Fmf, Aa, Gll, Gll^Fmf
Gll^Fmf, Gll^Fmf, Aa^Fma, Gll^Fmf, Aa, Gg^Fet, Aa^Fma, Gll^Fmf, Gll^Fmf, Aa^Fma, Gll^Fmf, Gll, Gll^Fmf, Hhd^Fmf, Gll^Fmf, Aa^Fma, Gll^Fmf, Aa, Gll^Fmf, Aa^Fma, Gll^Fmf, Gll, Gll, Kv, Gll^Fmf, Gll^Fmf, Gll, Aa, Gll, Gg^Fet, Gll, Gll^Es, Aa^Fma, Aa, Gll^Fmf, Gll^Fmf, Aa^Fma, Aa^Fma, Aa, Aa^Fma, Gll, Gll^Fmf, Gll^Es, Aa^Fma, Gll^Fmf, Gll^Fmf
Gll^Fmf, Gll, Aa, Aa^Fma, Gg^Fet, Gg^Fet, Aa^Fma, Gll^Fmf, Gg^Ve, Gll^Fmf, Gll, Gll, Aa^Fma, Gll^Fmf, Gll^Fmf, Aa, Aa^Fma, Gll^Fmf, Gg^Fet, Gll^Fmf, Gg^Fet, Gll^Fmf, Gll, Aa^Fma, Gll, Gll^Fmf, Gll^Fmf, Gll^Fmf, Gll^Fmf, Gg^Ve, Gll^Fmf, Gll, Aa^Fma, Gll^Fmf, Gll^Fmf, Aa^Fma, Aa, Aa, Gll^Es, Gll, Gll^Fmf, Gll, Gll, Gll, Gll^Fmf, Gll
Gll^Fmf, Gll, Gll^Es, Aa^Fma, Gll^Fmf, Gll^Em, Aa^Fma, Gll^Em, Aa, Aa, Aa^Fma, Aa^Fma, Gll^Fmf, Gll^Em, Gll^Fmf, Gll^Fmf, Gg^Ve, Gll^Fmf, Gll, Gll^Fmf, Gll^Fmf, Gll^Fmf, Aa^Fma, Gll^Es, Gg^Fet, Gll^Fmf, Aa^Fma, Aa^Fma, Aa, Gll^Fmf, Gll, Aa, Gll^Fmf, Aa, Gll, Aa^Fma, Aa^Fma, Gll, Gll^Fmf, Gg^Fet, Gll^Fmf, Gll, Gll^Fmf, Gg^Fet, Aa, Gll
Gll^Fmf, Gll^Fmf, Gll^Fmf, Aa^Fma, Gll^Fmf, Aa, Gll^Fmf, Gll^Fmf, Aa^Fma, Aa^Fma, Gll^Fmf, Aa^Fma, Gll^Fmf, Gll^Fmf, Gll, Gll^Fmf, Gll, Gll, Gll^Fmf, Gll^Fmf, Gll^Fmf, Aa^Fma, Gll^Fmf, Gg^Fet, Gll, Aa^Fma, Gll, Aa, Aa^Fma, Gll, Gll^Fmf, Gll, Gll^Fmf, Gll^Fmf, Gll^Fmf, Gll^Fmf, Gll^Fmf, Gll^Fmf, Gll^Fmf, Gll^Fmf, Aa^Fma, Aa, Gll^Fmf, Gll^Fmf, Aa^Fma, Aa
Gll^Fmf, Gll^Fmf, Gll^Fmf, Gll^Fmf, Gll^Fmf, Gll^Fmf, Gll^Fmf, Aa^Fma, Gll^Fmf, Gg^Fet, Gll^Fmf, Aa, Gll^Fmf, Gll^Em, Gll^Fmf, Aa, Gll^Fmf, Gll^Fmf, Gll^Fmf, Aa, Gll^Fmf, Gg^Ve, Aa^Fma, Gll, Gll^Fmf, Gll, Gll^Fmf, Gll, Gll^Fmf, Gll^Fmf, Gll, Gll, Gll, Gll^Fmf, Aa^Fma, Gll^Fmf, Hhd^Fmf, Ha^Fma, Ha^Fma, Gll^Fmf, Aa^Fma, Gll^Fmf, Gll, Gll^Fmf, Gll^Fmf, Gll^Fmf
Aa^Fma, Aa, Gll, Aa^Fma, Aa^Fma, Aa^Fma, Gg^Fet, Gll^Fmf, Gll^Fmf, Gll^Fmf, Aa^Fma, Gll^Fmf, Gll^Fmf, Gll, Aa, Aa^Fma, Gll^Fmf, Aa^Fma, Gg^Fet, Gll^Fmf, Gll^Fmf, Aa, Gll^Fmf, Gll^Fmf, Gll, Gll, Aa^Fma, Gll, Gll, Gll, Gll, Gll^Fmf, Aa^Fma, Aa^Fma, Gll^Fmf, Hhd^Fmf, Mm, Mm, Mm, Ha^Fma, Aa^Fma, Aa^Fma, Aa, Aa, Gll^Em, Gll
Gll, Gll^Fmf, Gll^Fmf, Aa, Gll, Gll^Es, Aa^Fma, Gll^Fmf, Gll^Es, Gg^Fet, Gll^Es, Aa^Fma, Aa^Fma, Gg^Fet, Gll^Fmf, Gll^Fmf, Gll, Aa, Gll^Fmf, Aa, Aa^Fma, Gll^Fmf, Gll^Fmf, Gll^Fmf, Gll, Gll^Fmf, Aa^Fma, Gll^Fmf, Gll^Fmf, Gll^Fmf, Gll^Fdf, Gll^Fdf, Aa, Aa^Fma, Hhd^Fmf, Ha^Fma, Mm, Mm, Ha^Fma, Ha^Fma, Gll, Gll^Fmf, Gll, Gll^Em, Gll, Gll^Fmf
Gll, Gll^Em, Gg^Fet, Gll^Fmf, Gll^Fmf, Gll^Fmf, Aa^Fma, Aa^Fma, Aa^Fma, Gll^Fmf, Aa, Aa^Fma, Aa^Fma, Gll, Gll^Fmf, Gll^Fmf, Gll^Fmf, Gll^Es, Gll, Aa^Fma, Gll^Fmf, Aa^Fma, Aa^Fma, Gll^Fmf, Gll^Fmf, Gll^Fmf, Aa^Fma, Aa, Ha^Fma, Aa^Fma, Hhd^Fmf, Gll^Fmf, Ha^Fma, Hhd^Fmf, Mm, Mm, Mm, Mm, Hhd^Fmf, Gll, Gll^Fmf, Gll^Fmf, Aa, Gg^Fet, Gll^Fmf, Gll
Gll^Fmf, Gll^Fmf, Aa^Fma, Gll, Gll^Fmf, Gll^Fmf, Gll^Fmf, Aa, Gll, Aa^Fma, Aa, Aa, Gll, Gll, Aa, Aa^Fma, Gll^Fmf, Gll, Gg^Fet, Gll^Fmf, Gll^Fmf, Gll^Fmf, Gll^Fmf, Aa^Fma, Gll, Gll^Fmf, Hhd^Fmf, Ha^Fma, Mm, Ha^Fma, Mm, Ha^Fma, Mm, Mm, Mm, Mm, Mm, Hhd^Fmf, Gll^Fmf, Gll^Fmf, Gll, Gg^Ve, Gll, Aa, Gll^Fmf, Gll^Fmf
Gll^Fmf, Gll^Fmf, Aa, Aa^Fma, Gll^Fmf, Gg^Ve, Gll, Gll^Em, Gll^Fmf, Gll^Fmf, Aa^Fma, Gll^Fmf, Gg^Ve, Gll^Es, Gll, Aa, Gll^Fmf, Gll, Gll^Fmf, Gll, Gll, Gll^Fmf, Gll^Em, Gll, Gll^Fmf, Gll^Fmf, Hhd^Fmf, Mm, Mm, Mm, Mm, Mm, Mm, Mm, Mm, Mm, Hhd^Fmf, Hhd^Fmf, Gg^Fet, Gll, Aa^Fma, Gll^Em, Aa^Fma, Aa^Fma, Aa^Fma, Gll
Aa^Fma, Gll, Gll^Es, Gll^Fmf, Gll, Gll^Fmf, Gll^Em, Gll, Aa^Fma, Gll^Fmf, Gll^Em, Gll^Fmf, Gll, Gll, Gll^Fmf, Gll^Fmf, Gg^Fet, Gll^Fmf, Gll, Gg^Fet, Gll, Gll, Gll, Gll, Gg^Ve, Gll^Fmf, Ha^Fma, Mm, Ha^Fma, Mm, Mm, Mm, Mm, Mm, Mm, Mm, Ha^Fma, Gll^Fmf, Gll^Fmf, Gll^Fmf, Aa, Aa, Gd, Gll^Fmf, Gll^Fmf, Gll
Gll^Fmf, Gll^Fmf, Gll^Fmf, Gll^Fmf, Gll^Fmf, Aa^Fma, Gll, Gll^Fmf, Aa, Aa^Fma, Gll^Fmf, Gll, Gll, Gll^Fmf, Gll^Fmf, Gll, Gll^Fmf, Gll, Gll^Fmf, Gll, Aa, Aa, Aa^Fma, Aa, Gll^Fmf, Gll^Fmf, Gll^Fmf, Ha^Fma, Gll^Fmf, Ha^Fma, Hhd^Fmf, Mm, Hhd^Fmf, Mm, Hhd^Fmf, Ha^Fma, Aa^Fma, Aa, Gll^Fmf, Aa^Fma, Gll^Fmf, Gd, Gg^Fet, Gll, Gll^Fmf, Gll
Gll, Gll^Fmf, Gll, Gll^Fmf, Aa^Fma, Gll^Fmf, Gll^Fmf, Gll^Fmf, Gll^Fmf, Gll^Fmf, Gll, Gll, Gll^Fmf, Aa^Fma, Aa, Gll, Gll^Fmf, Gll, Gll, Gll^Fmf, Aa^Fma, Aa^Fma, Gll^Fmf, Gll^Fmf, Gll^Fmf, Gll, Gll^Fmf, Aa, Aa^Fma, Aa^Fma, Gg^Ve, Hhd^Fmf, Aa, Ha^Fma, Aa, Aa, Aa, Gll^Fmf, Gll, Gll, Gg^Fet, Gll^Es, Gll, Gll^Fmf, Aa, Gll
Gll^Fmf, Gll^Fmf, Aa, Aa, Gll^Fmf, Gg^Fet, Gg^Fet, Aa^Fma, Aa^Fma, Gll, Gll^Fmf, Gll^Fmf, Gg^Fet, Gll^Fmf, Aa, Gll^Fmf, Gll, Gll^Es, Gll^Fmf, Gll^Fmf, Aa^Fma, Aa, Gll^Es, Gg^Fet, Gll, Gll^Em, Gll^Em, Gll, Aa^Fma, Gll^Fmf, Gll^Fmf, Gg^Fet, Aa, Aa^Fma, Gll^Fmf, Gll^Fmf, Aa^Fma, Aa, Gd^Fetd, Gll^Em, Gll^Fmf, Gll, Gll, Gll^Fmf, Aa^Fma, Aa^Fma
Aa^Fma, Gll^Fmf, Aa^Fma, Aa, Gll, Gll^Fmf, Gll^Fmf, Aa, Aa^Fma, Gll, Gll^Fmf, Gll^Fmf, Gll, Gll^Fmf, Gll, Gll, Gll^Fmf, Gll, Gll^Fmf, Aa^Fma, Aa^Fma, Gll^Fmf, Gll^Fmf, Gll, Gll^Fmf, Gll^Fmf, Gll, Gll^Fmf, Gll^Fmf, Gll^Fmf, Gll, Gll^Fmf, Aa^Fma, Gll^Fmf, Gg^Fet, Gll, Gll, Gd^Fetd, Gll^Ecf, Re^Vct, Gll^Em, Gll, Gd^Fetd, Gll, Gll, Gll^Fmf
Aa^Fma, Aa, Gll^Em, Gll^Fmf, Aa, Gll^Fmf, Gll, Gll^Es, Aa, Gll, Gll, Gll^Em, Re^Vct, Gll, Gll^Fmf, Gll^Fmf, Gll^Fmf, Gll^Em, Gll^Em, Gll^Fmf, Gll^Fmf, Gll^Fmf, Gll^Fmf, Gll, Gll^Fmf, Gll^Fmf, Aa^Fma, Gll^Fmf, Aa, Gll, Gll^Em, Gll^Fmf, Aa^Fma, Gll^Fmf, Gll^Fmf, Gll^Fmf, Gll^Fmf, Gll^Ecf, Gd^Fetd, Gll^Fmf, Gll, Gll^Ecf, Gll^Ecf, Gd^Fetd, Gll^Fmf, Gll
Gll^Fmf, Gll^Es, Gll^Fmf, Gll^Fmf, Aa^Fma, Gll^Em, Ce, Gll, Ce, Ce, Aa, Gs, Gd, Aa, Gll, Gll^Fmf, Gll^Fmf, Gll^Em, Aa^Fma, Gll^Fmf, Gg^Ve, Aa^Fma, Gll, Gll^Fmf, Aa^Fma, Aa, Gll^Fmf, Aa^Fma, Gll^Fmf, Aa^Fma, Gll^Em, Gg^Fet, Aa^Fma, Gll, Gll, Re^Vct, Aa^Fma, Gd^Fetd, Gll^Fmf, Aa, Ce, Gd^Fetd, Gll, Re^Vct, Gll^Fmf, Gll
Gll^Fmf, Gll^Fmf, Gll, Aa^Fma, Gll, Gll, Gll, Ke, 1 Ke, Ce, Ce, Gll^Es, Gll, Aa, Gll, Gll^Es, Gll^Fmf, Gll^Fmf, Gg^Fet, Aa, Aa^Fma, Aa, Aa^Fma, Gll^Es, Gll^Fmf, Gll^Fmf, Gll^Fmf, Aa, Gll^Fmf, Aa, Gll, Gll^Fmf, Gg^Ve, Gll^Fmf, Gll^Ecf, Gll, Gd^Fetd, Gll^Fmf, Ce, Aa^Fma, Ce, Aa^Fma, Ce, Gll^Fmf, Gll^Fmf, Gll
Gll, Gll^Fmf, Gll, Aa, Re^Vct, Gd, Gll^Fmf, Ce^Kov, Ke, Ce, Gll, Gll^Fmf, Gll^Fmf, Gll, Gll^Fmf, Gll^Fmf, Gll, Gll^Fmf, Gll^Fmf, Gll^Es, Gll, Aa, Aa, Aa^Fma, Gg^Fet, Gll^Em, Gll^Es, Gll^Fmf, Gll^Fmf, Aa^Fma, Gll^Fmf, Gll^Fmf, Gll^Fmf, Gll^Fmf, Gll^Fmf, Gll, Gll^Fmf, Gll^Em, Gll^Fmf, Ce, 3 Ke, Ce, Gg^Fet, Gll^Fmf, Gll^Fmf, Gll
Aa^Fma, Gll^Es, Gll, Aa^Fma, Aa^Fma, Gll, Gll, Gll, Ce, Gs, Gs^Es, Gll, Gll^Fmf, Gll^Fmf, Gg^Fet, Gll^Em, Aa^Fma, Aa^Fma, Gll^Fmf, Gg^Fet, Gll, Aa^Fma, Gll^Em, Gll^Fmf, Gll, Gll, Aa, Gll, Gll, Gll, Aa^Fma, Gll^Fmf, Gg^Fet, Gll^Fmf, Gll, Gll, Aa, Gll^Em, Ce, Ce, Ce, Ce, Ce, Gll^Fmf, Gll, Gll
Aa^Fma, Gll, Gll, Gll^Fmf, Gll, Gll, Gll^Fmf, Gll, Gll, Gll, Gs, Re^Vct, Gll, Gll^Fmf, Aa, Gll^Fmf, Aa^Fma, Gll^Fmf, Aa^Fma, Gll^Fmf, Gll^Em, Gll^Fmf, Gll^Fmf, Gll^Fmf, Aa^Fma, Aa^Fma, Gll^Fmf, Aa^Fma, Gll^Es, Gll^Fmf, Gll^Fmf, Gll, Gll, Gll^Fmf, Gd^Fetd, Aa^Fma, Re^Vct, Aa^Fma, Aa^Fma, Gll^Fmf, Ce, Gll^Fmf, Gll^Fmf, Aa^Fma, Gll, Gll^Fmf
Gll^Fmf, Gs^Es, Gd, Gll, Gs^Es, Gll, Aa^Fma, Gll, Re^Vct, Gs, Gll, Gll, Gll, Gll^Fmf, Aa^Fma, Aa^Fma, Gll, Aa, Gll^Fmf, Gll, Gll, Gll, Aa^Fma, Aa^Fma, Gll^Em, Gll^Fmf, Gll^Fmf, Aa^Fma, Gll^Fmf, Gll^Fmf, Gll^Fmf, Aa^Fma, Gll, Gll^Em, Gll^Ecf, Gd^Fetd, Gll, Gll^Fmf, Gll^Fmf, Aa^Fma, Gll^Fmf, Aa^Fma, Gll^Fmf, Gll, Aa^Fma, Gll
Aa^Fma, Gg^Fet, Gg^Fet, Gs, Gd^Es, Gll, Aa, Aa^Fma, Gg^Fet, Gll^Es, Gll, Gll^Fmf, Gll, Aa, Aa, Gll^Es, Gll^Fmf, Gg^Fet, Gll, Gll^Fmf, Gll, Aa^Fma, Aa, Aa, Gll^Fmf, Gll^Fmf, Gll, Aa^Fma, Gll, Gll^Fmf, Gll^Fmf, Gll^Fmf, Gll, Gd^Es, Gll^Es, Gll^Ecf, Gd^Fetd, Gll^Fmf, Gll^Fmf, Gll, Gll^Fmf, Gll^Fmf, Aa^Fma, Gll, Aa^Fma, Gll
Aa^Fma, Aa^Fma, Gll^Fmf, Gs, Gs, Gd, Aa^Fma, Aa^Fma, Gll^Fmf, Gll^Fmf, Gll, Gll, Gll, Aa^Fma, Aa^Fma, Gll, Gll, Gll^Es, Gll, Gll^Fmf, Gll, Aa^Fma, Gll, Gll, Gll, Gll, Gll, Gll^Fmf, Aa^Fma, Gll^Fmf, Gs, Gll^Fmf, Gll^Fmf, Gll^Em, Gll, Gd^Fetd, Gll^Fmf, Gll^Fmf, Gll, Gll, Gll, Gll^Fmf, Aa^Fma, Gll^Fmf, Aa^Fma, Gll
