Wwrg, Wog, Wog, Wog, Wog, Wwg, Wwg, Wwg, Wwg, Wog, Wwg, Aa^Qhh, Aa^Qhh, Aa^Qhh, Tyb^Qhh, Tyb^Qhh, Hhd^Qhh, Mm^Qhh, Ms^Qhh, Ms, Mm, Mm, Ms, Mm, Ms, Hhd^Qhh, Hhd^Qhh, Gll, Gll, Gll^Fmf, Aa^Fma, Gll^Fmf, Gs, Tyb, Tyb, Gs, Aa, Aa, Tyb, Gs, Aa, Ha, Ha, Hhd, Hhd, Hhd, Ha, Aa, Gd, Tyb, Gs, Gs, Aa, Gs, Tyb, Gd, Gs, Gs, Gll, Gll^Fmf, Gll^Fmf, Gll^Fmf, Aa^Fma, Aa^Fma, Aa^Fma, Aa^Fma, Aa^Fma
Wog, Wog, Wog, Wwg, Wog, Wwg, Wwg, Wwg, Wwg, Wwg, Wwg, Wwg, Wwg, Ds^Qhh, Aa^Qhh, Tyb^Qhh, Tyb^Qhh, Hhd^Qhh, Ha^Qhh, Mm^Qhh, Mm^Qhh, Mm, Ms, Ms, Ms, Mm^Qhh, Ha^Qhh, Gll^Fmf, Aa, Aa, Aa^Fma, Aa^Fma, Gll^Fmf, Gll, Gs, Tyb, Gs, Tyb, Tyb, Gs, Gd, Aa, Ha, Hhd, Hhd, Ha, Aa, Aa, Tyb, Tyb, Aa, Gs, Tyb, Aa, Gd, Aa, Aa, Gs, Gll^Fmf, Gll, Aa^Fma, Aa^Fma, Gll^Fmf, Gll, Gll, Aa, Aa
Wog, Wwrg, Wog, Wog, Wog, Wwrg, Wog, Wog, Wog, Wwg, Wwg, Wwg, Wwg, Wwg, Aa^Qhh, Aa^Qhh, Aa^Qhh, Aa^Qhh, Aa^Qhh, Ha^Qhh, Ha^Qhh, Ms^Qhh, Mm, Ms, Ms, Ms^Qhh, Ha^Qhh, Aa^Fma, Gll, Aa, Aa, Gll^Fmf, Gll, Gll, Gs, Gs, Tyb, Gd, Tyb, Tyb, Gs, Aa, Ha, Hhd, Ha, Ha, Aa, Tyb, Gs, Gd, Gd, Gd, Gs, Tyb, Tyb, Gs, Tyb, Gs, Gll, Gll, Aa^Fma, Aa, Aa^Fma, Gll, Gll, Aa^Fma, Aa^Fma
Wog, Wog, Wog, Wog, Wog, Wog, Wog, Wog, Wog, Wog, Wwg, Wwg, Wwg, Wwg, Wwg, Ds^Qhh, Gs^Qhh, Gs^Qhh, Gd^Qhh, Tyb^Qhh, Ha^Qhh, Ha^Qhh, Mm^Qhh, Mm, Mm, Ms^Qhh, Ha^Qhh, Aa, Gll^Fmf, Aa^Fma, Aa, Gs, Gll^Fmf, Gs, Aa, Tyb, Aa, Tyb, Tyb, Aa, Aa, Aa, Gs, Ha, Ha, Tyb, Gs, Tyb, Tyb, Aa, Tyb, Tyb, Gs, Gd, Gd, Tyb, Gs, Tyb, Gs, Gll^Fmf, Aa^Fma, Gll^Fmf, Gll^Fmf, Aa^Fma, Aa^Fma, Gll^Fmf, Gll^Fmf
Wog, Wog, Wog, Wog, Wog, Wog, Wwg, Wwrg, Wwrg, Wog, Wog, Wwg, Wwg, Wwg, Wwg, Ds^Qhh, Ds^Qhh, Gs^Qhh, Aa^Qhh, Aa^Qhh, Aa^Qhh, Hhd^Qhh, Hhd^Qhh, Mm^Qhh, Ms^Qhh, Hhd^Qhh, Aa^Qhh, Aa^Fma, Aa, Aa^Fma, Aa, Aa^Fma, Gll^Fmf, Gll, Aa, Aa, Aa^Fma, Aa^Fma, Gs, Tyb, Aa, Aa, Gs, Aa, Aa, Aa, Tyb, Tyb, Gs, Tyb, Gd, Ce, Gs, Re^Vct, Gd, Aa, Gs, Tyb, Aa, Gll, Aa^Fma, Gll, Gs^Vl, Gll, Aa^Fma, Aa^Fma, Gll
Wog, Wog, Wog, Wog, Wog, Wog, Wog, Wog, Wog, Wwg, Wwg, Wog, Wwg, Wwg, Wwg, Wwg, Wwg, Ds^Qhh, Wwg, Ds^Qhh, Ds^Qhh, Gs^Qhh, Gs^Qhh, Hhd^Qhh, Ha^Qhh, Ha^Qhh, Tyb^Qhh, Aa^Fma, Tyb, Tyb, Aa^Fma, Aa^Fma, Gs, Gll, Gs, Gs, Gll^Fmf, Gll, Gs, Gs, Aa^Fma, Aa, Tyb, Aa, Gs, Tyb, Tyb, Gs, Aa, Aa, Ce, Ce, Ce, Gs, Aa, Re^Vct, Aa, Tyb, Tyb, Aa, Aa^Fma, Gll, Gll, Gll^Fmf, Aa^Fma, Gll, Gll^Fmf
Wog, Wog, Wog, Wog, Wog, Wog, Wog, Wog, Wwg, Wwrg, Wwrg, Wog, Wog, Wwg, Wwg, Wwg, Wwg, Wwg, Wwg, Wwg, Wwg, Ds^Qhh, Gs^Qhh, Tyb^Qhh, Tyb^Qhh, Aa^Qhh, Tyb^Qhh, Gll^Fmf, Gs, Aa^Fma, Aa, Gs, Aa, Gs, Aa^Fma, Gll, Aa^Fma, Gll^Fmf, Gll^Fmf, Aa^Fma, Aa^Fma, Aa, Tyb, Aa, Tyb, Gs, Aa, Gs, Gd, Aa, Ke, 1 Ke, Ke, Aa, Gs, Aa, Ha, Gd, Gd, Aa, Gll^Fmf, Gll^Fmf, Aa^Fma, Aa^Fma, Aa^Fma, Gll^Fmf, Aa^Fma
Wog, Wog, Wog, Wog, Wog, Wog, Wog, Wog, Wog, Wog, Wog, Wwrg, Wog, Wog, Wwrg, Wog, Wog, Wwg, Wwg, Wwg, Wwg, Ds^Qhh, Ds^Qhh, Gd^Qhh, Gs^Qhh, Aa^Qhh, Aa^Qhh, Tyb^Qhh, Gs^Qhh, Tyb, Tyb, Aa, Gs, Aa, Aa^Fma, Gll^Fmf, Aa, Aa, Aa^Fma, Aa^Fma, Gll^Fmf, Gs, Gs, Tyb, Gd, Gs, Gs, Gs, Gs, Ce, Gd, Ce^Kov, Gd, Ce, Aa, Ha, Hhd, Hhd, Gs, Gs, Tyb, Gll, Aa, Aa, Aa^Fma, Aa^Fma, Aa
Wog, Wog, Wog, Wog, Wog, Wog, Wwg, Wog, Wog, Wog, Wog, Wog, Wwrg, Wog, Wwg, Wwg, Wwg, Wog, Wog, Wwg, Wwg, Wwg, Wwg, Ds^Qhh, Aa^Qhh, Aa^Qhh, Aa^Qhh, Gs^Qhh, Aa^Qhh, Gs, Gs, Gs, Gs, Gs, Gll^Fmf, Aa^Fma, Aa^Fma, Aa^Fma, Aa, Aa^Fma, Gll^Fmf, Gll, Gs, Aa, Re^Vct, Aa, Aa, Tyb, Tyb, Aa, Gd, Ce, Gs, Gd, Aa, Ha, Ha, Hhd, Gs, Gs, Tyb, Aa, Gs^Vc, Aa, Aa, Aa, Gll^Fmf
Wog, Wog, Wog, Wog, Wog, Wog, Wog, Wog, Wog, Wog, Wog, Wog, Wwg, Wog, Wog, Wog, Wwrg, Wog, Wog, Wog, Wwg, Wwg, Wwg, Wwg, Ds^Qhh, Gs^Qhh, Tyb^Qhh, Tyb^Qhh, Tyb^Qhh, Gs, Gs, Gd, Aa, Gll, Tyb, Aa, Aa^Fma, Aa^Fma, Aa, Aa, Gs, Gll, Tyb, Aa, Aa, Gs, Aa, Tyb, Tyb, Gs, Gd, Gs, Gd^Fetd, Tyb, Aa, Aa, Ha, Ha, Aa, Tyb, Aa, Gs, Tyb, Gd, Gd, Gs, Gs
Wog, Wog, Wog, Wog, Wog, Wwg, Wog, Wog, Wog, Wog, Wog, Wwg, Wog, Wwg, Wog, Wog, Wog, Wwrg, Wwrg, Wog, Wwg, Wwg, Wwg, Ds^Qhh, Gs^Qhh, Tyb^Qhh, Gs^Qhh, Aa^Qhh, Aa^Qhh, Tyb, Aa, Tyb, Tyb, Gs, Gs, Tyb, Gll^Fmf, Aa^Fma, Gs, Aa^Fma, Aa, Tyb, Aa, Gs, Gs, Tyb, Tyb, Gs, Gs, Aa, Aa, Re^Vct, Gs, Tyb, Tyb, Gs, Gs, Aa, Tyb, Aa, Gd, Gs, Gs, Tyb, Gs, Gs, Gs
Wog, Wog, Wog, Wog, Wwg, Wog, Wog, Wog, Wog, Wog, Wwg, Wog, Wog, Wog, Wog, Wog, Wog, Wog, Wwg, Wog, Wwg, Wwg, Wwg, Ds^Qhh, Ds^Qhh, Gd^Qhh, Gd^Qhh, Gs^Qhh, Gs^Qhh, Gd, Gs, Aa, Aa, Gs, Gd, Gs, Gll, Gll^Fmf, Gll, Gs, Tyb, Aa, Tyb, Aa, Gs, Gs, Gd^Fetd, Gs, Gs, Gs, Gs, Aa, Gs, Aa, Gs, Gs, Tyb, Tyb, Aa, Aa, Gll^Fmf, Gs, Aa, Aa^Fma, Aa, Tyb, Wwg
Wog, Wog, Wog, Wog, Wwg, Wog, Wog, Wog, Wog, Wog, Wwg, Wog, Wog, Wog, Wog, Wog, Wog, Wwg, Wwrg, Wwg, Wwg, Wwg, Wwg, Wwg, Ds^Qhh, Ds^Qhh, Ds^Qhh, Gs^Qhh, Gs, Gs, Ds, Gs, Ds, Gs, Gs, Tyb, Gs, Gll, Tyb, Gs, Gs, Tyb, Gs, Gs, Gs, Gs, Ha, Gs, Hhd, Gs, Gs, Gd, Gs, Gs, Wwg, Gs, Gs, Aa, Gs, Aa^Fma, Aa, Aa^Fma, Aa^Fma, Gs, Aa, Gd, Wwg
Wog, Wog, Wog, Wog, Wog, Wwg, Wog, Wog, Wog, Wog, Wog, Wog, Wog, Wog, Wog, Wog, Wog, Wog, Wog, Wwrg, Wog, Wwg, Wwg, Wwg, Wwg, Ds^Qhh, Wwg, Ds, Ds, Ds, Wwg, Ds, Wwg, Ds, Ds, Tyb, Gd, Tyb, Gs, Gs, Wwg, Gs, Wwf, Wwf, Wwf, Ha, Hhd, Hhd, Hhd, Gs, Gs, Gs, Wwf, Wwf, Gs, Wwg, Wwg, Aa, Aa, Aa^Fma, Aa^Fma, Gll^Fmf, Gll^Fmf, Gll, Gs, Wwg, Gs
Wog, Wog, Wog, Wog, Wog, Wog, Wwg, Wog, Wog, Wwg, Wog, Wog, Wog, Wog, Wog, Wog, Wwg, Wwrg, Wog, Wog, Wog, Wwg, Wwg, Wwg, Wwg, Wwg, Wwg, Wwg, Wwg, Wwg, Wwg, Wwg, Wwg, Wwg, Wwg, Ds, Gs, Gs, Wwg, Wwg, Gs^Vl, Wwg, Tyb, Gs, Wwf, Ha^Vhha, Ha, Hhd, Gs, Gs, Wwg, Wwf, Gs, Gs, Gd, Gs, Gs, Wwf, Wwf, Gs, Aa, Aa^Fma, Gll, Gll, Wwg, Wwg, Gs
Wog, Wog, Wog, Wog, Wog, Wog, Wwg, Wog, Wog, Wwg, Wog, Wog, Wog, Wog, Wwg, Wwg, Aa^Qhh, Wwg, Wwg, Wwg, Wwg, Wog, Wog, Wwg, Wwg, Wwg, Wwg, Wwg, Wwg, Wwg, Wwg, Wwg, Wwg, Wwg, Wwg, Ds, Wwg, Wwg, Wwg, Wwg, Gd, Tyb, Gs, Gs, Wwg, Aa, Aa, Gs, Wwg, Wwg, Gs, Gs, Gs, Gs, Gll, Tyb, Gs, Gd, Gd, Wwg, Wwg, Wwg, Wwg, Wwg, Aa, Gs, Gs
Wog, Wog, Wog, Wog, Wog, Wog, Wwg, Wog, Wog, Wwg, Wog, Wog, Wwg, Wog, Wwg, Tyb^Qhh, Aa^Qhh, Aa^Qhh, Wwg, Wog, Wog, Wwrg, Wog, Wwrg, Wwg, Wog, Wog, Wwrg, Wwrg, Wwg, Wog, Wwg, Wwg, Wwg, Wwg, Wwg, Wwg, Wwg, Gs, Tyb, Aa, Aa, Gll, Gs, Gs, Wwf, Wwf, Wwf, Gs, Gs, Aa, Gd, Tyb, Tyb, Gll^Fmf, Aa^Fma, Gll^Fmf, Gs, Aa, Gd, Wwg, Wwg, Tyb, Aa, Aa, Gd, Gs
Wog, Wog, Wog, Wog, Wwg, Wog, Wog, Wwg, Wwg, Wog, Wwg, Wwg, Wog, Wwg, Tyb^Qhh, Aa^Qhh, Aa^Qhh, Aa^Qhh, Wwg, Wog, Wog, Wog, Wwg, Wwrg, Aa^Qhh, Wwrg, Wwg, Wog, Wog, Wwrg, Wog, Wwg, Wwg, Wwg, Wwg, Wwg, Wwg, Wwg, Ds, Tyb, Tyb, Aa^Fma, Gll^Fmf, Gll, Tyb, Gs, Gs, Gs, Aa, Cha, Gs, Gs, Aa, Aa, Aa^Fma, Aa^Fma, Gll^Fmf, Aa^Fma, Aa, Wwg, Gs, Tyb, Gd, Gd, Gs, Aa, Aa^Fma
Wog, Wog, Wog, Wog, Wwg, Wog, Wwg, Wwg, Wwg, Wog, Wog, Wog, Wog, Wwg, Wwg, Tyb^Qhh, Wwg, Tyb^Qhh, Wwg, Wog, Wog, Wog, Wwg, Aa^Qhh, Aa^Qhh, Aa^Qhh, Tyb^Qhh, Wwg, Wog, Wwrg, Wwrg, Wwg, Wog, Wog, Wog, Wwg, Wwg, Wwg, Ds, Gd, Tyb, Aa^Fma, Aa, Aa^Fma, Aa, Tyb, Gs, Gd, Cha, Kh, Ch, Gd, Aa, Ha^Vhha, Ha^Fma, Ha^Fma, Aa^Fma, Gll, Wwf, Wwf, Aa, Gd, Aa, Gs, Gll, Gll^Fmf, Gll^Fmf
Wog, Wog, Wog, Wog, Wog, Wog, Wwg, Tyb^Qhh, Aa^Qhh, Wwg, Wwg, Wog, Wog, Wog, Wog, Wwg, Wwg, Wwg, Wog, Wwg, Wwg, Wwg, Tyb^Qhh, Aa^Qhh, Aa^Qhh, Tyb^Qhh, Wwg, Wwg, Wog, Wwrg, Wog, Wog, Wog, Wog, Wog, Wwg, Wwg, Wwg, Ds, Gs, Gll, Gll^Fmf, Gll^Fmf, Gll^Fmf, Aa, Tyb, Aa, Gs, Gs, Gs, Aa, Gd, Hhd, Ha, Ha, Ha^Fma, Hhd, Aa, Wwf, Gs, Tyb, Aa, Aa, Aa^Fma, Gll^Fmf, Gll^Fmf, Gll^Fmf
Wog, Wog, Wog, Wog, Wog, Wog, Wwg, Tyb^Qhh, Aa^Qhh, Aa^Qhh, Wwg, Wog, Wog, Wog, Wog, Wwg, Wog, Wog, Wog, Wog, Wog, Wwg, Wwg, Wwg, Wwg, Tyb^Qhh, Wwg, Wwg, Wwg, Wog, Wog, Wog, Wog, Wwrg, Wog, Wwg, Wwg, Wwg, Ds, Gs, Gd, Aa^Fma, Gll^Fmf, Aa^Fma, Aa, Aa^Fma, Aa, Gd, Aa, Gs, Aa, Gs, Hhd, Hhd, Hhd, Hhd, Gs, Gs, Gd, Wwf, Wwg, Aa, Gs, Aa^Fma, Gll, Gll^Fmf, Gll
Wog, Wog, Wwg, Wwg, Wog, Wog, Wwg, Wwg, Aa^Qhh, Tyb^Qhh, Wwg, Wog, Wwg, Wwg^Cov, Wog, Wog, Wog, Wwg, Wwg, Wog, Wog, Wog, Wog, Wog, Wwg, Wwg, Wwg, Wwg, Tyb^Qhh, Wwg, Wwg, Wwg, Wwg, Wwrg, Wwrg, Wwg, Wwg, Wwg, Wwg, Ds, Tyb, Aa, Aa^Fma, Aa^Fma, Hhd^Fmf, Gll^Fmf, Hhd^Fmf, Gs, Gs, Tyb, Tyb, Gs, Gs, Hhd, Hhd, Hhd, Gs, Tyb, Aa, Gs, Wwg, Gs, Gll, Gll^Fmf, Aa^Fma, Aa^Fma, Gs
Wog, Wwg, Wog, Wog, Wog, Wog, Wog, Wwg, Tyb^Qhh, Tyb^Qhh, Wwg, Wwg^Cov, Wog^Cov, Wog^Cov, Wog^Cov, Wog^Cov, Wog, Wog, Wwg, Wwg, Wwg, Wog, Wwg, Wog, Wog, Wwg, Tyb^Qhh, Aa^Qhh, Aa^Qhh, Wwg, Wog, Wog, Wwg, Wwrg, Wog, Wog, Wog, Wwg, Wwg, Ds, Tyb, Aa, Gll^Fmf, Aa^Fma, Ha^Fma, Hhd^Fmf, Hhd^Fmf, Hhd, Gs, Gd, Gd, Gs, Gs, Gs, Gs, Gs, Gs, Tyb, Gd, Gs, Wwg, Tyb, Gll, Gll^Fmf, Aa^Fma, Aa^Fma, Aa^Fma
Wwg, Wwg, Wog, Wog, Wog, Wwg, Wog, Wwg, Wwg, Wwg, Wwg, Wog, Wog^Cov, Wog^Kov, Wog^Cov, Wog, Wwg, Wwg, Tyb^Qhh, Aa^Qhh, Wwg, Wwg, Wog, Wog, Wog, Wwg, Wwg, Aa^Qhh, Wwg, Wwg, Wog, Wwrg, Wog, Wwrg, Wwg, Wog, Wwg, Wwg, Wwg, Ds, Gd, Aa^Fma, Aa^Fma, Aa^Fma, Ha^Fma, Hhd^Fmf, Hhd, Hhd, Gs, Gs, Aa, Gs, Gs, Gd, Gs, Gs, Aa, Gs, Gd, Gs, Wwf, Aa, Aa, Gll^Fmf, Gll^Fmf, Gll^Fmf, Aa^Fma
Wwg, Wog, Wog, Wog, Wog, Wwg, Wog, Wog, Wog, Wog, Wwg, Wog^Cov, Wwg, Wog^Cov, Wwg, Wog^Cov, Wwg, Aa^Qhh, Aa^Qhh, Aa^Qhh, Tyb^Qhh, Wwg, Wog, Wog, Wwg, Wwg, Wog, Wwg, Wwg, Wog, Wog, Wog, Wog, Wwg, Wwg, Wwg, Wwg, Wwg, Wwg, Ds, Tyb, Aa, Ha, Ha^Fma, Ha^Vhha, Hhd, Hhd, Hhd, Hhd, Gs, Gs, Tyb, Aa, Gs^Vl, Aa, Aa, Tyb, Gs, Gs, Wwf, Aa, Gd, Aa^Fma, Aa^Fma, Aa^Fma, Gll, Aa^Fma
Wog, Wog, Wog, Wog, Wog, Wwg, Wog, Wog, Wog, Wog, Wwg, Wog, Wog, Wog^Cov, Wog, Wwg, Wwg, Aa^Qhh, Aa^Qhh, Aa^Qhh, Wwg, Wwg, Wwg, Wwg, Wwg, Wog, Wog, Wog, Wwrg, Wwrg, Wog, Wog, Wwg, Wwg, Wwg, Wwg, Ds, Wwg, Ds, Ds, Tyb, Aa, Aa, Ha, Hhd, Hhd, Hhd, Hhd, Gs, Tyb, Tyb, Tyb, Gd, Gs, Gs, Tyb, Gs, Gs, Wwg, Wwf, Tyb, Aa, Ha^Fma, Aa^Fma, Aa^Fma, Aa^Fma, Gll
Wwg, Wog, Wog, Wog, Wog, Wog, Wog, Wog, Wwg, Wwg, Wwg, Wog, Wog, Wog, Wog, Wog, Wog, Wwg, Wwg, Wwg, Wog, Wog, Wog, Wog, Wwrg, Wog, Wwrg, Wwrg, Wog, Wog, Wog, Wwg, Wwg, Wwg, Wwg, Ds, Gs, Ds, Gs, Gs, Gd^Fetd, Aa, Tyb, Hhd, Hhd, Hhd, Hhd, Gs, Gs, Tyb, Gs, Gd, Gs, Aa, Gs, Gs, Gs, Wwf, Gs, Ch, Aa, Gs, Hhd, Ha^Fma, Ha^Fma, Gll^Fmf, Aa
Wog, Wwg, Wog, Wog, Wwg, Wwg, Wwg, Wwg, Aa^Qhh, Aa^Qhh, Wwg, Wog, Wog, Wog, Wog, Wog, Wwrg, Wog, Wog, Wog, Wog, Wog, Wwrg, Wwg, Wog, Wwg, Wog, Wwg, Wog, Wog, Wog, Wog, Wwg, Wwg, Wwg, Ds, Tyb, Aa, Gs, Gs^Vc, Tyb, Aa, Tyb, Hhd, Hhd, Hhd, Gs, Gs, Gs^Vc, Aa, Gd, Aa, Gs, Gs, Gs, Gd^Fetd, Gs, Wwf, Ch, Kh, Cha, Hhd^Fmf, Hhd, Hhd, Ha^Fma, Aa^Fma, Aa^Fma
Wog, Wog, Wog, Wwg, Wwg, Wwg, Tyb^Qhh, Tyb^Qhh, Aa^Qhh, Tyb^Qhh, Wwg, Wog, Wog, Wog, Wog, Wog, Wog, Wwrg, Wog, Wwrg, Wog, Wwrg, Wog, Wog, Wwg, Wwg, Wwg, Wwg, Wwg, Wog, Wwg, Wwg, Wwg, Wwg, Wwg, Ds, Gd, Tyb, Gd^Fetd, Gs, Aa, Tyb, Tyb, Gs, Gs, Gs, Aa, Aa, Aa, Gd, Gs, Gs, Gs, Aa, Aa, Gs, Gs, Wwg, Wwf, Gd, Gs, Hhd^Fmf, Hhd^Fmf, Hhd, Ha^Fma, Aa^Fma, Aa
Wog, Wog, Wog, Wog, Wog, Wwg, Tyb^Qhh, Aa^Qhh, Aa^Qhh, Wwg, Wog, Wog, Wog, Wog, Wog, Wwrg, Wog, Wwg, Wog, Wwg, Wwg, Wog, Wog, Wog, Wwg, Wwg, Wwg, Wwg, Wwg, Wwg, Wwg, Wwg, Wwg, Wwg, Aa^Qhh, Ds^Qhh, Tyb, Gs, Tyb, Tyb, Aa, Aa, Gd, Tyb, Tyb, Gs, Tyb, Tyb, Gd, Tyb, Gs, Gs, Gs, Gs, Gs, Aa, Gs, Gd^Fetd, Wwf, Aa, Aa, Tyb, Ha^Vhha, Hhd, Aa, Ha, Aa
Wog, Wog, Wog, Wog, Wog, Wwg, Wwg, Tyb^Qhh, Wwg, Wwg, Wog, Wog, Wog, Wog, Wog, Wwrg, Wog, Wog, Wog, Wog, Wog, Wwg, Wog, Wwg, Wwg, Wwg, Ds^Qhh, Wwg, Aa^Qhh, Wwg, Wwg, Wwg, Aa^Qhh, Aa^Qhh, Aa^Qhhf, Aa^Qhh, Gll^Fmf, Gll, Gll, Tyb, Tyb, Gs, Gs, Aa, Aa, Gd, Aa, Gs, Gs, Gs, Aa, Gd, Aa, Gs, Gd^Fetd, Gs, Gs, Gd^Fetd, Wwg, Tyb, Aa, Gs, Aa, Gd, Aa, Aa, Tyb
Wog, Wog, Wog, Wwg, Wog, Wog, Wog, Wwg, Wwg, Wog, Wog, Wog, Wog, Wog, Wwg, Wwrg, Wog, Wog, Wwg, Wog, Wwg, Wwg, Wwg, Wwg, Ds^Qhh, Ds^Qhh, Gll^Qhhf, Aa^Qhh, Aa^Qhhf, Aa^Qhh, Ds^Qhh, Ds^Qhh, Aa^Qhhf, Aa^Qhhf, Ha^Qhhf, Aa^Qhhf, Hhd^Fmf, Gll^Fmf, Aa, Gs, Aa, Tyb, Tyb, Tyb, Tyb, Aa, Gs, Gs, Gs, Gs, Gs, Gd, Aa, Gs, Gs, Gs, Gs, Wwg, Gs, Tyb, Hhd, Aa, Gs, Aa, Gs, Aa, Aa
Wog, Wog, Wog, Wwg, Wog, Wog, Wwg, Wog, Wog, Wog, Wog, Wog, Wog, Wwrg, Wog, Wog, Wwg, Wwg, Wwg, Wwg, Wwg, Wwg, Wwg, Wwg, Ds^Qhh, Gll^Qhhf, Hhd^Qhhf, Aa^Qhh, Ha^Qhhf, Aa^Qhhf, Hhd^Qhhf, Hhd^Qhhf, Kha, Hhd^Qhhf, Mm^Qhh, Ha^Qhhf, Kha, Ha, Ha, Aa, Aa, Gd, Tyb, Gs, Tyb, Aa, Gs, Gs, Gs, Gd^Fetd, Tyb, Gs, Tyb, Gs, Gs, Gs, Wwf, Wwf, Aa, Ha^Vhha, Hhd, Hhd, Hhd, Hhd, Hhd, Gs, Gd
Wog, Wog, Wwg, Wog, Wog, Wog, Wwg, Wog, Wog, Wog, Wog, Wog, Wwg, Wog, Wog, Wog, Wwg, Wwg, Wwg, Wwg, Ds^Qhh, Aa^Qhh, Aa^Qhh, Aa^Qhh, Hhd^Qhh, Hhd^Qhhf, Mm, Aa^Qhh, Mm^Qhh, Ha^Qhhf, Mm^Qhh, Mm, Mm, Ms, Ms^Xm, Ms, Ms^Xm, Ms, Mm, Hhd, Ha, Aa, Aa, Gs, Tyb, Gd, Aa, Aa, Gd, Tyb, Gs, Aa, Gd, Gs, Wwg, Gs, Wwf, Aa, Aa, Aa^Fma, Ha^Fma, Ha^Fma, Ha^Fma, Hhd, Ha^Fma, Aa, Gs
Wog, Wog, Wwg, Wog, Wog, Wwg, Wog, Wog, Wwrg, Wwrg, Wog, Wog, Wwg, Wog, Wog, Wwg, Wwg, Wwg, Aa^Qhh, Aa^Qhh, Gll^Qhhf, Aa^Qhhf, Ha^Qhhf, Ha^Qhhf, Mm, Mm, Ms^Xm, Ms, Ms^Xm, Ms^Qhh, Ms^Xm, Ms^Xm, Ms^Xm, Ms^Xm, Mm, Ms^Xm, Mm, Ms^Xm, Ms^Xm, Mm, Ha, Kha, Gs, Gs, Gs, Gs, Gd, Gs, Gs, Gs, Gs, Gs, Wwg, Wwg, Gs, Wwg, Tyb, Tyb, Gs, Aa^Fma, Aa^Fma, Ha, Ha, Ha^Fma, Aa, Aa, Gd
Wog, Wog, Wog, Wwg, Wog, Wwg, Wwg, Wwg, Wog, Wwrg, Wog, Wog, Wwg, Wwg, Wwg, Wwg, Wwg, Wwg, Aa^Qhh, Aa^Qhhf, Gll^Qhhf, Hhd^Qhhf, Mm^Qhh, Ms, Ms^Xm, Ms^Xm, Mm^Qhh, Ms^Xm, Mm^Qhh, Ms^Xm, Mm^Qhh, Mm, Ha, Ha, Hhd, Kha, Hhd, Mm, Mm^Xm, Ms, Mm, Hhd, Gs, Gd, Kh, Gs, Tyb, Gs, Gd^Fetd, Aa, Gs, Wwf, Gs, Gs, Tyb, Aa, Gs, Tyb, Aa, Aa, Gll, Gll^Fmf, Aa^Fma, Gll^Fmf, Aa, Gs, Gs
Wog, Wog, Wog, Wwg, Wwg, Wwg, Wwg, Wwg, Wog, Wog, Wwrg, Wog, Wog, Wog, Wog, Wwg, Wwg, Wwg, Wwg, Aa^Qhh, Gll^Qhhf, Hhd^Qhhf, Hhd^Qhh, Mm^Qhh, Mm^Qhh, Mm^Qhh, Ha^Qhh, Mm^Qhh, Hhd^Qhh, Mm^Qhh, Hhd^Qhh, Mm^Qhh, Cha, Kha, Cha, Cha, Cha, Kha, Cha, Ms^Xm, Ms, Hhd, Gs, Gs, Aa, Gs, Gs, Gs, Tyb, Aa, Gs, Wwf, Wwg, Tyb, Gd, Aa, Aa, Gs, Aa, Gs, Gll^Fmf, Aa^Fma, Gll^Fmf, Aa^Fma, Aa^Fma, Aa, Tyb
Wog, Wog, Wwg, Wwg, Tyb, Aa^Fma, Aa^Fma, Wwg, Wog, Wog, Wog, Wog, Wwrg, Wog, Wwg, Wog, Wwg, Wwg, Wwg, Ds^Qhh, Ds^Qhh, Ds^Qhh, Ds^Qhh, Hhd^Qhh, Hhd^Qhh, Ha^Qhh, Aa^Qhh, Hhd^Qhh, Gs^Qhh, Ha^Qhh, Gs^Qhh, Hhd^Qhh, Cha, Rrc^Vhca, Cha, 2 Kha, Cha, Rrc^Vhca, Cha, Ms, Ha, Aa, Gs, Gs, Gd, Aa, Gd, Tyb, Tyb, Gs, Gd, Gs^Vl, Wwg, Gs, Gs, Gd, Aa, Aa, Gs, Gs, Gll, Gll^Fmf, Gs^Vc, Aa, Aa, Aa, Tyb
Wog, Wog, Wwg, Wwg, Aa^Fma, Aa^Fma, Tyb, Wwg, Wog, Wog, Wog, Wog, Wwg, Wwrg, Wog, Wwg, Wog, Wwg, Wwg, Wwg, Wwg, Wwg, Ds^Qhh, Tyb^Qhh, Tyb^Qhh, Aa^Qhh, Gd^Qhh, Gs^Qhh, Aa^Qhh, Gs^Qhh, Aa, Aa, Aa, Kha, Rrc^Vhca, Cha, Rrc^Vhca, Kha, Urb, Ha, Aa, Aa, Tyb, Tyb, Gs, Aa, Gs, Tyb, Gs, Aa, Urb, Gd, Wwg, Gs, Urb, Gs, Urb, Gs, Gd, Gs, Gs, Gll, Gs, Tyb, Aa, Gs, Gs
Wog, Wog, Wog, Wwg, Wwg, Aa^Fma, Tyb, Wwg, Wog, Wog, Wwrg, Wwg, Wog, Wwrg, Wog, Wwg, Wog, Wwg, Wwg, Wwg, Wog, Wwg, Wwg, Ds^Qhh, Aa^Qhh, Aa^Qhh, Aa^Qhh, Tyb^Qhh, Tyb^Qhh, Gd^Qhh, Gs, Gs, Gd, Cha, Cha, Kha, Cha, Cha, Gd, Urb, Urb, Gd, Gd, Gd, Kh, Gs, Aa, Aa, Urb, Urb, Gs, Wwg, Urb, Urb, Aa, Urb, Aa, Urb, Urb, Urb, Urb, Gs, Aa, Gs, Gs, Aa, Gs
Wog, Wog, Wog, Wwg, Wog, Wwg, Wwg, Wwg, Wwg, Wwg, Wog, Wog, Wog, Wwrg, Wwg, Wwg, Wwg, Wog, Wog, Wog, Wwg, Wwg, Wwg, Wwg, Ds^Qhh, Gs^Qhh, Gs^Qhh, Gd^Qhh, Tyb^Qhh, Aa, Aa, Aa, Aa, Gs, Gd, Aa, Gs, Aa, Aa, Gs, Aa, Urb, Urb, Gs, Urb, Urb, Urb, Urb, Gs, Gs, Wwf, Wwg, Gd, Aa, Gs, Aa, Aa^Fma, Aa, Gll^Fmf, Gs, Gs, Urb, Urb, Urb, Urb, Gs, Gs
Wog, Wog, Wog, Wog, Wog, Wog, Wwg, Wwg, Aa^Fma, Wwg, Wog, Wog, Wog, Wog, Wog, Wog, Wog, Wog, Wog, Wwg, Wog, Wog, Wog, Wwg, Wwg, Ds^Qhh, Ds^Qhh, Gs^Qhh, Ds, Gs, Aa, Gs, Cha, Gs, Cha, Aa, Ds, Aa, Aa, Gs, Gs, Aa, Aa, Urb, Gs, Aa, Gs, Gs, Wwf, Wwf, Gs, Gs, Tyb, Aa, Gll, Aa^Fma, Aa, Aa^Fma, Aa^Fma, Aa, Gs, Aa, Gd, Aa, Gs, Urb, Urb
Wog, Wog, Wog, Wog, Wog, Wwg, Tyb, Aa^Fma, Tyb, Wwg, Wog, Wog, Wwg, Wwg, Wog, Wwrg, Wog, Wog, Wog, Wog, Wog, Wog, Wog, Wwg, Wwg, Wwg, Wwg, Ds, Wwg, Ds, Wwg, Ds, Wwg^Bsb|, 4 Kha, Wwg^Bsb|, Ds, Wwg, Wwg, Ds, Gs, Kha, Aa, Gd, Gs, Aa, Aa, Wwg, Wwf, Gd, Aa, Aa, Aa, Gs, Tyb, Gll, Gll^Fmf, Aa^Fma, Aa, Aa, Aa, Gs, Aa, Gs^Vc, Gs, Aa, Gd, Gs
Wog, Wog, Wog, Wog, Wog, Wwg, Wwg, Aa^Fma, Wwg, Wwg, Wog, Wog, Wog, Wog, Wog, Wwrg, Wwrg, Wwrg, Wwrg, Wog, Wwrg, Wog, Wog, Wog, Wog, Wog, Wog, Wwg, Wwg, Wwg, Wwg, Wwg, Wwg^Bsb|, Wwg^Bsb|, Wwg^Bsb|, Wwg, Wwg, Wwg, Wwg, Ds, Ds, Gs, Tyb, Tyb, Tyb, Gs, Wwg, Aa, Aa, Gd, Tyb, Gs, Gll^Fmf, Gs, Tyb, Aa, Gs^Vl, Aa^Fma, Cha, Aa, Aa, Gs, Aa, Aa, Gd, Gs, Tyb
Wog, Wog, Wog, Wog, Wog, Wog, Wog, Wwg, Wwg, Wog, Wwg, Wog, Wog, Wog, Wog, Wog, Wog, Wog, Wog, Wog, Wog, Wog, Wwg, Wog, Wog, Wog, Wwg, Wwg, Wwg, Wog, Wog, Wwg, Wog, Wwg^Bsb|, Wwg, Wwg, Wwg, Wwg, Wwg, Wwg, Ds, Tyb, Gs, Gs, Tyb, Gs, Wwf, Gs^Vc, Aa, Tyb, Aa, Aa^Fma, Aa, Aa, Aa^Fma, Aa^Fma, Aa, Aa, Kha, Cha, Aa, Gd, Aa, Gs, Gs, Gs, Gs
Wog, Wog, Wog, Wog, Wog, Wog, Wwg, Wwg, Aa^Fma, Wwg, Wog, Wog, Wog, Wog, Wog, Wog, Wog, Wog, Wog, Wog, Wog, Wog, Wwg, Wog, Wwrg, Wog, Wog, Wog, Wog, Wwg, Wog, Wog, Wog, Wwg, Wwg, Wwg, Wwg, Wwg, Wwg, Wwg, Wwg, Gs, Wwg, Gs, Wwg, Wwf, Tyb^Qhh, Aa, Aa, Aa, Ha, Aa, Gs, Aa, Gll, Gll^Fmf, Aa, Aa^Fma, Gs, Cha, Aa, Gs, Tyb, Aa, Tyb, Tyb, Gs
Wog, Wog, Wog, Wog, Wog, Wog, Wwg, Aa^Fma, Tyb, Wwg, Wog, Wog, Wog, Wog, Wog, Wog, Wog, Wog, Wog, Wog, Wog, Wog, Wog, Wog, Wog, Wog, Wog, Wog, Wwg, Wog, Wwg, Wog, Wog, Wwg, Wwg, Wwg, Wwg, Wwg, Wwg, Wwg, Wwg, Wwg, Wwg, Wwg, Aa^Qhh, Aa^Qhh, Tyb^Qhh, Gs^Qhh, Hhd^Qhh, Ha, Mm, Ha, Hhd, Aa, Aa, Gs, Gs, Gs, Aa, Gs, Aa, Gd, Tyb, Aa, Gs, Aa, Gs
Wog, Wog, Wog, Wog, Wog, Wog, Wwg, Aa^Fma, Wwg, Wwg, Wog, Wog, Wog, Wog, Wog, Wog, Wog, Wog, Wog, Wog, Wog, Wog, Wwrg, Wwrg, Wog, Wog, Wwg, Wwg, Wwg, Wwg, Wwg, Wwg, Wwg, Wwg, Wwg, Wwg, Wwg, Wwg, Wwg, Wwg, Ds^Qhh, Wwg, Aa^Qhh, Gs^Qhh, Aa^Qhhf, Tyb^Qhh, Aa^Qhh, Hhd^Qhh, Mm^Qhh, Mm^Qhh, Mm, Mm, Mm, Ha, Aa, Aa^Fma, Gll^Fmf, Aa, Gs, Tyb, Gd, Aa, Gs, Gs, Gll, Gll, Gll
Wog, Wog, Wog, Wog, Wog, Wog, Wwg, Wwg, Wog, Wwg, Wog, Wwg, Wwg, Wog, Wog, Wog, Wog, Wog, Wog, Wog, Wog, Wwrg, Wog, Wog, Wog, Wwg, Wwg, Wwg, Wwg, Wwg, Wog, Wwg, Wwg, Wwg, Wwg, Wwg, Wwg, Wwg, Wwg, Wwg, Ds^Qhh, Aa^Qhh, Aa^Qhhf, Gll^Qhhf, Aa^Qhhf, Aa^Qhh, Gd^Qhh, Ha^Qhh, Mm^Qhh, Mm^Qhh, Mm, Mm, Mm, Ha, Aa, Aa^Fma, Tyb, Aa, Tyb, Tyb, Gs, Gs, Gll^Fmf, Gll^Fmf, Aa, Gll^Fmf, Gll^Fmf
Wog, Wog, Wog, Wog, Wwg, Wwg, Wog, Wog, Wog, Wwg, Wog, Wog, Wog, Wog, Wwg, Wog, Wog, Wog, Wog, Wog, Wog, Wwrg, Wwg, Wog, Wog, Wog, Wog, Wwg, Wog, Wwg, Wwg, Wog, Wog, Wog, Wog, Wwg, Wwg, Wwg, Wwg, Wwg, Ds^Qhh, Gs^Qhh, Gs^Qhh, Gll^Qhhf, Aa^Qhh, Gd^Qhh, Aa^Qhh, Ha^Qhh, Mm^Qhh, Mm, Mm, Mm, Mm, Hhd, Hhd, Gs, Aa, Gs, Aa, Aa, Gs, Gll^Fmf, Aa, Aa^Fma, Aa^Fma, Aa^Fma, Gll^Fmf
Wog, Wog, Wog, Wog, Wog, Wog, Wog, Wog, Wwg, Wwrg, Wog, Wog, Wog, Wog, Wog, Wog, Wwg, Wwrg, Wog, Wwg, Wog, Wwg, Wog, Wog, Wwg, Wwg, Wog, Wog, Wwg, Wog, Wog, Wog, Wog, Wog, Wwg, Wwg, Wwg, Wwg, Wwg, Wwg, Ds^Qhh, Gs^Qhh, Gd^Qhh, Tyb^Qhh, Gs^Qhh, Gs^Qhh, Gs^Qhh, Hhd^Qhh, Hhd^Qhh, Mm, Mm, Mm, Mm, Mm, Ha, Aa, Tyb, Aa, Gs^Vl, Tyb, Aa, Gll^Fmf, Aa^Fma, Aa^Fma, Gll, Gll^Fmf, Gll^Fmf
Wog, Wog, Wog, Wwg, Wog, Wog, Wog, Wog, Wwg, Wog, Wwrg, Wwrg, Wwrg, Wog, Wog, Wog, Wog, Wwg, Wwg, Wog, Wog, Wog, Wog, Wog, Wwg, Wog, Wwg, Wwg, Wwg, Wwg, Wwg, Wog, Wwg, Wwg, Wwg, Wwg, Wwg, Wwg, Wwg, Ds^Qhh, Gs^Qhh, Tyb^Qhh, Aa^Qhh, Aa^Qhh, Aa^Qhh, Aa^Qhh, Aa^Qhh, Hhd^Qhh, Mm^Qhh, Mm, Mm, Mm, Mm, Mm, Ha, Gs, Aa, Aa, Aa^Fma, Aa, Aa, Aa, Gll^Fmf, Aa, Gll^Fmf, Gll^Fmf, Gll
Wog, Wog, Wog, Wwg, Wog, Wog, Wwrg, Wog, Wog, Wwrg, Wog, Wog, Wwrg, Wog, Wog, Wwg, Wwg, Wog, Wog, Wog, Wwg, Wwg, Wwg, Wog, Wwg, Wwg, Wwg, Wwg, Wwg, Wwg, Wwg, Wwg, Wwg, Wwg, Wwg, Wwg, Wwg, Wwg, Ds^Qhh, Ds^Qhh, Gs^Qhh, Tyb^Qhh, Aa^Qhhf, Aa^Qhhf, Aa^Qhhf, Aa^Qhhf, Ha^Qhhf, Ha^Qhhf, Mm, Mm, Mm, Mm, Mm, Mm, Mm, Ha, Aa, Aa^Fma, Aa^Fma, Aa^Fma, Aa^Fma, Gll^Fmf, Aa, Gll^Fmf, Aa^Fma, Gll^Fmf, Aa
Wog, Wog, Wog, Wog, Wwg, Wog, Wog, Wog, Wog, Wwrg, Wog, Wog, Wwg, Wog, Wog, Wog, Wwg, Wwg, Wwg, Wwg, Wwg, Wwg, Wwg, Wwg, Wwg, Wwg, Wwg, Wwg, Wwg, Wwg, Wwg, Wwg, Wwg, Wwg, Aa^Qhh, Wwg, Ds^Qhh, Ds^Qhh, Gs^Qhh, Gd^Qhh, Aa^Qhh, Aa^Qhh, Gll^Qhh, Gll^Qhhf, Aa^Qhhf, Gll^Fmf, Ha^Qhhf, Mm^Qhh, Mm, Mm, Mm, Mm, Mm, Mm, Mm, Ha, Hhd, Aa, Gll, Gll^Fmf, Gll^Fmf, Gll^Fmf, Aa^Fma, Aa^Fma, Ha^Fma, Aa^Fma, Aa^Fma
Wog, Wog, Wog, Wog, Wog, Wwrg, Wog, Wog, Wog, Wwrg, Wog, Wwg, Wwg, Wog, Wwg, Wwg, Wwg, Wwg, Wwg, Wwg, Wwg, Wwg, Wwg, Wwg, Wwg, Wwg, Ds^Qhh, Wwg, Aa^Qhh, Aa^Qhh, Ds^Qhh, Ds^Qhh, Ds^Qhh, Aa^Qhh, Gs^Qhh, Ds^Qhh, Aa^Qhh, Tyb^Qhh, Tyb^Qhh, Tyb^Qhh, Aa^Qhhf, Aa^Qhh, Gll^Qhhf, Aa^Qhh, Aa^Qhhf, Gll^Qhhf, Hhd^Qhhf, Mm^Qhh, Mm, Mm, Mm, Mm, Mm, Mm, Mm, Mm, Hhd, Gll^Fmf, Aa, Aa^Fma, Gll^Fmf, Aa^Fma, Ha^Fma, Ha^Fma, Mm, Ha^Fma, Hhd^Fmf
Wog, Wog, Wog, Wog, Wog, Wwrg, Wog, Wog, Wog, Wwrg, Wwg, Wwg, Wog, Wog, Wwg, Wwg, Wwg, Wwg, Ds^Qhh, Ds^Qhh, Ds^Qhh, Aa^Qhh, Aa^Qhh, Aa^Qhh, Ds^Qhh, Aa^Qhh, Tyb^Qhh, Ds^Qhh, Aa^Qhh, Aa^Qhh, Aa^Qhh, Tyb^Qhh, Gll^Qhh, Aa^Qhh, Aa^Qhh, Aa^Qhh, Aa^Qhhf, Aa^Qhh, Aa^Qhhf, Aa^Qhhf, Aa^Qhhf, Aa^Qhhf, Aa^Qhh, Aa^Qhhf, Aa^Qhhf, Hhd^Qhh, Mm^Qhh, Mm^Qhh, Mm, Mm, Mm, Mm, Mm, Mm, Mm, Mm, Mm, Hhd, Gll^Fmf, Aa^Fma, Ha^Fma, Ha^Fma, Mm, Ha^Fma, Mm, Mm, Mm
Wog, Wog, Wog, Wog, Wog, Wog, Wog, Wog, Wog, Wog, Wwg, Wwg, Wwg, Wwg, Wwg, Wwg, Ds^Qhh, Ds^Qhh, Tyb^Qhh, Gs^Qhh, Aa^Qhh, Aa^Qhh, Aa^Qhh, Aa^Qhh, Gll^Qhhf, Aa^Qhh, Gll^Qhhf, Aa^Qhh, Aa^Qhhf, Aa^Qhh, Tyb^Qhh, Tyb^Qhh, Gll^Qhhf, Aa^Qhhf, Aa^Qhhf, Gll^Qhh, Aa^Qhhf, Aa^Qhhf, Gll^Qhhf, Gll^Qhhf, Gll^Fmf, Aa^Qhhf, Aa^Qhhf, Gll^Qhh, Hhd^Qhhf, Ha^Qhhf, Mm, Mm, Mm, Mm, Mm, Mm, Mm, Mm, Mm, Mm, Mm, Ha, Gll^Fmf, Aa^Fma, Ha^Fma, Mm, Mm, Mm, Ms, Ms, Ms
Wog, Wog, Wog, Wog, Wwrg, Wwrg, Wwrg, Wog, Wwg, Wwg, Wwg, Wog, Wwg, Wwg, Ds^Qhh, Ds^Qhh, Tyb^Qhh, Tyb^Qhh, Gll, Gll^Qhhf, Aa^Qhhf, Aa^Qhhf, Aa^Qhhf, Aa^Qhhf, Aa^Fma, Aa^Qhhf, Gll^Fmf, Aa^Qhhf, Aa^Qhhf, Aa^Qhhf, Gll^Fmf, Aa^Qhhf, Gs, Aa^Qhhf, Gll^Qhhf, Gll^Qhhf, Gll^Qhhf, Gll^Qhhf, Aa^Fma, Gll^Qhhf, Gs, Aa^Qhhf, Aa^Fma, Hhd^Qhhf, Mm, Mm, Mm, Mm, Mm, Mm, Mm, Mm, Mm, Mm, Mm, Mm, Mm, Ha, Aa^Fma, Hhd^Fmf, Hhd^Fmf, Mm, Mm, Ms, Ms, Ms, Ms
