border_size=1
usage=map

Wwg, Wwg, Ds, Gd, Aa, Gs, Gll, Gll^Fmf, Aa^Fma, Gll^Fmf, Gll^Fmf, Gll^Fmf, Gll^Fmf, Gll, Aa^Fma, Gll^Fmf, Gll, Gll^Fmf, Gll, Gs^Es, Gs^Es, Gs, Rb, Gs, Gd, Gs, Gll^Fmf, Aa^Fma, Aa, Gs, Aa, Aa, Ha^Fma, Aa^Fma, Aa, Gll, Gll^Fmf, Hhd^Fmf, Mm, Mm, Mm, Mm, Mm, Mm, Ms, Ms, Mm, Ms, Ms, Ms, Ms, Ms, Ms, Mm, Mm, Mm, Ms, Mm
Wwg, Wwg, Wwg, Ds, Gd, Gs, Gs, Gll^Es, Gll, Gll^Em, Gll, Gll^Fmf, Aa^Fma, Aa, Gll^Fmf, Aa^Fma, Gll^Em, Gll, Gll^Fmf, Gs, Gs, Gd, Rb, Gs^Es, Gs, Gs, Gll^Em, Aa, Aa^Fma, Gd, Gs^Es, Ha, Ha^Fma, Aa^Fma, Aa^Fma, Gll^Fmf, Gll, Hhd, Hhd, Ha^Fma, Ha^Fma, Mm, Mm, Ms, Ms, Ms, Ms, Mm, Mm, Mm, Mm, Mm, Mm, Ms, Ms, Mm, Ms, Mm
Wog, Wwg, Wwg, Ds, Ds, Aa, Ds, Gd^Es, Gd, Gs, Gs, Aa, Aa, Aa^Fma, Aa^Fma, Gll^Fmf, Gll^Fmf, Gll, Gll^Fmf, Gll, Gs, Gs, Gs, Rb, Gs, Aa, Aa^Fma, Aa^Fma, Aa, Gs, Gs, Aa, Hhd, Hhd^Fmf, Gll^Fmf, Aa, Aa^Fma, Gll^Em, Gll^Fmf, Hhd^Fmf, Ha, Mm, Mm, Mm, Mm, Mm, Mm, Ms, Ms, Mm, Ms, Mm, Mm, Mm, Mm, Ms, Ms, Mm
Wog, Wwg, Wwg, Wwg, Wwg, Ds, Wwg, Ds, Ds, Gd, Aa, Aa^Fma, Aa, Aa^Fma, Gll^Fmf, Aa^Fma, Aa^Fma, Gll^Em, Aa^Fma, Gll, Gs, Gd, Gs, Rb, Gs, Aa, Aa^Fma, Gll^Fmf, Aa^Fma, Gs, Gs, Gd, Gs, Hhd^Fmf, Aa^Fma, Aa, Aa^Fma, Gll^Fmf, Gll^Fmf, Gll^Fmf, Gll, Hhd, Mm, Mm, Mm, Mm, Ms, Mm, Mm, Mm, Ms, Ms, Ms, Mm, Mm, Mm, Ms, Ms
Wwg, Wog, Wog, Wwg, Ai, Wwg, Wwg, Wwg, Ai, Aa, Aa, Aa, Gs, Gll, Gll, Ha^Fma, Hhd^Fmf, Gll^Fmf, Aa, Gll^Es, Gll, Gs, Gll, Rb, Rb, Gs^Es, Aa, Aa^Fma, Gll^Fmf, Gll, Gs, Gd^Es, Gs, Aa, Aa^Fma, Aa, Aa, Aa^Fma, Gll^Em, Gll^Fmf, Gll^Fmf, Hhd^Fmf, Ha^Fma, Mm, Mm, Mm, Mm, Mm, Ms, Mm, Mm, Ms, Ms, Mm, Mm, Mm, Ms, Mm
Wwg, Wog, Wwg, Wog, Wog, Wwg, Ai, Ai, Wwg, Ai, Ai, Ds, Gd, Gs^Es, Gll, Hhd^Fmf, Hhd^Fmf, Ha^Fma, Aa^Fma, Gll, Gll^Fmf, Gll, Aa^Fma, Aa, Gs, Rb, Rb, Gll, Aa^Fma, Aa^Fma, Gs, Gd, Gs, Aa, Aa^Fma, Ha^Fma, Aa, Aa^Fma, Gll^Fmf, Gll^Fmf, Aa, Aa^Fma, Ha^Fma, Mm, Mm, Mm, Mm, Mm, Mm, Ms, Mm, Mm, Mm, Mm, Ms, Mm, Mm, Mm
Wog, Wwg, Wog, Wwg, Wog, Wwg, Ai, Ai, Wog, Wwg, Ai, Ds, Ds, Gs, Gll^Es, Hhd^Fmf, Hhd^Fmf, Ha^Fma, Aa, Gll^Fmf, Aa, Gll^Em, Aa^Fma, Aa, Aa, Gs, Gs, Rb, Rb, Aa, Gs, Gd, Gd, Gs, Ha, Ha^Fma, Ha^Fma, Aa, Aa^Fma, Aa, Aa^Fma, Aa^Fma, Aa, Ha, Ha^Fma, Mm, Mm, Mm, Mm, Mm, Mm, Ms, Ms, Mm, Mm, Ms, Ms, Mm
Wog, Wog, Wog, Ai, Wog, Wog, Wog, Wwg, Wwg, Wwg, Wwg, Ai, Wwg, Ds, Ds, Gll, Gll, Gll, Gs, Aa^Fma, Aa^Fma, Gll^Fmf, Aa^Fma, Aa^Fma, Aa^Fma, Aa, Aa, Aa, Gs, Rb, Rb^Es, Gs^Es, Gs, Gs, Aa, Ha, Hhd^Fmf, Hhd^Fmf, Hhd^Fmf, Aa^Fma, Gg^Ve, Aa, Aa, Aa^Fma, Aa^Fma, Hhd, Hhd^Fmf, Mm, Ha, Mm, Hhd, Mm, Mm, Ms, Ms, Ms, Ms, Mm
Wog, Wog, Wog, Wwg, Wwg, Ai, Wog, Wwg, Wwg, Wog, Ai, Wwg, Wwg, Wwg, Wwg, Ds, Ds, Gs, Gs, Aa, Aa^Fma, Aa^Fma, Ha^Fma, Aa^Fma, Aa^Fma, Aa, Gs, Gs, Gs, Gd, Rb^Es, Gs, Gs, Gs, Aa, Hhd, Hhd^Fmf, Ha, Hhd^Fmf, Gll^Fmf, Gll^Fmf, Gll^Em, Gll, Aa, Gll^Em, Gll, Gll^Fmf, Ha^Fma, Aa, Hhd, Aa, Ha, Mm, Mm, Mm, Mm, Mm, Mm
Wog, Wog, Wog, Wog, Wog, Wog, Wog, Ai, Wwg, Wwg, Wwg, Wog, Wog, Ai, Wwg, Wwg, Wwg, Ds, Ds, Gs, Gll, Hhd^Fmf, Hhd^Fmf, Ha^Fma, Aa, Gll, Gd, Gs, Gs^Es, Gd, Rb, Aa, Aa, Aa, Gs, Gll, Ha, Ha, Hhd, Gll, Gll, Gll^Fmf, Gll^Fmf, Aa^Fma, Gll^Fmf, Gll^Fmf, Aa^Fma, Aa^Fma, Aa, Gll, Aa, Ha^Fma, Hhd^Fmf, Mm, Mm, Mm, Mm, Mm
Wog, Wog, Wog, Wog, Wog, Wwg, Wog, Wog, Wwg, Wog, Wog, Wwg, Wwg, Wog, Ai, Wwg, Wwg, Wwg, Ds, Gs, Gll, Aa^Fma, Hhd^Fmf, Ha^Fma, Gll^Em, Gll^Fmf, Gd, Aa^Es, Aa, Gs, Aa, Rb, Rb, Gs, Re^Vct, Gll, Gll^Fmf, Hhd^Fmf, Re^Vct, Gs^Es, Aa, Aa, Aa, Aa^Fma, Aa^Fma, Gll, Gll, Aa^Fma, Aa^Fma, Aa, Aa^Fma, Aa^Fma, Aa^Fma, Hhd, Mm, Mm, Mm, Mm
Wog, Wog, Wog, Wog, Wog, Wog, Wog, Wog, Wwg, Wwg, Wwg, Wog, Wog, Wwg, Wog, Wog, Wwg, Wwg, Wwg, Ds, Gll, Gll^Fmf, Gll, Gll^Fmf, Gll^Fmf, Gll, Gll, Gs, Gs, Aa, Gs, Aa, Rb, Rb, Rb, Gs, Ce, Gll^Fmf, Gs, Aa, Aa^Fma, Aa^Fma, Aa, Aa, Gll, Gll^Fmf, Gll, Aa, Gll^Em, Aa^Fma, Aa, Aa, Aa^Fma, Hhd, Hhd^Fmf, Hhd^Fmf, Ha, Ha
Wog, Wog, Wog, Wog, Wog, Wog, Wog, Wog, Wog, Wwg, Wog, Wwg, Wwg, Wwg, Ai, Wog, Wwg, Wwg, Wwg, Ds, Gs, Gll, Gg^Ve, Gll^Fmf, Aa^Fma, Gll^Fmf, Aa^Fma, Aa, Gll, Gs, Gs, Rb, Gs, Aa, Rb, Ce, 1 Ke, Ce, Hhd, Hhd^Fmf, Ha^Fma, Aa, Gll, Gll^Es, Gll^Es, Gll^Fmf, Aa^Fma, Gll^Es, Gll^Es, Aa, Gll, Gll^Em, Gll^Fmf, Gll^Fmf, Gll^Fmf, Gll^Fmf, Aa, Aa
Wog, Wog, Wog, Wog, Wog, Wog, Wog, Wog, Wog, Wog, Wog, Wog, Wog, Wwg, Wwg, Wog, Wwg, Ai, Wwg, Ds, Ds, Gll^Es, Gll^Fmf, Aa^Fma, Aa^Fma, Aa^Fma, Gll^Fmf, Aa^Fma, Gll^Fmf, Gll, Gll, Rb^Es, Gd, Gs, Rb, Ke, Ce^Kov, Ke, Hhd, Ha, Ha, Ha^Fma, Gll^Fmf, Gll, Aa, Aa, Gll, Gll^Fmf, Gll, Gll^Fmf, Gll^Fmf, Gll^Fmf, Gll, Gll, Gll, Gll, Aa, Aa
Wog, Wog, Wog, Wog, Wog, Wog, Wog, Wog, Wog, Wog, Wog, Wog, Wwg, Wwg, Wog, Wwg, Wog, Wwg, Wwg, Wwg, Ds, Gll, Gll, Gll^Fmf, Aa, Aa^Fma, Gll^Fmf, Aa^Fma, Aa^Fma, Gll^Fmf, Gll, Rb, Gs, Re^Vct, Rb, Ce, Ce, Ce, Ha, Hhd, Ha^Fma, Hhd^Fmf, Gll^Fmf, Aa^Fma, Aa^Fma, Gll^Fmf, Gll^Fmf, Gll, Aa^Fma, Gll, Gll, Gll, Gs^Es, Gd, Gs, Gs, Ai, Ai
Wog, Wog, Wog, Wog, Wog, Wog, Wog, Wog, Wog, Wog, Wog, Wwg, Wog, Ai, Wog, Wwg, Wwg, Wwg, Wwg, Wwg, Ds, Gs, Gs^Es, Gll^Fmf, Gll^Em, Gll^Fmf, Aa^Fma, Aa, Aa^Fma, Gll, Gll^Fmf, Rb, Gd, Gs, Rb, Rb, Rb, Aa, Gs, Ha^Fma, Hhd^Fmf, Hhd^Fmf, Gll, Aa^Fma, Aa, Gll^Fmf, Gll^Fmf, Gll, Gll^Fmf, Gs, Gs, Gs, Gd, Gd, Gs, Wwg, Wwg, Wwg
Wog, Wog, Wog, Wog, Wog, Wog, Wog, Wog, Wog, Wog, Wog, Wwg, Wog, Wog, Wog, Ai, Wog, Wwg, Wwg, Wwg, Ds, Aa, Gs, Gll, Aa^Fma, Gll^Fmf, Aa, Aa^Fma, Aa, Aa, Gll, Rb^Es, Gs, Gs, Rb, Gd^Es, Gs^Es, Rb, Hhd, Hhd^Fmf, Ha^Fma, Hhd^Fmf, Gll^Fmf, Aa^Fma, Aa, Aa^Fma, Aa^Fma, Gll^Fmf, Gll, Gs, Gs^Es, Gd^Es, Gs, Gd, Wwg, Wwg, Wog, Wog
Wog, Wog, Wog, Wog, Wog, Wog, Wog, Wog, Wog, Wog, Wog, Wwg, Wog, Wog, Wwg, Wwg, Wwg, Wwg, Wwg, Wwg, Ds, Gs, Gs, Gll^Es, Gll^Fmf, Aa, Aa^Fma, Aa^Fma, Aa^Fma, Aa, Gll^Fmf, Rb^Es, Gs, Aa, Rb, Gd, Re^Vct, Rb, Rb, Hhd, Aa^Fma, Gll^Fmf, Aa^Fma, Aa^Fma, Gll, Gll^Fmf, Aa^Fma, Gll^Fmf, Re^Vct, Gs^Es, Gd, Gd, Gs, Wwg, Wwg, Wog, Wog, Wog
Wog, Wog, Wog, Wog, Wog, Wog, Wog, Wog, Wog, Wog, Wog, Wog, Wwg, Wwg, Wog, Wog, Wwg, Wwg, Wwg, Ds, Gs^Es, Aa, Aa, Gll^Es, Gll, Gll^Fmf, Ha^Fma, Gll^Fmf, Gll^Fmf, Gll^Fmf, Gll, Rb, Re^Vct, Gs, Rb, Gd, Gs, Aa, Rb, Gs, Aa, Aa^Fma, Aa^Fma, Gll^Fmf, Gll^Fmf, Gll, Aa^Fma, Gll^Fmf, Gll, Gd, Re^Vct, Gd, Wwg, Wwg, Wog, Wog, Ai, Wog
Wog, Wog, Wog, Wog, Wog, Wog, Wog, Wog, Wog, Ww^Vm, Wog, Wog, Wog, Wwg, Wwg, Wog, Wwg, Wwg, Wwg, Ds, Ds, Gs, Aa, Gll, Hh^Vhh, Hhd^Fmf, Ms, Hhd^Fmf, Hhd^Fmf, Gll, Aa, Rb, Rb, Rb, Aa, Rb, Aa, Aa, Gs, Rb, Gs, Aa, Gs, Gll, Gs^Es, Gll, Gll^Fmf, Aa, Gll^Fmf, Gll, Gs^Es, Wwg, Wwg, Wwg, Ai, Ai, Wog, Wog
Wog, Wog, Wog, Wog, Wog, Wog, Wog, Wog, Wog, Wog, Wog, Wog, Wog, Wwg, Wwg, Wog, Ai, Ai, Wwg, Wwg, Wwg, Ds, Ds, Gll, Hhd^Fmf, Mm, Mm, Mm, Ms, Ha^Fma, Ha^Fma, Aa, Rb, Rb, Ce, Rb, Rb, Gs, Gs, Rb, Gs, Aa, Rb, Gs, Re^Vct, Gll, Aa, Aa^Fma, Ce, Gll^Es, Gd, Wwg, Wog, Wwg, Wog, Ai, Wog, Wwg
Wog, Wog, Wog, Wog, Wog, Wog, Wog, Wog, Wog, Wog, Wog, Wog, Wog, Wog, Wwg, Ai, Wog, Wwg, Wwg, Wwg, Wwg, Wwg, Ds, Gll, Hhd^Fmf, Mm, Mm, Mm, Ms, Ms, Ha^Fma, Aa, Rb, Gd, Ce, Gd^Es, Ce, Rb, Rb, Rb, Rb^Es, Rb, Gd^Es, Rb, Rb, Aa, Ce, Ce, 5 Ke, Ce, Ce, Wwg, Wog, Wog, Wwg, Wog, Wwg, Wwg
Wog, Wog, Wog, Wog, Wog, Wog, Wog, Wog, Wog, Wog, Wog, Wog, Wog, Wog, Wog, Wog, Ai, Ai, Ai, Ai, Wwg, Wwg, Wwg, Ds, Aa, Ha^Fma, Ms, Ms, Ms, Mm, Hhd^Fmf, Gll, Rb, Ce, 3 Ke, Ce, Rb, Gd, Re^Vct, Rb, Gs, Gs, Gd, Gs, Rb, Aa, Aa, Ce, Ce, Ce, Gd, Wwg, Wwg, Wog, Wog, Wwg, Wwg, Gd
Wog, Wog, Wog, Wog, Wog, Wog, Wog, Wog, Wog, Ww^Vm, Wog, Wog, Wog, Wog, Wwg, Wwg, Wog, Wog, Chw, Ai, Chw, Wwg, Wwg, Ds, Aa, Ha^Fma, Mm, Mm, Mm, Mm, Hhd^Fmf, Re^Vct, Rb, Ce, Ce, Ce, Ce, Gs, Wwg, Rb, Wwg, Wwg, Wwg, Wwg, Wwg, Wwf, Wwg, Ce, Gd, Ce, Wwg, Wwg, Ai, Ai, Wog, Wwg, Wwg, Gd
Wog, Wog, Wog, Wog, Wog, Wog, Wog, Wog, Wog, Wog, Wog, Wog, Wog, Wog, Ww^Vm, Wwg, Wwg, Wog, Chw, 4 Khw, Chw, Wwg, Wwg, Ds, Ds, Hhd^Fmf, Hhd^Fmf, Ms, Ha^Fma, Hhd^Fmf, Gll, Gll^Fmf, Gs, Rb, Ce, Aa, Aa, Wwg, Wwg, Wwf, Wwg, Wog, Ai, Wog, Wwg, Wwf, Wwg, Wwg, Wwg, Wwg, Ai, Wog, Ai, Ai, Wog, Wwg, Gs^Es, Gs
Wog, Wog, Wog, Wog, Wog, Wog, Wog, Wog, Ai, Wog, Wog, Wog, Wog, Wog, Wwg, Wog, Wwg, Ai, Wog, Chw, Wog, Ai, Wwg, Wwg, Ds, Gll, Aa, Ha^Fma, Ds, Ds, Gll^Fmf, Gll^Fmf, Wwf, Rb, Wwg, Aa, Ai, Wog, Wwg, Wwf, Wwf, Wog, Ai, Wog, Wwg, Wwf, Wwg, Wog, Wog, Wog, Wog, Wog, Wwg, Wog, Wwg, Wwg, Gd, Aa
Wog, Wog, Wwg, Wog, Wwg, Wwg, Wog, Wog, Wwg, Wog, Wwg, Wwg, Ai, Wog, Wwg, Wog, Wwg, Wwg, Wog, Wog, Wog, Wog, Ai, Wwg, Ds, Gd, Ds, Ds, Wwg, Wwf, Wwg, Wwg, Wwg, Wwf, Wwg, Ai, Wog, Wog, Wog, Ww^Vm, Wwf, Wwg, Wwg, Ai, Wwg, Wwf, Wwf, Wwg, Wog, Wog, Wog, Ai, Wwg, Ai, Wwg, Gs^Vc, Aa, Aa
Wwg, Wwg, Wog, Wog, Ai, Wog, Wog, Wog, Wog, Wwg, Ai, Wwg, Wog, Wog, Wog, Wwg, Wog, Wog, Wwg, Ai, Wog, Wog, Wwg, Wwg, Wwf, Ds, Wwg, Wwg, Wwf, Wwf, Wwg, Wog, Wwg, Wwf, Wwf, Wwg, Ai, Ai, Wog, Wwg, Wwg, Wwf, Wwg, Wwg, Wwg, Wwg, Wwf, Wwg, Wwg, Ww^Vm, Wog, Wog, Wwg, Wwg, Wwg, Gs^Es, Aa^Fma, Aa^Fma
Wwg, Wog, Wog, Wog, Wog, Wog, Ai, Wwg, Wog, Wog, Wwg, Wog, Ai, Wog, Wwg, Wog, Ai, Ai, Wwg, Wwg, Wwg, Wwg, Wwf, Wwf, Wwg, Wwg, Ww^Vm, Wwg, Wwf, Wwg, Wog, Wog, Wwg, Wwf, Wwf, Wwg, Wog, Wog, Wwg, Wwg, Rb, Wwf, Ha, Ha, Ha, Gs, Gs, Wwg, Wwg, Wwg, Wwg, Wog, Wwg, Wwg, Gs, Gs^Es, Aa^Fma, Aa^Fma
Wwg, Wog, Wog, Wog, Wog, Wwg, Wwg, Wog, Wwg, Wwg, Wwg, Wwg, Wwg, Wwg, Wwg, Wog, Wog, Wog, Wwg, Wwg, Ds, Wwg, Wwf, Wwg, Wog, Ai, Wog, Wwg, Wwf, Wwg, Ai, Ai, Ai, Wwf, Wwg, Wwg, Wwg, Wwg, Gd, Rb, Hhd, Hh^Vhh, Hhd, Hhd, Ha, Aa, Gll, Gd^Es, Gd, Wwg, Gs^Es, Wwg, Gd, Gd, Gll^Fmf, Gll^Fmf, Ha^Fma, Ha^Fma
Wwg, Wwg, Ai, Wwg, Wwg, Wwg, Wwg, Wwg, Wwg, Wwg, Ds, Wwg, Wwg, Wwg, Ds, Wwg, Wwg, Wwg, Ds, Ds, Rb, Ds, Wwf, Wwg, Wwg, Wog, Wog, Ai, Wwg, Wwf, Ha^Fma, Ha^Fma, Ha, Wwf, Rb, Wwg, Gs, Gs, Gd^Es, Rb, Rb, Hhd, Ha, Ha, Aa^Fma, Gll, Gll^Fmf, Gll, Gs^Vl, Gs^Es, Aa^Fma, Gs, Gll^Fmf, Aa^Fma, Ha^Fma, Hhd^Fmf, Mm, Mm
Wog, Wog, Wwg, Wwg, Wwg, Wwg, Ds, Ds, Ds, Ds, Gs, Ds, Ds, Ds, Aa^Fma, Ds, Ds, Wwg, Ds, Gd, Rb^Es, Ds, Ds, Wwg, Wwg, Ai, Wwg, Wog, Wwg, Ds, Hhd, Hhd, Hh^Vhh, Gs, Rb^Es, Gs, Hhd^Fmf, Gs, Hhd^Fmf, Gll^Fmf, Rb, Gs, Gs, Aa^Fma, Ha^Fma, Hhd^Fmf, Hhd, Gll^Fmf, Gll^Fmf, Aa^Fma, Ha, Gll^Fmf, Hhd^Fmf, Ha, Mm, Mm, Mm, Mm
Wog, Wwg, Wwg, Wwg, Ds, Ds, Gd, Gd, Gll^Es, Gs, Gll^Em, Gll, Gll^Es, Aa, Gll^Fmf, Aa^Fma, Gll, Ds, Gg^Ve, Gs^Es, Aa, Gs, Rb, Ds, Ds, Wwg, Ds, Wwg, Ds, Ds, Hhd^Fmf, Ha, Gs, Gs^Es, Gs, Hhd, Ha, Hhd, Ha, Gll^Fmf, Rb^Es, Gs, Ha, Ha^Fma, Mm, Mm, Mm, Hhd, Gll^Fmf, Ha^Fma, Mm, Ha^Fma, Mm, Mm, Mm, Mm, Ha^Fma, Ha^Fma
Ai, Wwg, Wwg, Ds, Gs^Vc, Aa, Aa, Gll^Fmf, Gll, Gll^Fmf, Gll^Fmf, Gll^Fmf, Gll^Fmf, Gll^Es, Gll, Aa, Gll^Fmf, Gll^Fmf, Gll^Fmf, Aa^Fma, Aa^Fma, Aa, Rb, Gd^Es, Gd, Ds, Gs, Ds, Hhd, Hhd^Fmf, Hhd^Fmf, Gll, Gll, Rb, Aa, Ha^Fma, Ha^Fma, Ha^Fma, Aa, Gs, Rb, Gs, Ha, Mm, Mm, Mm, Mm, Hhd^Fmf, Gll^Fmf, Hhd, Mm, Mm, Mm, Mm, Mm, Ha, Ha, Ha
Wog, Wwg, Wwg, Ds, Ds, Gs^Es, Aa, Aa^Fma, Aa^Fma, Gs^Vl, Aa, Aa^Fma, Gll^Em, Gll, Aa^Fma, Aa^Fma, Ha^Fma, Hhd^Fmf, Hhd, Hhd^Fmf, Ha^Fma, Aa^Fma, Hh^Vhh, Rb, Gs^Es, Rb^Es, Gd^Em, Hhd^Fmf, Ha^Fma, Hhd, Gll^Fmf, Gll, Rb, Rb, Gd^Es, Aa, Rb, Aa^Fma, Rb, Rb, Gd, Aa, Gs, Hhd, Hh^Vhh, Mm, Ha, Hhd^Fmf, Gll^Fmf, Hhd^Fmf, Ha, Mm, Ha^Fma, Hhd^Fmf, Ha, Hhd^Fmf, Ha^Fma, Mm
Wog, Wwg, Wwg, Wwg, Ds, Aa, Aa, Gll, Aa, Aa, Aa, Gll, Gll^Fmf, Gll^Fmf, Ha^Fma, Ha, Ms, Mm, Mm, Ms, Ms, Hhd^Fmf, Mm, Hhd, Hhd^Fmf, Rb, Rb, Aa^Fma, Ha^Fma, Ha, Aa, Aa, Ha, Gs, Hh^Vhh, Gs, Rb, Gd, Gs, Gs, Gd, Aa, Gll^Em, Gll, Hhd^Fmf, Mm, Ha^Fma, Aa^Fma, Aa^Fma, Gg^Ve, Ha^Fma, Ha, Aa^Fma, Aa^Fma, Ha^Fma, Hhd^Fmf, Ms, Ms
Wwg, Wwg, Wwg, Ds, Aa, Aa, Gll^Fmf, Gll^Fmf, Aa^Fma, Aa, Aa^Fma, Aa^Fma, Hhd^Fmf, Hhd, Mm, Ms, Mm, Mm, Mm, Mm, Mm, Mm, Mm, Mm, Ms, Ha^Fma, Aa^Fma, Rb, Rb, Gs^Vc, Gll, Ha^Fma, Ha, Hhd, Ha, Hhd^Fmf, Aa^Fma, Aa, Gll^Fmf, Gll^Fmf, Hhd^Fmf, Ha, Hhd^Fmf, Gll^Fmf, Aa^Fma, Ha, Gll^Fmf, Aa^Fma, Ha, Ha^Fma, Ms, Ha^Fma, Hhd^Fmf, Hhd^Fmf, Ms, Ha^Fma, Mm, Ms
Wwg, Wwg, Ds, Ds, Aa^Fma, Aa^Fma, Hhd^Fmf, Hhd^Fmf, Ha^Fma, Aa^Fma, Ha^Fma, Ha, Mm, Mm, Mm, Mm, Mm, Ms, Ms, Ms, Ms, Mm, Ms, Mm, Ms, Ha^Fma, Hhd^Fmf, Gs, Gll^Es, Rb, Gll, Hhd^Fmf, Hhd, Hhd, Hhd^Fmf, Ha^Fma, Aa^Fma, Aa^Fma, Ha^Fma, Hhd^Fmf, Mm, Ms, Mm, Ha^Fma, Ha^Fma, Gll^Fmf, Hhd^Fmf, Hhd^Fmf, Mm, Ms, Mm, Mm, Mm, Mm, Mm, Ms, Mm, Mm
Wwg, Ds, Gll, Gll^Fmf, Ha^Fma, Ha^Fma, Mm, Ms, Ha^Fma, Aa^Fma, Ha^Fma, Ms, Mm, Mm, Ms, Ms, Mm, Mm, Mm, Mm, Ms^Xm, Ms^Xm, Ms^Xm, Ms, Mm, Mm, Ha^Fma, Gll^Fmf, Gll^Fmf, Rb^Es, Gs^Es, Hhd^Fmf, Hhd, Hhd, Rb, Gs, Gs, Ha^Fma, Ms, Ms, Ms, Ms, Ms, Ms, Mm, Hhd^Fmf, Mm, Mm, Ms, Ms, Ms, Mm, Ms, Mm, Ms, Mm, Mm, Ms
Ds, Ds, Gll^Fmf, Gll^Fmf, Hhd^Fmf, Ms, Ms, Ms, Hhd^Fmf, Gll^Fmf, Hhd^Fmf, Mm, Ms, Ms, Mm, Mm, Mm, Mm, Ms^Xm, Ms^Xm, Mm, Mm, Mm, Ms^Xm, Ms, Mm, Ha^Fma, Aa^Fma, Hhd^Fmf, Gs, Rb, Rb, Rb, Gs, Rb, Gd, Rb, Hhd^Fmf, Mm, Ms, Mm, Mm, Mm, Mm, Mm, Mm, Mm, Ms, Ms^Xm, Mm, Ms^Xm, Ms^Xm, Ms^Xm, Ms^Xm, Ms^Xm, Mm, Mm, Mm
Ds, Gll, Gll^Fmf, Ha^Fma, Ms, Ms, Mm, Ha^Fma, Aa^Fma, Gll^Fmf, Ha^Fma, Mm, Ms, Mm, Mm, Mm, Mm, Mm, Ms, Ms, Ms, Mm, Ms, Ms, Ms^Xm, Mm, Ms, Ha^Fma, Xu, Hhd^Fmf, Cud, Cud, Cud, Rb, Cud, Cud, Cud, Hhd^Fmf, Xu, Ms, Mm, Ms, Mm, Ms, Mm, Ms, Ms, Ms, Ms^Xm, Ms^Xm, Ms, Mm, Ms^Xm, Ms^Xm, Mm, Mm, Ms^Xm, Ms^Xm
Ds, Gll^Fmf, Gll^Fmf, Hhd^Fmf, Ms, Mm, Hhd^Fmf, Ha^Fma, Gll^Fmf, Ha^Fma, Mm, Ms, Mm, Mm, Ms, Ms, Mm, Mm, Mm, Mm, Ms, Ms, Ms, Ms, Ms^Xm, Mm, Mm, Mm, Mm, Xu, Uu, Uu, Ur^Cov, Ur, Ur^Cov, Uu, Uu, Xu, Mm, Ms, Mm, Mm, Mm, Ms, Ms, Mm, Ms, Ms^Xm, Ms, Mm, Mm, Ms^Xm, Ms, Mm, Ms, Ms, Ms^Xm, Mm
Aa, Gll, Aa^Fma, Hhd^Fmf, Ha^Fma, Mm, Hhd^Fmf, Aa^Fma, Gll^Fmf, Hhd^Fmf, Mm, Ms, Mm, Mm, Ms, Mm, Mm, Mm, Ms^Xm, Ms^Xm, Ms, Ms, Ms, Mm, Ms^Xm, Mm, Mm, Mm, Mm, Xu, Uu, Uu, Ur^Cov, 2 Kud, Ur^Cov, Uu, Uu, Xu, Mm, Ms, Ms, Mm, Mm, Ms^Xm, Mm, Mm, Ms^Xm, Ms^Xm, Mm, Mm, Ms^Xm, Ms^Xm, Ms, Ms, Mm, Mm, Ms, Mm
Aa^Fma, Aa^Fma, Gll^Fmf, Ha^Fma, Aa^Fma, Hhd^Fmf, Gll^Fmf, Aa^Fma, Ha^Fma, Hhd^Fmf, Mm, Ms, Ms, Ms, Mm, Ms, Ms^Xm, Mm, Mm, Ms, Ms^Xm, Mm, Ms^Xm, Ms, Ms, Ms, Ms, Ms, Ms, Xu, Xu, Uu, Cud, Ur, Cud, Uu, Uu, Xu, Mm, Mm, Ms, Ms, Ms, Mm, Mm, Ms, Mm, Ms, Mm, Ms^Xm, Ms, Ms, Mm, Mm, Ms^Xm, Ms^Xm, Ms, Ms^Xm
Aa^Fma, Aa^Fma, Gll^Fmf, Aa^Fma, Ha^Fma, Aa^Fma, Hhd^Fmf, Ha^Fma, Ms, Mm, Mm, Mm, Ms, Mm, Ms^Xm, Ms^Xm, Mm, Ms, Ms, Ms, Ms, Mm, Mm, Mm, Ms, Mm, Ms, Ms, Mm, Mm, Xu, Cud, Qxu, Qxu^Bs|, Qxu, Cud, Xu, Xu, Mm, Mm, Ms^Xm, Ms^Xm, Mm, Ms, Ms, Ms^Xm, Mm, Mm, Ms^Xm, Ms^Xm, Mm, Ms, Ms, Ms, Ms^Xm, Ms, Ms, Mm
Ha^Fma, Ha^Fma, Hhd^Fmf, Ha^Fma, Ms, Ha^Fma, Mm, Mm, Mm, Ms, Mm, Mm, Ms^Xm, Mm, Mm, Mm, Mm, Mm, Ms^Xm, Mm, Ms, Ms, Ms^Xm, Mm, Ms, Mm, Mm, Ms, Mm, Mm, Mm, Xu, Qxu, Qxu^Bs|, Qxu, Cud, Xu, Mm, Ms, Ms^Xm, Ms, Mm, Ms, Ms, Ms, Ms^Xm, Mm, Ms, Mm, Ms, Mm, Ms, Ms, Ms^Xm, Ms, Mm, Ms, Ms^Xm
Mm, Ms, Mm, Ms, Ms, Mm, Mm, Mm, Ms^Xm, Ms, Ms, Ms^Xm, Mm, Mm, Ms, Ms, Mm, Ms^Xm, Mm, Mm, Mm, Mm, Mm, Ms^Xm, Ms^Xm, Ms, Mm, Ms, Ms, Ms, Mm, Xu, Xu, Qxu^Bs|, Xu, Xu, Mm, Mm, Ms^Xm, Ms^Xm, Mm, Mm, Mm, Mm, Ms, Ms, Ms^Xm, Ms^Xm, Mm, Mm, Ms, Ms, Ms^Xm, Ms, Mm, Mm, Ms^Xm, Ms^Xm
Ms, Ms, Mm, Mm, Ms^Xm, Ms, Ms, Ms^Xm, Ms, Ms^Xm, Ms^Xm, Ms^Xm, Ms, Mm, Mm, Mm, Ms^Xm, Ms^Xm, Mm, Mm, Mm, Ms, Mm, Mm, Ms, Ms, Ms^Xm, Ms^Xm, Mm, Ms, Mm, Ms, Ms, Xu, Ms, Mm, Ms, Ms, Ms^Xm, Ms, Ms, Ms, Mm, Mm, Mm, Mm, Ms^Xm, Ms, Ms, Mm, Ms^Xm, Ms^Xm, Ms, Ms, Mm, Ms, Ms^Xm, Mm
Mm, Ms, Ms, Mm, Mm, Mm, Mm, Ms, Mm, Ms^Xm, Mm, Ms, Mm, Mm, Mm, Ms, Ms^Xm, Ms^Xm, Mm, Ms, Ms, Ms, Mm, Mm, Mm, Ms, Mm, Mm, Mm, Ms^Xm, Mm, Mm, Mm, Ms, Mm, Ms, Mm, Ms^Xm, Ms, Ms, Ms, Ms, Mm, Ms^Xm, Mm, Ms^Xm, Ms, Ms^Xm, Ms^Xm, Ms^Xm, Ms, Ms, Mm, Ms^Xm, Ms^Xm, Ms^Xm, Ms^Xm, Mm
