Ur, Uu, Uu, Xu, Xu, Xu, Xu, Xu, Xu, Xu, Xu, Xu, Xu, Xu, Xu, Xu, Xu, Xu, Xu, Xu, Xu, Xu, Xu, Xu, Xu, Xu, Xu, Xu, Xu, Xu, Xu, Xu, Xu, Xu, Xu, Xu, Xu, Xu, Xu, Xu, Xu, Xu, Xu, Xu, Xu, Xu, Xu, Xu, Xu, Xu
Uu, Ur, Ur, Uu, Uu, Xu, Uh, Uh, Uh, Xu, Xu, Xu, Xu, Xu, Xu, Xu, Xu, Xu, Xu, Xu, Xu, Xu, Xu, Xu, Xu, Xu, Xu, Xu, Xu, Xu, Xu, Xu, Xu, Xu, Xu, Xu, Xu, Xu, Xu, Xu, Xu, Xu, Xu, Xu, Xu, Xu, Xu, Xu, Xu, Xu
Xu, Uu, Uu, Ur, Ur, Uu, Ur, Ur, Ur, Tb^Tf, Tb^Tf, Xu, Xu, Xu, Xu, Xu, Xu, Xu, Xu, Xu, Xu, Xu, Xu, Xu, Xu, Xu, Xu, Xu, Xu, Xu, Xu, Xu, Xu, Xu, Xu, Xu, Xu, Xu, Xu, Xu, Xu, Xu, Xu, Xu, Xu, Xu, Xu, Xu, Xu, Xu
Xu, Xu, Xu, Uu, Uu, Ce, Ce, Ce, Ce, Ce, Uu, Xu, Xu, Xu, Xu, Xu, Xu, Xu, Xu, Xu, Xu, Xu, Xu, Xu, Xu, Xu, Xu, Xu, Xu, Xu, Xu, Xu, Xu, Xu, Xu, Xu, Xu, Xu, Xu, Xu, Xu, Xu, Xu, Xu, Xu, Xu, Xu, Xu, Xu, Xu
Xu, Xu, Xu, Uh, Tb^Tf, Ur, Ke, 1 Ke, Ke, Ur, Uu, Xu, Xu, Xu, Xu, Xu, Xu, Xu, Xu, Xu, Xu, Xu, Xu, Xu, Xu, Xu, Xu, Xu, Xu, Xu, Xu, Xu, Xu, Xu, Xu, Xu, Xu, Xu, Xu, Xu, Xu, Xu, Xu, Xu, Xu, Xu, Xu, Xu, Xu, Xu
Xu, Xu, Xu, Uh, Uu, Ce, Ur, Ce^Kov, Ur, Ce, Uu^Vu, Xu, Wwg, Xu, Xu, Xu, Wwg, Xu, Xu, Xu, Xu, Xu, Xu, Xu, Xu, Xu, Xu, Xu, Xu, Xu, Xu, Xu, Xu, Xu, Xu, Xu, Xu, Xu, Xu, Xu, Xu, Xu, Xu, Xu, Xu, Xu, Xu, Xu, Xu, Xu
Wwg, Xu, Wwg, Uu^Vu, Wwf, Uu, Wwf, Ce, Wwf, Uu, Wwf, Wwf, Xu, Wwg, Wwg, Wwg, Xu, Wwg, Wwg, Xu, Xu, Xu, Xu, Xu, Xu, Xu, Xu, Xu, Xu, Xu, Xu, Xu, Xu, Xu, Xu, Xu, Xu, Xu, Xu, Xu, Xu, Xu, Xu, Xu, Xu, Xu, Xu, Xu, Xu, Xu
Xu, Wwg, Xu, Wwg, Tb^Tf, Wwg, Uu, Wwf, Ur, Wwg, Uu, Xu, Xu, Xu, Xu, Xu, Xu, Xu, Xu, Wwg, Wwg, Xu, Xu, Xu, Xu, Xu, Xu, Xu, Xu, Xu, Xu, Xu, Xu, Xu, Xu, Xu, Uh, Xu, Tb^Tf, Xu, Xu, Xu, Xu, Xu, Xu, Xu, Xu, Xu, Xu, Xu
Xu, Xu, Xu, Uh, Tb^Tf, Uu, Tb^Tf, Tb^Tf, Uu, Ur, Ur, Uh, Uh, Xu, Xu, Xu, Xu, Xu, Xu, Xu, Xu, Wwg, Xu, Xu, Xu, Xu, Xu, Xu, Xu, Xu, Xu, Xu, Xu, Xu, Uu^Vu, Tb^Tf, Uu, Tb^Tf, Tb^Tf, Uh, Tb^Tf, Xu, Xu, Xu, Xu, Xu, Xu, Xu, Xu, Xu
Xu, Xu, Xu, Xu, Xu, Xu, Xu, Uh, Xu, Uu, Uu, Ur, Ur, Xu, Xu, Xu, Uh, Xu, Xu, Xu, Xu, Wwg, Xu, Xu, Xu, Xu, Xu, Xu, Xu, Xu, Xu, Xu, Uh, Uh, Tb^Tf, Uu, Cte, Cte, Cte, Tb^Tf, Uu^Vu, Xu, Xu, Xu, Xu, Xu, Xu, Xu, Xu, Xu
Xu, Xu, Xu, Xu, Xu, Xu, Xu, Xu, Xu, Xu, Xu, Uu, Ur, Uu, Cud, Tb^Tf, Uu, Tb^Tf, Tb^Tf, Xu, Xu, Wwg, Wwg, Xu, Xu, Xu, Xu, Xu, Xu, Xu, Xu, Xu, Uh, Xu, Uu, Uu, Cte, 4 Kte, Cte, Uu, Uu, Xu, Xu, Xu, Xu, Xu, Xu, Xu, Xu, Xu
Xu, Xu, Xu, Xu, Xu, Xu, Xu, Xu, Xu, Xu, Xu, Uu, Ur, Ur, Ur, Uu, Ur, Uu, Uu, Uu^Vud, Xu, Xu, Xu, Wwg, Xu, Xu, Xu, Xu, Xu, Xu, Xu, Xu, Xu, Tb^Tf, Xu, Uu, Uu, Cte, Uu, Uu, Xu, Uu, Xu, Xu, Xu, Xu, Xu, Xu, Xu, Xu
Xu, Xu, Xu, Xu, Xu, Xu, Xu, Xu, Xu, Xu, Qxu, Cud, Ur, Uu, Uu, Ur, Cud, Cud, Uu, Uu, Cud, Xu, Uu, Wwg, Xu, Xu, Xu, Xu, Xu, Xu, Xu, Xu, Xu, Uu^Vu, Uu, Uu, Uu, Uu, Uu, Uu, Tb^Tf, Tb^Tf, Xu, Xu, Xu, Xu, Xu, Xu, Uu, Uu
Xu, Xu, Xu, Xu, Xu, Xu, Xu, Xu, Xu, Xu, Qxu, Uu, Ur, Uu, Cud, Cud, Uu, Ur, Ur, Uu, Ur, Ur, Ur, Wwg, Uu, Xu, Xu, Xu, Xu, Xu, Xu, Xu, Xu, Xu, Uh, Xu, Uu^Emf, Uu, Uu, Xu, Tb^Tf, Uh, Xu, Xu, Xu, Xu, Xu, Xu, Ur^Br/, Ur^Br/
Xu, Xu, Xu, Xu, Xu, Xu, Xu, Xu, Xu, Xu, Qxu, Uu, Ur, Ur, Cud, Uu, Uu^Vud, Uu, Uu, Ur, Xu, Uu, Wwg, Wwg^Bsb\, Ur, Uu, Xu, Xu, Xu, Xu, Xu, Xu, Xu, Xu, Xu, Uu^Emf, Uu^Emf, Uu^Emf, Uu, Uu^Vu, Xu, Xu, Xu, Xu, Xu, Xu, Xu, Ur^Br/, Xu, Uu
Xu, Xu, Xu, Xu, Xu, Xu, Xu, Xu, Xu, Xu, Xu, Qxu, Uu, Ur, Cud, Ur, Uu, Uu, Qxu, Qxu, Xu, Xu, Wwg, Xu, Uu, Ur, Cud, Xu, Xu, Xu, Xu, Xu, Xu, Xu, Uu, Uu, Uu, Uu, Xu, Uu, Xu, Xu, Xu, Xu, Xu, Xu, Ur^Br/, Ur^Br|, Ur^Br/, Ur^Br/
Xu, Xu, Xu, Xu, Xu, Xu, Xu, Xu, Xu, Xu, Xu, Xu, Xu, Uu, Uu, Ur, Uu, Tb^Tf, Qxu, Wwg, Wwf, Xu, Wwg, Xu, Uu, Ur, Uu, Xu, Xu, Xu, Xu, Xu, Xu, Xu, Uu, Xu, Xu, Uu, Xu, Uu, Uu, Xu, Xu, Xu, Ur^Br/, Ur^Br/, Tb^Tf, Xu, Ur^Br|, Uu
Xu, Xu, Xu, Xu, Xu, Xu, Xu, Xu, Xu, Xu, Xu, Xu, Xu, Xu, Cud, Ur, Uu, Tb^Tf, Xu, Xu, Wwf, Wwg, Xu, Xu, Uu^Vud, Ur, Ur, Uu, Uu, Xu, Xu, Xu, Xu, Xu, Uu, Xu, Xu, Uu, Xu, Xu, Uu, Xu, Ur^Br/, Ur^Br/, Tb^Tf, Xu, Ur^Br/, Ur^Br/, Xu, Xu
Xu, Xu, Xu, Xu, Xu, Xu, Xu, Xu, Xu, Xu, Xu, Xu, Xu, Xu, Uh, Ur, Xu, Xu, Xu, Xu, Wwg, Wwg, Wwg, Xu, Xu, Uu, Qxu, Ur, Ur, Uu, Uu, Xu, Tb^Tf, Uu, Xu, Xu, Xu, Uu, Xu, Xu, Xu, Ur^Br|, Tb^Tf, Xu, Ur^Br/, Ur^Br/, Uu, Uu, Xu, Xu
Xu, Xu, Xu, Xu, Xu, Xu, Xu, Xu, Xu, Xu, Xu, Xu, Xu, Xu, Ur, Ur, Xu, Xu, Wwg, Wwg, Wwf, Xu, Wwg, Xu, Tb^Tf, Uu, Uu, Qxu, Qxu, Ur, Ur, Cud, Uu, Uu, Uu, Xu, Uu, Uu, Xu, Xu, Uu, Ur^Br|, Ur^Br/, Ur^Br/, Uu, Uu, Xu, Xu, Xu, Xu
Xu, Xu, Xu, Xu, Xu, Xu, Xu, Xu, Xu, Xu, Xu, Xu, Xu, Xu, Ur, Tb^Tf, Wwg, Wwg, Xu, Xu, Wwf, Xu, Xu, Xu, Uh, Tb^Tf, Uu, Qxu, Uu, Uu, Ur, Uu, Uh, Uh, Uu, Uu, Uu, Uu, Uu, Uu, Ur^Br/, Ur^Br/, Uu, Uu, Xu, Xu, Xu, Xu, Xu, Xu
Xu, Xu, Xu, Xu, Xu, Xu, Xu, Xu, Xu, Xu, Xu, Xu, Xu, Xu, Ur, Tb^Tf, Wwg, Xu, Xu, Xu, Xu, Wwg, Qxu, Xu, Xu, Xu, Uu, Uu, Uu, Xu, Ur, Uu, Uu, Uh, Uu, Xu, Uu, Uu, Xu, Ur^Br/, Tb^Tf, Tb^Tf, Xu, Xu, Xu, Xu, Xu, Xu, Xu, Xu
Xu, Xu, Xu, Xu, Xu, Xu, Xu, Xu, Xu, Xu, Xu, Xu, Xu, Xu, Uh, Ur, Wwf, Cud, Qxu, Xu, Xu, Qxu, Uu, Xu, Cud, Tb^Tf, Uu, Uu, Ur, Ur, Uu, Uu, Xu, Uu, Uu, Uu, Xu, Uu, Ur^Br/, Ur^Br|, Tb^Tf, Uh, Xu, Xu, Xu, Xu, Xu, Xu, Xu, Xu
Xu, Xu, Xu, Xu, Xu, Xu, Xu, Xu, Xu, Xu, Xu, Xu, Xu, Xu, Uh, Ur, Wwf, Cud, Cud, Xu, Uh, Uu, Uu, Tb^Tf, Cud, Cud, Ur, Ur, Xu, Uu, Uu, Xu, Xu, Cud, Uu, Uu, Ur^Br/, Ur^Br/, Uu, Uu, Xu, Xu, Xu, Xu, Xu, Xu, Xu, Xu, Xu, Xu
Xu, Xu, Xu, Xu, Xu, Xu, Xu, Xu, Xu, Xu, Xu, Xu, Xu, Xu, Xu, Ur, Ur, Wwf, Wwg, Uh, Uu, Uu, Uu, Uu, Uu, Uu, Ur, Uu, Uu^Vud, Xu, Uu, Uu, Uu, Xu, Xu, Ur^Br/, Uu, Uu, Xu, Xu, Xu, Xu, Xu, Xu, Xu, Xu, Xu, Xu, Xu, Xu
Xu, Xu, Xu, Xu, Xu, Xu, Xu, Xu, Xu, Uh, Tb^Tf, Xu, Uu, Xu, Uu, Uu, Uu, Ur, Uu, Wwg, Wwf, Uu, Uu^Vud, Uu, Uu, Uu, Ur, Uu, Uu, Xu, Uu, Xu, Uu, Xu, Uu, Ur^Br|, Cud, Xu, Xu, Xu, Xu, Xu, Xu, Xu, Xu, Xu, Xu, Xu, Xu, Xu
Xu, Xu, Xu, Xu, Xu, Xu, Xu, Xu, Qxu, Uh, Tb^Tf, Uu, Uu, Uu, Uu, Uu, Uu, Ur, Uu, Uu, Uu, Wwg, Wwg, Xu, Xu, Uu, Uu, Ur, Uu, Uu, Uu, Uu, Xu, Xu, Ur^Br/, Ur^Br|, Xu, Xu, Xu, Xu, Xu, Xu, Xu, Xu, Xu, Xu, Xu, Xu, Xu, Xu
Uh, Xu, Tb^Tf, Xu, Uu^Vud, Xu, Cud, Qxu, Uu, Tb^Tf, Uu, Uu, Xu, Xu, Xu, Uu, Uu, Ur, Cud, Xu, Xu, Uu, Uh, Wwg, Wwg, Xu, Wwg, Ur, Uu, Xu, Uu, Cud, Ur^Br/, Ur^Br/, Uu, Uu, Uu, Qxu, Qxu, Uu^Vu, Uu, Xu, Uu^Vu, Xu, Xu, Xu, Xu, Xu, Xu, Xu
Ur^Br\, Tb^Tf, Ur^Br/, Ur^Br\, Ur^Br\, Uu, Ur^Br/, Uu, Uu, Uu, Uu, Xu, Xu, Xu, Xu, Xu, Qxu, Ur, Ur, Xu, Uu, Uu, Qxu, Wwf, Xu, Wwg, Uu, Wwf^Bsb|, Wwf, Xu, Ur, Ur, Qxu^Br|, Uu, Xu, Uu, Wwg, Wwg, Uu, Xu, Uu, Tb^Tf, Tb^Tf, Xu, Xu, Xu, Xu, Xu, Xu, Xu
Uu, Ur^Br/, Uh, Uh, Xu, Ur^Br/, Uu, Ur^Br\, Ur^Br\, Xu, Uu, Cud, Xu, Xu, Xu, Xu, Xu, Uu, Uu, Ur, Ur, Qxu, Qxu, Xu, Uu, Uu, Xu, Ur, Wwf, Ur, Xu, Qxu, Wwf^Br|, Xu, Wog, Wwg, Xu, Uu, Uu, Uu, Uu, Uu, Qxu, Xu, Xu, Xu, Xu, Xu, Xu, Xu
Xu, Xu, Xu, Xu, Xu, Xu, Cud, Uu, Uu, Ur^Br\, Ur^Br\, Uu, Uu, Xu, Wwg^Br\, Xu, Wwg, Xu, Uu, Uu, Ur, Uu^Vu, Uu, Uu, Uu, Xu, Uu, Ur, Uu^Vud, Wwg, Wwg, Xu, Wwg^Br/, Wwg, Wog, Xu, Xu, Xu, Tb^Tf, Uu, Cfr, Cfr, Cfr, Qxu, Xu, Xu, Xu, Xu, Xu, Xu
Xu, Xu, Xu, Xu, Xu, Xu, Xu, Qxu, Qxu, Uu, Uu, Ur^Br\, Uu^Br/, Qxu^Br/, Qxu, Wwg^Br\, Wwg^Br\, Xu, Qxu, Uu, Uu, Ur, Cud, Xu, Tb^Tf, Uu, Ur, Ur, Xu, Xu, Xu, Wwg^Br|, Xu, Xu, Wwf, Xu, Xu, Uu^Vu, Tb^Tf, Uu, Cfr, 5 Kfr, Cfr, Qxu, Wwg, Xu, Xu, Xu, Xu, Xu
Xu, Xu, Xu, Xu, Xu, Xu, Xu, Xu, Qxu, Uu, Uu, Xu, Uu, Uu, Cud, Xu, Xu, Wwg^Br\, Wwg^Br\, Qxu, Uu, Ur, Ur, Ur, Ur, Ur, Ur, Cud, Xu, Xu, Uu^Vud, Ur^Br|, Qxu, Xu, Xu, Wwf, Wwg, Xu, Xu, Uu^Vu, Qxu, Cfr, Qxu, Qxu, Wwg, Xu, Xu, Xu, Xu, Xu
Xu, Xu, Xu, Xu, Xu, Xu, Xu, Xu, Xu, Uu, Uu, Uu, Uu, Uu, Uu, Xu, Qxu, Xu, Qxu, Qxu^Br\, Ur^Br\, Uu, Xu, Ur, Tb^Tf, Tb^Tf, Tb^Tf, Ur, Ur, Xu, Xu, Ur^Br|, Ur^Br\, Qxu, Qxu, Xu, Wwg, Wwg, Wwg, Xu, Xu, Qxu, Xu, Xu, Wwg, Wwg, Xu, Xu, Xu, Xu
Xu, Xu, Xu, Xu, Xu, Xu, Qlf^Ii, Xu, Uu^Ii, Uu^Ii, Uu^Ii, Uu^Vu, Uh, Uu, Uu, Uu, Xu, Xu, Ur^Br/, Ur^Br/, Uh, Ur^Br|, Xu, Ur, Tb^Tf, Uh, Qxu, Uu, Uu, Ur, Uu, Xu, Ur^Br|, Uu, Qxu, Wwg, Wwg, Xu, Xu, Wwg, Wwg, Xu, Wwg, Wwg, Xu, Xu, Xu, Xu, Xu, Xu
Xu, Xu, Xu, Xu, Xu, Qlf^Ii, Qlf^Ii, Qlf^Ii, Uu^Ii, Qlf^Ii, Uu^Ii, Uh, Tb^Tf, Uu, Uu, Xu, Ur^Br/, Ur^Br/, Uu, Uu, Uu, Ur^Br|, Ur^Br\, Ur, Qxu^Bs\, Qxu, Qxu, Qxu, Cud, Ur, Uu, Uu, Ur^Br|, Xu, Qxu, Qxu, Qxu, Qxu, Uu, Xu, Xu, Wwg, Xu, Xu, Xu, Xu, Xu, Xu, Xu, Xu
Xu, Xu, Xu, Xu, Xu, Xu, Uu^Ii, Uu^Ii, Uu^Ii, Qlf^Ii, Uu^Ii, Uu, Uu, Uu, Uu, Ur^Br/, Uu, Uu, Xu, Uu, Uu, Qxu, Qxu, Ur^Br\, Qxu^Br\, Qxu^Bs\, Ur, Uu, Uu, Ur, Uu, Uu, Ur^Br\, Xu, Xu, Qxu, Xu, Uu, Uu, Uu^Vud, Xu, Xu, Xu, Xu, Xu, Xu, Xu, Xu, Xu, Xu
Xu, Xu, Xu, Xu, Xu, Xu, Qlf^Ii, Qlf^Ii, Uu^Ii, Uu^Ii, Ce, Uu^Ii, Uu, Xu, Uu, Ur^Br|, Uu, Uu^Vud, Uu, Uu, Xu, Uu, Qxu, Uu, Qxu, Qxu^Br\, Ur^Br|, Ur, Ur, Ur, Ur, Ur, Ur, Ur^Br\, Ur^Br\, Xu, Ur^Br/, Ur^Br/, Ur^Br\, Uu, Uu, Xu, Xu, Xu, Xu, Xu, Xu, Xu, Xu, Xu
Xu, Xu, Xu, Xu, Ql^Ii, Xu, Uu^Ii, Uu^Ii, Uu, Uu, Ce, Ce^Ii, Ce^Ii, Uu, Uu, Ur^Br|, Uu, Uu, Xu, Xu, Xu, Uu, Qxu, Uu, Uu^Vud, Uu, Ur^Br|, Ur, Cud, Cud, Cud, Cud, Cud, Ur, Uu, Ur^Br\, Uu, Xu, Uu, Ur^Br|, Uu, Xu, Xu, Xu, Xu, Xu, Xu, Xu, Xu, Xu
Xu, Xu, Ql^Ii, Ql^Ii, Uu, Uu, Uu, Uu^Vu, Uu^Ii, Ce, Ce^Ii, 2 Ke^Ii, Ce^Ii, Ce, Uu, Ur^Br|, Xu, Xu, Xu, Xu, Xu, Uu, Xu, Uu, Uu, Uu, Ur^Br|, Ur, Cud, Uu^Vud, Cud, Uu^Vud, Cud, Ur, Ur, Uu, Xu, Xu, Xu, Ur^Br|, Xu, Tb^Tf, Xu, Xu, Xu, Xu, Xu, Xu, Xu, Xu
Ql^Ii, Ql^Ii, Uu, Uu, Uu, Uu, Uu, Uu, Uu^Ii, Uu^Ii, Uu^Ii, Ce, Ce^Ii, Uu, Uu, Ur^Br|, Xu, Xu, Xu, Xu, Xu, Uu, Uu, Qxu, Qxu, Uu, Ur^Br|, Cud, Uu^Vud, Cud, 3 Kud, Cud, Uu^Vud, Cud, Xu, Uu^Vud, Xu, Xu, Xu, Ur^Br\, Ur^Br|, Tb^Tf, Tb^Tf, Xu, Xu, Xu, Xu, Xu, Xu, Xu
Uu, Uu, Uu, Uu, Uu, Uu, Uu, Uu^Ii, Qlf^Ii, Uu^Ii, Qlf^Ii, Uu^Ii, Uu^Ii, Tb^Tfi, Tb^Tf, Ur^Br|, Xu, Xu, Xu, Xu, Xu, Xu, Tb^Tf, Uu, Xu, Cud, Ur^Br|, Cud, Cud, Cud, Cud, Cud, Cud, Cud, Qxu, Xu, Xu, Xu, Xu, Xu, Ur^Br\, Xu, Tb^Tf, Xu, Xu, Xu, Xu, Xu, Xu, Xu
Uu, Uu, Uu, Uu, Uu, Uu, Uu, Uu^Ii, Uu^Ii, Qlf^Ii, Uu^Ii, Qlf^Ii, Uu^Ii, Uh, Uu^Vu, Ur^Br|, Xu, Xu, Xu, Xu, Xu, Xu, Uh, Tb^Tf, Tb^Tf, Uu, Ur^Br|, Ur, Cud, Uu^Vud, Cud, Uu^Vud, Cud, Qxu, Xu, Xu, Xu, Xu, Xu, Xu, Xu, Ur^Br|, Xu, Tb^Tf, Xu, Xu, Xu, Xu, Xu, Xu
Uu, Uu, Uu, Uu, Uu, Uu, Ql^Ii, Ql^Ii, Xu, Uu^Ii, Xu, Uu^Ii, Tb^Tfi, Tb^Tfi, Uu, Ur^Br|, Xu, Xu, Xu, Xu, Xu, Xu, Xu, Uh, Xu, Uu, Ur^Br|, Ur, Ur, Cud, Qxu, Mm, Xu, Qxu, Xu, Xu, Xu, Xu, Xu, Xu, Xu, Ur^Br|, Ur^Br\, Uu, Xu, Xu, Xu, Xu, Xu, Xu
Uu, Uu, Uu, Uu, Ql^Ii, Ql^Ii, Xu, Ql^Ii, Xu, Xu, Xu, Xu, Xu, Uu, Uu, Ur^Br|, Xu, Xu, Xu, Xu, Xu, Xu, Xu, Xu, Xu, Xu, Ur^Br|, Ur, Uh, Xu, Xu, Xu, Xu, Xu, Xu, Xu, Xu, Xu, Xu, Xu, Xu, Uu, Ur^Br|, Uu, Uh, Xu, Xu, Xu, Xu, Xu
Uu, Uu, Xuc, Xuc, Ql^Ii, Ql^Ii, Xu, Ql^Ii, Xu, Xu, Xu, Xu, Xu, Xu, Xu, Ur^Br|, Xu, Xu, Xu, Xu, Xu, Xu, Xu, Xu, Xu, Xu, Ur^Br|, Ur, Uh, Uh, Xu, Xu, Xu, Xu, Xu, Xu, Xu, Xu, Xu, Xu, Uh, Uu, Ur^Br|, Uu, Uh, Uh, Xu, Xu, Xu, Xu
Uu, Ql^Ii, Ql^Ii, Ql^Ii, Xu, Xu, Ql^Ii, Ql^Ii, Xu, Xu, Xu, Xu, Xu, Xu, Xu, Ur^Br|, Xu, Xu, Xu, Xu, Xu, Xu, Xu, Xu, Xu, Xu, Ur^Br|, Ur, Uh, Uh, Xu, Xu, Xu, Xu, Xu, Xu, Xu, Xu, Xu, Xu, Uh, Uu, Ur^Br|, Uu, Uh, Uh, Xu, Xu, Xu, Xu
