Ur, Uu, Uu, Xu, Xu, Xu, Xu, Xu, Xu, Xu, Xu, Xu, Xu, Xu, Xu, Xu, Xu, Xu, Xu, Xu, Xu, Xu, Xu, Xu, Xu, Xu, Xu, Xu, Xu, Xu, Xu, Xu, Xu, Xu, Xu, Xu, Xu, Xu, Xu, Xu, Xu, Xu, Xu, Xu, Xu, Xu, Xu, Xu, Xu, Xu
Uu, Ur, Ur, Uu, Uu, Xu, Uh, Uh, Uh, Xu, Xu, Xu, Xu, Xu, Xu, Xu, Xu, Xu, Xu, Xu, Xu, Xu, Xu, Xu, Xu, Xu, Xu, Xu, Xu, Xu, Xu, Xu, Xu, Xu, Xu, Xu, Xu, Xu, Xu, Xu, Xu, Xu, Xu, Xu, Xu, Xu, Xu, Xu, Xu, Xu
Xuc, Uu, Uu, Ur, Ur, Uu, Ur, Ur, Ur, Uu^Uf, Uu^Uf, Xu, Xu, Xu, Xu, Xu, Xu, Xu, Xu, Xu, Xu, Xu, Xu, Xu, Xu, Xu, Xu, Xu, Xu, Xu, Xu, Xu, Xu, Xu, Xu, Xu, Xu, Xu, Xu, Xu, Xu, Xu, Xu, Xu, Xu, Xu, Xu, Xu, Xu, Xu
Xuc, Xuc, Xuc, Uu, Uu, Ce, Ce, Ce, Ce, Ce, Uu, Xu, Xu, Xu, Xu, Xu, Xu, Xu, Xu, Xu, Xu, Xu, Xu, Xu, Xu, Xu, Xu, Xu, Xu, Xu, Xu, Xu, Xu, Xu, Xu, Xu, Xu, Xu, Xu, Xu, Xu, Xu, Xu, Xu, Xu, Xu, Xu, Xu, Xu, Xu
Xuc, Xuc, Xuc, Uh, Uu^Uf, Ur, Ke, 1 Ke, Ke, Ur, Uu, Xu, Xu, Xu, Xu, Xu, Xu, Xu, Xu, Xu, Xu, Xu, Xu, Xu, Xu, Xu, Xu, Xu, Xu, Xu, Xu, Xu, Xu, Xu, Xu, Xu, Xu, Xu, Xu, Xu, Xu, Xu, Xu, Xu, Xu, Xu, Xu, Xu, Xu, Xu
Xuc, Xuc, Xuc, Uh, Uu, Ce, Ur, Ce^Kov, Ur, Ce, Uu^Vu, Xu, Wwg, Xu, Xu, Xu, Wwg, Xu, Xu, Xu, Xu, Xu, Xu, Xu, Xu, Xu, Xu, Xu, Xu, Xu, Xu, Xu, Xu, Xu, Xu, Xu, Xu, Xu, Xu, Xu, Xu, Xu, Xu, Xu, Xu, Xu, Xu, Xu, Xu, Xu
Wwg, Xuc, Wwg, Uu^Vu, Wwf, Uu, Wwf, Ce, Wwf, Uu, Wwf, Wwf, Xuc, Wwg, Wwg, Wwg, Xuc, Wwg, Wwg, Xu, Xu, Xu, Xu, Xu, Xu, Xu, Xu, Xu, Xu, Xu, Xu, Xu, Xu, Xu, Xu, Xu, Xu, Xu, Xu, Xu, Xu, Xu, Xu, Xu, Xu, Xu, Xu, Xu, Xu, Xu
Xu, Wwg, Xu, Wwg, Uu^Uf, Wwg, Uu, Wwf, Ur, Wwg, Uu, Xuc, Xuc, Xuc, Xuc, Xuc, Xuc, Xuc, Xuc, Wwg, Wwg, Xu, Xu, Xu, Xu, Xu, Xu, Xu, Xu, Xu, Xu, Xu, Xu, Xu, Xu, Xu, Uh, Xu, Uu^Uf, Xu, Xu, Xu, Xu, Xu, Xu, Xu, Xu, Xu, Xu, Xu
Xu, Xu, Xu, Uh, Uu^Uf, Uu, Uu^Uf, Uu^Uf, Uu, Ur, Ur, Uh, Uh, Xuc, Xuc, Xuc, Xuc, Xuc, Xuc, Xuc, Xuc, Wwg, Xu, Xu, Xu, Xu, Xu, Xu, Xu, Xu, Xu, Xu, Xu, Xu, Uu^Vu, Uu^Uf, Uu, Uu^Uf, Uu^Uf, Uh, Uu^Uf, Xu, Xu, Xu, Xu, Xu, Xu, Xu, Xu, Xu
Xu, Xu, Xu, Xu, Xu, Xu, Xu, Uh, Xu, Uu, Uu, Ur, Ur, Xuc, Xuc, Xuc, Uh, Xuc, Xuc, Xuc, Xuc, Wwg, Xu, Xu, Xu, Xu, Xu, Xu, Xu, Xu, Xu, Xu, Uh, Uh, Uu^Uf, Uu, Co, Co, Co, Uu^Uf, Uu^Vu, Xu, Xu, Xu, Xu, Xu, Xu, Xu, Xu, Xu
Xu, Xu, Xu, Xu, Xu, Xu, Xu, Xu, Xu, Xu, Xu, Uu, Ur, Uu, Cud, Uu^Uf, Uu, Uu^Uf, Uu^Uf, Xuc, Xuc, Wwg, Wwg, Xu, Xu, Xu, Xu, Xu, Xu, Xu, Xu, Xu, Uh, Xuc, Uu, Uu, Co, 4 Ko, Co, Uu, Uu, Xu, Xu, Xu, Xu, Xu, Xu, Xu, Xu, Xu
Xu, Xu, Xu, Xu, Xu, Xu, Xu, Xu, Xu, Xu, Xu, Uu, Ur, Ur, Ur, Uu, Ur, Uu, Uu, Uu^Vud, Xuc, Xuc, Xuc, Wwg, Xu, Xu, Xu, Xu, Xu, Xu, Xu, Xu, Xu, Uu^Uf, Xuc, Uu, Uu, Co, Uu, Uu, Xuc, Uu, Xu, Xu, Xu, Xu, Xu, Xu, Xu, Xu
Xu, Xu, Xu, Xu, Xu, Xu, Xu, Xu, Xu, Xu, Qxu, Cud, Ur, Uu, Uu, Ur, Cud, Cud, Uu, Uu, Cud, Xuc, Uu, Wwg, Xu, Xu, Xu, Xu, Xu, Xu, Xu, Xu, Xu, Uu^Vu, Uu, Uu, Uu, Uu, Uu, Uu, Uu^Uf, Uu^Uf, Xu, Xu, Xu, Xu, Xu, Xu, Uu, Uu
Xu, Xu, Xu, Xu, Xu, Xu, Xu, Xu, Xu, Xu, Qxu, Uu, Ur, Uu, Cud, Cud, Uu, Ur, Ur, Uu, Ur, Ur, Ur, Wwg, Uu, Xu, Xu, Xu, Xu, Xu, Xu, Xu, Xu, Xu, Uh, Xuc, Uu^Emf, Uu, Uu, Xuc, Uu^Uf, Uh, Xu, Xu, Xu, Xu, Xu, Xu, Ur^Br/, Ur^Br/
Xu, Xu, Xu, Xu, Xu, Xu, Xu, Xu, Xu, Xu, Qxu, Uu, Ur, Ur, Cud, Uu, Uu^Vud, Uu, Uu, Ur, Xuc, Uu, Wwg, Wwg^Bsb\, Ur, Uu, Xu, Xu, Xu, Xu, Xu, Xu, Xu, Xu, Xu, Uu^Emf, Uu^Emf, Uu^Emf, Uu, Uu^Vu, Xu, Xu, Xu, Xu, Xu, Xu, Xu, Ur^Br/, Xuc, Uu
Xu, Xu, Xu, Xu, Xu, Xu, Xu, Xu, Xu, Xu, Xu, Qxu, Uu, Ur, Cud, Ur, Uu, Uu, Qxu, Qxu, Xuc, Xuc, Wwg, Xuc, Uu, Ur, Cud, Xu, Xu, Xu, Xu, Xu, Xu, Xu, Uu, Uu, Uu, Uu, Xuc, Uu, Xu, Xu, Xu, Xu, Xu, Xu, Ur^Br/, Ur^Br|, Ur^Br/, Ur^Br/
Xu, Xu, Xu, Xu, Xu, Xu, Xu, Xu, Xu, Xu, Xu, Xu, Xu, Uu, Uu, Ur, Uu, Uu^Uf, Qxu, Wwg, Wwf, Xuc, Wwg, Xuc, Uu, Ur, Uu, Xu, Xu, Xu, Xu, Xu, Xu, Xu, Uu, Xuc, Xuc, Uu, Xuc, Uu, Uu, Xu, Xu, Xu, Ur^Br/, Ur^Br/, Uu^Uf, Xuc, Ur^Br|, Uu
Xu, Xu, Xu, Xu, Xu, Xu, Xu, Xu, Xu, Xu, Xu, Xu, Xu, Xu, Cud, Ur, Uu, Uu^Uf, Xuc, Xuc, Wwf, Wwg, Xuc, Xuc, Uu^Vud, Ur, Ur, Uu, Uu, Xu, Xu, Xu, Xu, Xu, Uu, Xuc, Xuc, Uu, Xuc, Xuc, Uu, Xu, Ur^Br/, Ur^Br/, Uu^Uf, Xuc, Ur^Br/, Ur^Br/, Xu, Xu
Xu, Xu, Xu, Xu, Xu, Xu, Xu, Xu, Xu, Xu, Xu, Xu, Xu, Xu, Uh, Ur, Xuc, Xuc, Xuc, Xuc, Wwg, Wwg, Wwg, Xuc, Xuc, Uu, Qxu, Ur, Ur, Uu, Uu, Xu, Uu^Uf, Uu, Xuc, Xuc, Xuc, Uu, Xuc, Xuc, Xuc, Ur^Br|, Uu^Uf, Xuc, Ur^Br/, Ur^Br/, Uu, Uu, Xu, Xu
Xu, Xu, Xu, Xu, Xu, Xu, Xu, Xu, Xu, Xu, Xu, Xu, Xu, Xu, Ur, Ur, Xuc, Xuc, Wwg, Wwg, Wwf, Xuc, Wwg, Xuc, Uu^Uf, Uu, Uu, Qxu, Qxu, Ur, Ur, Cud, Uu, Uu, Uu, Xuc, Uu, Uu, Xuc, Xuc, Uu, Ur^Br|, Ur^Br/, Ur^Br/, Uu, Uu, Xu, Xu, Xu, Xu
Xu, Xu, Xu, Xu, Xu, Xu, Xu, Xu, Xu, Xu, Xu, Xu, Xu, Xu, Ur, Uu^Uf, Wwg, Wwg, Xuc, Xuc, Wwf, Xuc, Xuc, Xuc, Uh, Uu^Uf, Uu, Qxu, Uu, Uu, Ur, Uu, Uh, Uh, Uu, Uu, Uu, Uu, Uu, Uu, Ur^Br/, Ur^Br/, Uu, Uu, Xu, Xu, Xu, Xu, Xu, Xu
Xu, Xu, Xu, Xu, Xu, Xu, Xu, Xu, Xu, Xu, Xu, Xu, Xu, Xu, Ur, Uu^Uf, Wwg, Xuc, Xuc, Xuc, Xuc, Wwg, Qxu, Xuc, Xuc, Xuc, Uu, Uu, Uu, Xuc, Ur, Uu, Uu, Uh, Uu, Xuc, Uu, Uu, Xuc, Ur^Br/, Uu^Uf, Uu^Uf, Xu, Xu, Xu, Xu, Xu, Xu, Xu, Xu
Xu, Xu, Xu, Xu, Xu, Xu, Xu, Xu, Xu, Xu, Xu, Xu, Xu, Xu, Uh, Ur, Wwf, Cud, Qxu, Xuc, Xuc, Qxu, Uu, Xuc, Cud, Uu^Uf, Uu, Uu, Ur, Ur, Uu, Uu, Xuc, Uu, Uu, Uu, Xuc, Uu, Ur^Br/, Ur^Br|, Uu^Uf, Uh, Xu, Xu, Xu, Xu, Xu, Xu, Xu, Xu
Xu, Xu, Xu, Xu, Xu, Xu, Xu, Xu, Xu, Xu, Xu, Xu, Xu, Xu, Uh, Ur, Wwf, Cud, Cud, Xuc, Uh, Uu, Uu, Uu^Uf, Cud, Cud, Ur, Ur, Xuc, Uu, Uu, Xuc, Xuc, Cud, Uu, Uu, Ur^Br/, Ur^Br/, Uu, Uu, Xu, Xu, Xu, Xu, Xu, Xu, Xu, Xu, Xu, Xu
Xu, Xu, Xu, Xu, Xu, Xu, Xu, Xu, Xu, Xu, Xu, Xu, Xu, Xu, Xu, Ur, Ur, Wwf, Wwg, Uh, Uu, Uu, Uu, Uu, Uu, Uu, Ur, Uu, Uu^Vud, Xuc, Uu, Uu, Uu, Xuc, Xuc, Ur^Br/, Uu, Uu, Xu, Xu, Xu, Xu, Xu, Xu, Xu, Xu, Xu, Xu, Xu, Xu
Xu, Xu, Xu, Xu, Xu, Xu, Xu, Xu, Xu, Uh, Uu^Uf, Xu, Uu, Xu, Uu, Uu, Uu, Ur, Uu, Wwg, Wwf, Uu, Uu^Vud, Uu, Uu, Uu, Ur, Uu, Uu, Xuc, Uu, Xuc, Uu, Xuc, Uu, Ur^Br|, Cud, Xu, Xu, Xu, Xu, Xu, Xu, Xu, Xu, Xu, Xu, Xu, Xu, Xu
Xu, Xu, Xu, Xu, Xu, Xu, Xu, Xu, Qxu, Uh, Uu^Uf, Uu, Uu, Uu, Uu, Uu, Uu, Ur, Uu, Uu, Uu, Wwg, Wwg, Xuc, Xuc, Uu, Uu, Ur, Uu, Uu, Uu, Uu, Xuc, Xuc, Ur^Br/, Ur^Br|, Xu, Xu, Xu, Xu, Xu, Xu, Xu, Xu, Xu, Xu, Xu, Xu, Xu, Xu
Uh, Xu, Uu^Uf, Xu, Uu^Vud, Xu, Cud, Qxu, Uu, Uu^Uf, Uu, Uu, Xuc, Xuc, Xuc, Uu, Uu, Ur, Cud, Xuc, Xuc, Uu, Uh, Wwg, Wwg, Xuc, Wwg, Ur, Uu, Xuc, Uu, Cud, Ur^Br/, Ur^Br/, Uu, Uu, Uu, Qxu, Qxu, Uu^Vu, Uu, Xu, Uu^Vu, Xu, Xu, Xu, Xu, Xu, Xu, Xu
Ur^Br\, Uu^Uf, Ur^Br/, Ur^Br\, Ur^Br\, Uu, Ur^Br/, Uu, Uu, Uu, Uu, Xuc, Xuc, Xuc, Xuc, Xuc, Qxu, Ur, Ur, Xuc, Uu, Uu, Qxu, Wwf, Xuc, Wwg, Uu, Wwf^Bsb|, Wwf, Xuc, Ur, Ur, Qxu^Br|, Uu, Xuc, Uu, Wwg, Wwg, Uu, Xuc, Uu, Uu^Uf, Uu^Uf, Xu, Xu, Xu, Xu, Xu, Xu, Xu
Uu, Ur^Br/, Uh, Uh, Xu, Ur^Br/, Uu, Ur^Br\, Ur^Br\, Xuc, Uu, Cud, Xuc, Xuc, Xuc, Xuc, Xuc, Uu, Uu, Ur, Ur, Qxu, Qxu, Xuc, Uu, Uu, Xuc, Ur, Wwf, Ur, Xuc, Qxu, Wwf^Br|, Xuc, Wog, Wwg, Xuc, Uu, Uu, Uu, Uu, Uu, Qxu, Xu, Xu, Xu, Xu, Xu, Xu, Xu
Xu, Xu, Xu, Xu, Xu, Xu, Cud, Uu, Uu, Ur^Br\, Ur^Br\, Uu, Uu, Xuc, Wwg^Br\, Xuc, Wwg, Xuc, Uu, Uu, Ur, Uu^Vu, Uu, Uu, Uu, Xuc, Uu, Ur, Uu^Vud, Wwg, Wwg, Xuc, Wwg^Br/, Wwg, Wog, Xuc, Xuc, Xuc, Uu^Uf, Uu, Cud, Cud, Cud, Qxu, Xu, Xu, Xu, Xu, Xu, Xu
Xu, Xu, Xu, Xu, Xu, Xu, Xu, Qxu, Qxu, Uu, Uu, Ur^Br\, Uu^Br/, Qxu^Br/, Qxu, Wwg^Br\, Wwg^Br\, Xuc, Qxu, Uu, Uu, Ur, Cud, Xuc, Uu^Uf, Uu, Ur, Ur, Xuc, Xuc, Xuc, Wwg^Br|, Xuc, Xuc, Wwf, Xuc, Xuc, Uu^Vu, Uu^Uf, Uu, Cud, 5 Kud, Cud, Qxu, Wwg, Xu, Xu, Xu, Xu, Xu
Xu, Xu, Xu, Xu, Xu, Xu, Xu, Xu, Qxu, Uu, Uu, Xuc, Uu, Uu, Cud, Xuc, Xuc, Wwg^Br\, Wwg^Br\, Qxu, Uu, Ur, Ur, Ur, Ur, Ur, Ur, Cud, Xuc, Xuc, Uu^Vud, Ur^Br|, Qxu, Xuc, Xuc, Wwf, Wwg, Xuc, Xuc, Uu^Vu, Qxu, Cud, Qxu, Qxu, Wwg, Xu, Xu, Xu, Xu, Xu
Xu, Xu, Xu, Xu, Xu, Xu, Xu, Xu, Xu, Uu, Uu, Uu, Uu, Uu, Uu, Xuc, Qxu, Xuc, Qxu, Qxu^Br\, Ur^Br\, Uu, Xuc, Ur, Uu^Uf, Uu^Uf, Uu^Uf, Ur, Ur, Xuc, Xuc, Ur^Br|, Ur^Br\, Qxu, Qxu, Xuc, Wwg, Wwg, Wwg, Xuc, Xuc, Qxu, Xuc, Xuc, Wwg, Wwg, Xu, Xu, Xu, Xu
Xu, Xu, Xu, Xu, Xu, Xu, Qlf^Ii, Xu, Uu^Ii, Uu^Ii, Uu^Ii, Uu^Vu, Uh, Uu, Uu, Uu, Xuc, Xuc, Ur^Br/, Ur^Br/, Uh, Ur^Br|, Xuc, Ur, Uu^Uf, Uh, Qxu, Uu, Uu, Ur, Uu, Xuc, Ur^Br|, Uu, Qxu, Wwg, Wwg, Xu, Xu, Wwg, Wwg, Xuc, Wwg, Wwg, Xu, Xu, Xu, Xu, Xu, Xu
Xu, Xu, Xu, Xu, Xu, Qlf^Ii, Qlf^Ii, Qlf^Ii, Uu^Ii, Qlf^Ii, Uu^Ii, Uh, Uu^Uf, Uu, Uu, Xuc, Ur^Br/, Ur^Br/, Uu, Uu, Uu, Ur^Br|, Ur^Br\, Ur, Qxu^Bs\, Qxu, Qxu, Qxu, Cud, Ur, Uu, Uu, Ur^Br|, Xuc, Qxu, Qxu, Qxu, Qxu, Uu, Xu, Xu, Wwg, Xu, Xu, Xu, Xu, Xu, Xu, Xu, Xu
Xu, Xu, Xu, Xu, Xu, Xu, Uu^Ii, Uu^Ii, Uu^Ii, Qlf^Ii, Uu^Ii, Uu, Uu, Uu, Uu, Ur^Br/, Uu, Uu, Xuc, Uu, Uu, Qxu, Qxu, Ur^Br\, Qxu^Br\, Qxu^Bs\, Ur, Uu, Uu, Ur, Uu, Uu, Ur^Br\, Xuc, Xuc, Qxu, Xuc, Uu, Uu, Uu^Vud, Xu, Xu, Xu, Xu, Xu, Xu, Xu, Xu, Xu, Xu
Xu, Xu, Xu, Xu, Xu, Xu, Qlf^Ii, Qlf^Ii, Uu^Ii, Uu^Ii, Ce, Uu^Ii, Uu, Xuc, Uu, Ur^Br|, Uu, Uu^Vud, Uu, Uu, Xu, Uu, Qxu, Uu, Qxu, Qxu^Br\, Ur^Br|, Ur, Ur, Ur, Ur, Ur, Ur, Ur^Br\, Ur^Br\, Xuc, Ur^Br/, Ur^Br/, Ur^Br\, Uu, Uu, Xu, Xu, Xu, Xu, Xu, Xu, Xu, Xu, Xu
Xu, Xu, Xu, Xu, Ql^Ii, Xu, Uu^Ii, Uu^Ii, Uu, Uu, Ce, Ce^Ii, Ce^Ii, Uu, Uu, Ur^Br|, Uu, Uu, Xu, Xu, Xu, Uu, Qxu, Uu, Uu^Vud, Uu, Ur^Br|, Ur, Cud, Cud, Cud, Cud, Cud, Ur, Uu, Ur^Br\, Uu, Xu, Uu, Ur^Br|, Uu, Xu, Xu, Xu, Xu, Xu, Xu, Xu, Xu, Xu
Xu, Xu, Ql^Ii, Ql^Ii, Uu, Uu, Uu, Uu^Vu, Uu^Ii, Ce, Ce^Ii, 2 Ke^Ii, Ce^Ii, Ce, Uu, Ur^Br|, Xu, Xu, Xu, Xu, Xu, Uu, Xuc, Uu, Uu, Uu, Ur^Br|, Ur, Cud, Uu^Vud, Cud, Uu^Vud, Cud, Ur, Ur, Uu, Xu, Xu, Xu, Ur^Br|, Xuc, Uu^Uf, Xu, Xu, Xu, Xu, Xu, Xu, Xu, Xu
Ql^Ii, Ql^Ii, Uu, Uu, Uu, Uu, Uu, Uu, Uu^Ii, Uu^Ii, Uu^Ii, Ce, Ce^Ii, Uu, Uu, Ur^Br|, Xu, Xu, Xu, Xu, Xu, Uu, Uu, Qxu, Qxu, Uu, Ur^Br|, Cud, Uu^Vud, Cud, 3 Kud, Cud, Uu^Vud, Cud, Xu, Uu^Vud, Xu, Xu, Xu, Ur^Br\, Ur^Br|, Uu^Uf, Uu^Uf, Xu, Xu, Xu, Xu, Xu, Xu, Xu
Uu, Uu, Uu, Uu, Uu, Uu, Uu, Uu^Ii, Qlf^Ii, Uu^Ii, Qlf^Ii, Uu^Ii, Uu^Ii, Uu^Ufi, Uu^Uf, Ur^Br|, Xu, Xu, Xu, Xu, Xu, Xu, Uu^Uf, Uu, Xuc, Cud, Ur^Br|, Cud, Cud, Cud, Cud, Cud, Cud, Cud, Qxu, Xu, Xu, Xu, Xu, Xu, Ur^Br\, Xuc, Uu^Uf, Xu, Xu, Xu, Xu, Xu, Xu, Xu
Uu, Uu, Uu, Uu, Uu, Uu, Uu, Uu^Ii, Uu^Ii, Qlf^Ii, Uu^Ii, Qlf^Ii, Uu^Ii, Uh, Uu^Vu, Ur^Br|, Xu, Xu, Xu, Xu, Xu, Xu, Uh, Uu^Uf, Uu^Uf, Uu, Ur^Br|, Ur, Cud, Uu^Vud, Cud, Uu^Vud, Cud, Qxu, Xu, Xu, Xu, Xu, Xu, Xu, Xu, Ur^Br|, Xuc, Uu^Uf, Xu, Xu, Xu, Xu, Xu, Xu
Uu, Uu, Uu, Uu, Uu, Uu, Ql^Ii, Ql^Ii, Xu, Uu^Ii, Xu, Uu^Ii, Uu^Ufi, Uu^Ufi, Uu, Ur^Br|, Xu, Xu, Xu, Xu, Xu, Xu, Xu, Uh, Xu, Uu, Ur^Br|, Ur, Ur, Cud, Qxu, Mm, Xu, Qxu, Xu, Xu, Xu, Xu, Xu, Xu, Xu, Ur^Br|, Ur^Br\, Uu, Xu, Xu, Xu, Xu, Xu, Xu
Uu, Uu, Uu, Uu, Ql^Ii, Ql^Ii, Xu, Ql^Ii, Xu, Xu, Xu, Xu, Xu, Uu, Uu, Ur^Br|, Xu, Xu, Xu, Xu, Xu, Xu, Xu, Xu, Xu, Xu, Ur^Br|, Ur, Uh, Xu, Xu, Xu, Xu, Xu, Xu, Xu, Xu, Xu, Xu, Xu, Xu, Uu, Ur^Br|, Uu, Uh, Xu, Xu, Xu, Xu, Xu
Uu, Uu, Xuc, Xuc, Ql^Ii, Ql^Ii, Xu, Ql^Ii, Xu, Xu, Xu, Xu, Xu, Xu, Xu, Ur^Br|, Xu, Xu, Xu, Xu, Xu, Xu, Xu, Xu, Xu, Xu, Ur^Br|, Ur, Uh, Uh, Xu, Xu, Xu, Xu, Xu, Xu, Xu, Xu, Xu, Xu, Uh, Uu, Ur^Br|, Uu, Uh, Uh, Xu, Xu, Xu, Xu
Uu, Ql^Ii, Ql^Ii, Ql^Ii, Xu, Xu, Ql^Ii, Ql^Ii, Xu, Xu, Xu, Xu, Xu, Xu, Xu, Ur^Br|, Xu, Xu, Xu, Xu, Xu, Xu, Xu, Xu, Xu, Xu, Ur^Br|, Ur, Uh, Uh, Xu, Xu, Xu, Xu, Xu, Xu, Xu, Xu, Xu, Xu, Uh, Uu, Ur^Br|, Uu, Uh, Uh, Xu, Xu, Xu, Xu
