border_size=1
usage=map

Xu, Xu, Xu, Xu, Xu, Qlf, Qlf, Xu, Xu, Qlf, Ql, Xu, Xu, Xu, Xu, Xu, Ql, Xu, Ql, Xu, Xu, Xu, Xu, Qlf, Qlf, Xu, Xu, Xu, Qlf, Qlf, Qlf, Qlf, Xu
Qlf, Xu, Qlf, Qlf, Xu, Xu, Qlf, Xu, Xu, Qlf, Ql, Xu, Ql, Xu, Ql, Ql, Ql, Ql, Ql, Ql, Ql, Ql, Xu, Qlf, Qlf, Xu, Xu, Xu, Qlf, Qlf, Xu, Xu, Xu
Qlf, Qlf, Qlf, Qlf, Ql, Xu, Qlf, Xu, Qlf, Qlf, Ql, Ql, Ql, Ql, Xu, Ql, Uh, Xu, Uh, Ql, Xu, Ql, Ql, Ql, Ql, Ql, Xu, Xu, Xu, Qlf, Qlf, Xu, Xu
Xu, Qlf, Qlf, Qlf, Ql, Ql, Qlf, Qlf, Qlf, Ql, Ql, Ql, Xu, Ql, Uh, Uh, Ql, Ql, Ql, Uh, Uh, Ql, Xu, Ql, Ql, Xu, Ql, Ql, Qlf, Qlf, Qlf, Qlf, Qlf
Xu, Xu, Xu, Qlf, Ql, Ql, Ql, Qlf, Ql, Ql, Ql, Xu, Xu, Uh, Ql, Ql, Uu, Uu, Uu, Ql, Ql, Uh, Xu, Xu, Ql, Ql, Ql, Ql, Qlf, Qlf, Xu, Qlf, Qlf
Xu, Xu, Xu, Ql, Ql, Ql, Ql, Ql, Ql, Ql, Ql, Ql, Uh, Uh, Ql, Uu, Ql, Ql, Ql, Uu, Ql, Uh, Uh, Ql, Ql, Ql, Ql, Ql, Ql, Ql, Xu, Qlf, Xu
Xu, Xu, Xu, Ql, Ql, Ql, Ql, Ql, Xu, Ql, Ql, Xu, Xu, Uh, Ql, Uu, Ql, Uu, Ql, Uu, Ql, Uh, Xu, Xu, Ql, Ql, Xu, Ql, Ql, Xu, Xu, Xu, Xu
Qlf, Qlf, Qlf, Qlf, Qlf, Ql, Ql, Xu, Xu, Ql, Ql, Xu, Uh, Uh, Ql, Uu, Uu^Xo, 7 Uu, Uu^Xo, Uu, Ql, Uh, Uh, Xu, Ql, Ql, Ql, Ql, Ql, Xu, Xu, Xu, Qlf
Qlf, Qlf, Qlf, Qlf, Qlf, Ql, Ql, Ql, Ql, Ql, Ql, Ql, Xu, Uh, Uh, Ql, Ql, Uu^Xo, Ql, Ql, Uh, Uh, Xu, Ql, Ql, Ql, Ql, Ql, Qlf, Xu, Qlf, Qlf, Xu
Qlf, Qlf, Xu, Qlf, Ql, Ql, Ql, Ql, Ql, Ql, Ql, Xu, Xu, Uh, Uh, Uh, Ql, Uu, Ql, Uh, Uh, Uh, Xu, Xu, Ql, Ql, Ql, Ql, Qlf, Qlf, Qlf, Xu, Xu
Xu, Xu, Xu, Xu, Ql, Ql, Ql, Ql, Xu, Ql, Ql, Ql, Ql, Ql, Xu, Uh, Uh, Uu, Uh, Uh, Xu, Ql, Ql, Ql, Ql, Ql, Ql, Ql, Xu, Qlf, Qlf, Xu, Xu
Xu, Xu, Xu, Xu, Ql, Ql, Ql, Ql, Xu, Xu, Ql, Ql, Ql, Ql, Ql, Xu, Uh, Uu, Uh, Xu, Ql, Ql, Ql, Ql, Ql, Ql, Qlf, Xu, Xu, Xu, Qlf, Qlf, Qlf
Xu, Xu, Xu, Xu, Qlf, Ql, Ql, Ql, Ql, Ql, Ql, Ql, Ql, Ql, Ql, Ql, Uh, Uu, Uh, Ql, Uh, Uh, Uh, Qlf, Qlf, Qlf, Xu, Xu, Xu, Xu, Qlf, Qlf, Xu
Xu, Xu, Xu, Xu, Qlf, Qlf, Qlf, Ql, Ql, Ql, Qlf, Qlf, Qlf, Ql, Uh, Uh, Uu^Cov, Uu^Kov, Uh^Cov, Uh, Uh, Uh, Uh, Xu, Xu, Qlf, Qlf, Xu, Xu, Xu, Xu, Qlf, Xu
Qlf, Qlf, Qlf, Qlf, Qlf, Qlf, Xu, Xu, Xu, Xu, Uh, Qlf, Xu, Uh, Uu, Uh, Uu, Uu^Cov, Uu, Uu, Uu, Uh, Uu, Uu, Uu, Xu, Xu, Qlf, Qlf, Xu, Xu, Qlf, Qlf
Qlf, Qlf, Qlf, Qlf, Qlf, Xu, Xu, Xu, Uh, Uh, Qlf, Qlf, Uu, Uu, Uu, Uu, Uu, Uu, Uu, Uu, Uu, Uu, Uu, Xu, Xu, Uu, Xu, Xu, Xu, Qlf, Xu, Xu, Xu
Xu, Xu, Xu, Qlf, Xu, Xu, Xu, Xu, Uh, Qlf, Uh, Uh, Xu, Xu, Uu, Uu, Uu, Uh, Uu, Uu, Xu, Uh, Xu, Uu, Xu, Uu, Uu, Xu, Xu, Qlf, Qlf, Xu, Xu
Xu, Xu, Qlf, Qlf, Xu, Xu, Uu, Uu, Qlf, Qlf, Xu, Xu, Uh, Uh, Uh, Uu, Uu, Uu, Uu, Uh, Xu, Xu, Uu, Uu, Xu, Xu, Xu, Uu, Xu, Xu, Qlf, Xu, Xu
Qlf, Qlf, Xu, Xu, Xu, Xu, Uh, Qlf, Xu, Xu, Xu, Xu, Xu, Uh, Xu, Uu, Uu^Vu, Uu, Uu, Xu, Xu, Uu^Vu, Xu, Uu, Uu, Xu, Xu, Uu, Qlf^Blv\, Qlf, Xu, Xu, Xu
Xu, Xu, Xu, Xu, Xu, Uh, Uh, Qlf, Uu, Xu, Xu, Xu, Xu, Xu, Xu, Xu, Xu, Uu, Xu, Xu, Uu, Xu, Xu, Xu, Xu, Uu, Qlf^Blv\, Qlf, Uh, Uu, Xu, Xu, Xu
Xu, Xu, Xu, Xu, Uu^Vu, Uh, Qlf, Qlf, Xu, Uu, Uu, Xu, Xu, Xu, Xu, Xu, Uu, Uu, Uh, Uh, Uu, Uh, Uh, Uh, Uu, Uu, Qlf, Uu, Uh, Uu, Xu, Xu, Xu
Xu, Xu, Xu, Xu, Uu, Uu, Qlf, Uu, Uh, Uh, Uu, Uu, Uu, Xu, Uh, Uh, Uh, Uu, Uu, Uu, Uu, Uu, Uu, Uu, Uu, Uu, Qlf, Uh, Uu, Uu, Uu, Xu, Xu
Xu, Xu, Uh, Uh, Uu, Uu, Qlf^Blv/, Uu, Uu, Uh, Xu, Uu, Uh, Uu, Uu, Uh, Uu, Uu, Ce, Uu, Uu, Uu, Uu, Uh, Uh, Uu, Qlf, Uu, Xu, Xu, Uu, Xu, Xu
Qlf, Xu, Xu, Uu, Xu, Uu, Uu, Qlf, Qlf, Uu, Xu, Xu, Uh, Uh, Uu, Xu, Uu, Ce, 3 Ke, Ce, Uu, Uh, Xu, Xu, Uu, Uu^Vu, Qlf, Uu, Xu, Uu, Xu, Xu, Qlf
Qlf, Xu, Xu, Uu, Uh, Uh, Uh, Uu, Uu^Vu, Qlf, Uu, Uh, Uh, Uh, Uu, Uu, Uu, Ce, Ce, Ce, Uu, Uh, Uh, Uu, Qlf^Blv\, Qlf^Blv\, Uu, Uu, Uh, Uu, Xu, Xu, Qlf
Xu, Qlf, Xu, Xu, Uh, Uh, Ce, Uu, Uu, Qlf^Blv/, Qlf, Uu, Uu, Uu, Uh, Xu, Uh, Uu, Uu, Uu, Uu, Uu, Uu, Uu, Qlf^Blv\, Uu, Ce, Ce, Ce, Uh, Xu, Xu, Xu
Xu, Qlf, Qlf, Xu, Uh, Ce, 4 Ke, Ce, Uu, Uh, Qlf, Uu, Xu, Uu, Uu, Uh, Uu, Uu, Uu, Uh, Xu, Xu, Xu, Uu, Qlf, Uu, Ce, 5 Ke, Ce, Uh, Uh, Xu, Xu
Qlf, Qlf, Xu, Xu, Uu, Ce, Ce, Ce, Uu, Uh, Qlf^Blv/, Uu, Uh, Xu, Uu, Uu, Uu, Uu, Uu, Uh, Uu, Uu, Uu, Uu, Qlf, Uu, Uu, Ce, Uu, Uu, Uu^Vu, Xu, Xu
Xu, Xu, Xu, Xu, Uu, Uu, Uu, Uu, Uu, Uu, Qlf, Uh, Uu, Uu, Uh, Uh, Uu, Xu, Xu, Uu, Uu, Xu, Uh, Qlf, Xu, Uu, Uu, Uu, Xu, Uu, Uu, Xu, Xu
Xu, Xu, Uh, Uu, Xu, Xu, Uu, Xu, Xu, Uu, Qlf, Xu, Uu, Uu, Uu, Xu, Uu, Xu, Xu, Xu, Uu, Xu, Xu, Qlf, Uu, Uu, Uu, Uu, Xu, Xu, Uu, Xu, Xu
Xu, Xu, Xu, Uu, Xu, Uh, Uu, Uh, Uh, Uu^Vu, Uu, Qlf^Blv/, Xu, Xu, Uh, Uu, Uu, Uu, Uh, Uh, Xu, Uu, Qlf^Blv\, Qlf, Uu, Xu, Uu, Xu, Uh, Uh, Uu, Xu, Xu
Xu, Xu, Uh, Uu, Uh, Xu, Xu, Uu, Uu, Uu, Xu, Qlf, Qlf, Xu, Xu, Uu, Qlf, Qlf^Blv\, Qlf^Blv\, Qlf, Qlf, Qlf, Uu, Uu, Uu, Uu, Uu, Xu, Uu, Uu, Xu, Qlf, Qlf
Xu, Xu, Xu, Uu, Uu, Uh, Uu, Uu, Xu, Uu, Uu, Xu, Xu, Qlf, Qlf, Uu, Qlf^Blv\, Qlf, Qlf, Uu, Uu, Uu, Xu, Xu, Uu, Xu, Uu, Uu, Xu, Xu, Qlf, Qlf, Xu
Xu, Xu, Xu, Xu, Uu, Uu, Xu, Uu, Uh, Xu, Uu, Xu, Xu, Xu, Xu, Qlf, Qlf, Uu, Xu, Qlf, Qlf^Blv/, Uu, Uu, Uu, Xu, Xu, Xu, Uh, Xu, Xu, Qlf, Xu, Xu
Xu, Xu, Xu, Xu, Uu, Xu, Xu, Uu, Uu, Xu, Uu, Uu, Uh, Xu, Qlf, Qlf, Uu, Uu, Uu, Uu, Qlf^Blv/, Uu, Xu, Uu, Uu, Uh, Uh, Xu, Xu, Xu, Qlf, Xu, Xu
Xu, Xu, Xu, Xu, Xu, Uh, Xu, Uh, Xu, Xu, Xu, Uu, Xu, Xu, Qlf, Xu, Uu, Uu, Uh, Uu, Uu, Qlf, Qlf, Xu, Uu, Uu, Uu, Xu, Xu, Xu, Qlf, Xu, Qlf
Qlf, Xu, Xu, Xu, Xu, Uh, Uu, Xu, Uu, Uu, Uu, Uu, Qlf^Blv\, Qlf, Uu, Xu, Uu^Vu, Xu, Xu, Uh, Uu, Xu, Qlf, Xu, Uu, Xu, Uu, Xu, Xu, Xu, Xu, Qlf, Xu
Xu, Qlf, Qlf, Xu, Xu, Xu, Xu, Uu, Xu, Xu, Qlf, Qlf^Blv\, Uu, Uu, Xu, Xu, Xu, Xu, Xu, Uh, Uu, Xu, Qlf, Xu, Uh, Uu, Xu, Xu, Xu, Xu, Xu, Xu, Xu
Xu, Xu, Qlf, Xu, Xu, Xu, Xu, Xu, Qlf, Qlf, Uh, Uu, Uu, Uu, Xu, Xu, Xu, Xu, Uu, Uu, Uh, Xu, Qlf, Xu, Xu, Uu, Uu^Vu, Xu, Xu, Xu, Xu, Xu, Xu
Xu, Xu, Qlf, Qlf, Xu, Xu, Xu, Qlf, Xu, Xu, Uh, Uh, Xu, Uu, Xu, Xu, Xu, Uh, Uu, Uu, Xu, Xu, Xu, Qlf, Xu, Uu, Uu, Xu, Uh, Xu, Xu, Xu, Qlf
Xu, Xu, Qlf, Xu, Xu, Xu, Qlf, Qlf, Xu, Xu, Xu, Xu, Uu, Uu, Xu, Xu, Xu, Uh, Uu, Uu, Xu, Xu, Xu, Qlf, Xu, Xu, Uu, Uu, Uh, Xu, Xu, Xu, Qlf
Xu, Qlf, Xu, Xu, Xu, Qlf, Xu, Xu, Xu, Xu, Xu, Xu, Uh, Uu, Uu, Uu^Vu, Xu, Xu, Uu, Uu, Xu, Xu, Xu, Qlf, Uu^Vu, Xu, Uu, Uu, Uh, Xu, Xu, Qlf, Xu
Xu, Qlf, Xu, Xu, Qlf, Qlf, Xu, Xu, Xu, Xu, Xu, Xu, Xu, Xu, Uu, Uu, Uu, Uu, Uu, Uu, Uu, Uu, Uu, Qlf, Qlf^Blv/, Uu, Uu, Uu, Xu, Xu, Xu, Qlf, Xu
Xu, Qlf, Xu, Xu, Qlf, Xu, Xu, Xu, Xu, Xu, Xu, Xu, Xu, Xu, Uh, Qxu, Uu, Ce, Ce, Ce, Ce, Ce, Uu, Uu, Uu, Qlf^Blv/, Qlf, Xu, Xu, Xu, Xu, Qlf, Qlf
Xu, Qlf, Qlf, Xu, Qlf, Xu, Xu, Xu, Xu, Xu, Xu, Xu, Xu, Uh, Uh, Uu, Uu, Uu, Ke, 1 Ke, Ke, Uu, Uu, Uu, Uh, Xu, Xu, Qlf, Qlf, Xu, Xu, Xu, Qlf
Xu, Xu, Qlf, Qlf, Qlf, Qlf, Qlf, Xu, Xu, Xu, Xu, Xu, Xu, Xu, Xu, Xu, Uu, Ce, Uu, Ce^Kov, Uu, Ce, Uu, Uh, Xu, Xu, Xu, Xu, Xu, Qlf, Qlf, Qlf, Qlf
Xu, Xu, Qlf, Qlf, Qlf, Qlf, Qlf, Xu, Xu, Xu, Xu, Xu, Xu, Xu, Xu, Xu, Uu, Uu, Uu, Ce, Uu, Uu, Uu^Vu, Xu, Xu, Xu, Xu, Xu, Xu, Xu, Qlf, Qlf, Qlf
Xu, Xu, Xu, Qlf, Qlf, Qlf, Qlf, Xu, Xu, Xu, Xu, Xu, Xu, Xu, Xu, Uh, Uh, Uu, Uu, Uu, Uu, Xu, Xu, Xu, Xu, Xu, Xu, Xu, Xu, Qlf, Qlf, Qlf, Qlf
Xu, Xu, Xu, Qlf, Qlf, Qlf, Xu, Xu, Xu, Xu, Xu, Xu, Xu, Xu, Xu, Xu, Uh, Uu, Uu, Uu, Uu, Uh, Uh, Xu, Xu, Xu, Xu, Xu, Xu, Xu, Qlf, Qlf, Qlf
Xu, Xu, Xu, Xu, Xu, Xu, Xu, Xu, Xu, Xu, Xu, Xu, Xu, Xu, Xu, Xu, Xu, Uh, Uu, Uu, Uu, Uu, Xu, Xu, Xu, Xu, Xu, Xu, Xu, Xu, Xu, Qlf, Qlf
Xu, Xu, Xu, Xu, Xu, Xu, Xu, Xu, Xu, Xu, Xu, Xu, Xu, Xu, Xu, Xu, Xu, Uh, Uu, Uu, Uu, Uh, Uh, Xu, Xu, Xu, Xu, Xu, Xu, Xu, Xu, Qlf, Xu
Xu, Xu, Xu, Xu, Xu, Xu, Xu, Xu, Xu, Xu, Xu, Xu, Xu, Xu, Xu, Uh, Uh, Uh, Uu, Uu, Uu, Uh, Uh, Xu, Xu, Xu, Xu, Xu, Xu, Xu, Xu, Xu, Xu
