Xur, Xur, Xur, Xur, Xur, Qlf, Qlf, Xur, Xur, Qlf, Ql, Xur, Xur, Xur, Xur, Xur, Ql, Xu, Ql, Xur, Xur, Xur, Xur, Qlf, Qlf, Xur, Xur, Xur, Qlf, Qlf, Qlf, Qlf, Xur
Qlf, Xur, Qlf, Qlf, Xur, Xur, Qlf, Xur, Xur, Qlf, Ql, Xur, Ql, Xur, Ql, Ql, Ql, Ql, Ql, Ql, Ql, Ql, Xur, Qlf, Qlf, Xur, Xur, Xur, Qlf, Qlf, Xur, Xur, Xur
Qlf, Qlf, Qlf, Qlf, Ql, Xur, Qlf, Xur, Qlf, Qlf, Ql, Ql, Ql, Ql, Xur, Ql, Uh, Xur, Uh, Ql, Xur, Ql, Ql, Ql, Ql, Ql, Xur, Xur, Xur, Qlf, Qlf, Xur, Xur
Xur, Qlf, Qlf, Qlf, Ql, Ql, Qlf, Qlf, Qlf, Ql, Ql, Ql, Xur, Ql, Uh, Uh, Ql, Ql, Ql, Uh, Uh, Ql, Xur, Ql, Ql, Xur, Ql, Ql, Qlf, Qlf, Qlf, Qlf, Qlf
Xur, Xur, Xur, Qlf, Ql, Ql, Ql, Qlf, Ql, Ql, Ql, Xur, Xur, Uh, Ql, Ql, Uu, Uu, Uu, Ql, Ql, Uh, Xur, Xur, Ql, Ql, Ql, Ql, Qlf, Qlf, Xur, Qlf, Qlf
Xur, Xur, Xur, Ql, Ql, Ql, Ql, Ql, Ql, Ql, Ql, Ql, Uh, Uh, Ql, Uu, Ql, Ql, Ql, Uu, Ql, Uh, Uh, Ql, Ql, Ql, Ql, Ql, Ql, Ql, Xur, Qlf, Xur
Xur, Xur, Xur, Ql, Ql, Ql, Ql, Ql, Xur, Ql, Ql, Xur, Xur, Uh, Ql, Uu, Ql, Uu, Ql, Uu, Ql, Uh, Xur, Xur, Ql, Ql, Xur, Ql, Ql, Xur, Xur, Xur, Xur
Qlf, Qlf, Qlf, Qlf, Qlf, Ql, Ql, Xur, Xur, Ql, Ql, Xur, Uh, Uh, Ql, Uu, Uu^Xo, Uu, Uu^Xo, Uu, Ql, Uh, Uh, Xur, Ql, Ql, Ql, Ql, Ql, Xur, Xur, Xur, Qlf
Qlf, Qlf, Qlf, Qlf, Qlf, Ql, Ql, Ql, Ql, Ql, Ql, Ql, Xur, Uh, Uh, Ql, Ql, Uu^Xo, Ql, Ql, Uh, Uh, Xur, Ql, Ql, Ql, Ql, Ql, Qlf, Xur, Qlf, Qlf, Xu
Qlf, Qlf, Xur, Qlf, Ql, Ql, Ql, Ql, Ql, Ql, Ql, Xur, Xur, Uh, Uh, Uh, Ql, Uu, Ql, Uh, Uh, Uh, Xur, Xur, Ql, Ql, Ql, Ql, Qlf, Qlf, Qlf, Xu, Xu
Xur, Xur, Xur, Xur, Ql, Ql, Ql, Ql, Xur, Ql, Ql, Ql, Ql, Ql, Xur, Uh, Uh, Uu, Uh, Uh, Xur, Ql, Ql, Ql, Ql, Ql, Ql, Ql, Xur, Qlf, Qlf, Xu, Xu
Xur, Xur, Xur, Xur, Ql, Ql, Ql, Ql, Xur, Xur, Ql, Ql, Ql, Ql, Ql, Xur, Uh, Uu, Uh, Xur, Ql, Ql, Ql, Ql, Ql, Ql, Qlf, Xur, Xur, Xur, Qlf, Qlf, Qlf
Xur, Xur, Xur, Xur, Qlf, Ql, Ql, Ql, Ql, Ql, Ql, Ql, Ql, Ql, Ql, Ql, Uh, Uu, Uh, Ql, Uh, Uh, Uh, Qlf, Qlf, Qlf, Xur, Xur, Xur, Xur, Qlf, Qlf, Xu
Xur, Xur, Xur, Xur, Qlf, Qlf, Qlf, Ql, Ql, Ql, Qlf, Qlf, Qlf, Ql, Uh, Uh, Uu^Cov, Uu^Kov, Uh^Cov, Uh, Uh, Uh, Uh, Xur, Xur, Qlf, Qlf, Xur, Xur, Xur, Xur, Qlf, Xu
Qlf, Qlf, Qlf, Qlf, Qlf, Qlf, Xur, Xur, Xur, Xur, Uh, Qlf, Xur, Uh, Uu, Uh, Uu, Uu^Cov, Uu, Uu, Uu, Uh, Uu, Uu, Uu, Xur, Xur, Qlf, Qlf, Xur, Xur, Qlf, Qlf
Qlf, Qlf, Qlf, Qlf, Qlf, Xur, Xur, Xur, Uh, Uh, Qlf, Qlf, Uu, Uu, Uu, Uu, Uu, Uu, Uu, Uu, Uu, Uu, Uu, Xur, Xur, Uu, Xur, Xur, Xur, Qlf, Xur, Xur, Xur
Xur, Xur, Xur, Qlf, Xur, Xur, Xur, Xur, Uh, Qlf, Uh, Uh, Xur, Xur, Uu, Uu, Uu, Uh, Uu, Uu, Xur, Uh, Xur, Uu, Xur, Uu, Uu, Xur, Xur, Qlf, Qlf, Xur, Xur
Xur, Xur, Qlf, Qlf, Xur, Xur, Uu, Uu, Qlf, Qlf, Xur, Xur, Uh, Uh, Uh, Uu, Uu, Uu, Uu, Uh, Xur, Xur, Uu, Uu, Xur, Xur, Xur, Uu, Xur, Xur, Qlf, Xur, Xur
Qlf, Qlf, Xur, Xur, Xur, Xur, Uh, Qlf, Xur, Xur, Xur, Xur, Xur, Uh, Xur, Uu, Uu^Vu, Uu, Uu, Xur, Xur, Uu^Vu, Xur, Uu, Uu, Xur, Xur, Uu, Qlf^Blv\, Qlf, Xur, Xur, Xur
Xur, Xur, Xur, Xur, Xur, Uh, Uh, Qlf, Uu, Xur, Xur, Xur, Xur, Xur, Xur, Xur, Xur, Uu, Xur, Xur, Uu, Xur, Xur, Xur, Xur, Uu, Qlf^Blv\, Qlf, Uh, Uu, Xur, Xur, Xur
Xur, Xur, Xur, Xur, Uu^Vu, Uh, Qlf, Qlf, Xu, Uu, Uu, Xur, Xur, Xur, Xur, Xur, Uu, Uu, Uh, Uh, Uu, Uh, Uh, Uh, Uu, Uu, Qlf, Uu, Uh, Uu, Xur, Xur, Xur
Xur, Xur, Xur, Xur, Uu, Uu, Qlf, Uu, Uh, Uh, Uu, Uu, Uu, Xur, Uh, Uh, Uh, Uu, Uu, Uu, Uu, Uu, Uu, Uu, Uu, Uu, Qlf, Uh, Uu, Uu, Uu, Xur, Xur
Xur, Xur, Uh, Uh, Uu, Uu, Qlf^Blv/, Uu, Uu, Uh, Xur, Uu, Uh, Uu, Uu, Uh, Uu, Uu, Ce, Uu, Uu, Uu, Uu, Uh, Uh, Uu, Qlf, Uu, Xur, Xur, Uu, Xur, Xur
Qlf, Xur, Xur, Uu, Xu, Uu, Uu, Qlf, Qlf, Uu, Xur, Xur, Uh, Uh, Uu, Xur, Uu, Ce, 3 Ke, Ce, Uu, Uh, Xur, Xur, Uu, Uu^Vu, Qlf, Uu, Xur, Uu, Xur, Xur, Qlf
Qlf, Xur, Xur, Uu, Uh, Uh, Uh, Uu, Uu^Vu, Qlf, Uu, Uh, Uh, Uh, Uu, Uu, Uu, Ce, Ce, Ce, Uu, Uh, Uh, Uu, Qlf^Blv\, Qlf^Blv\, Uu, Uu, Uh, Uu, Xur, Xur, Qlf
Xu, Qlf, Xur, Xur, Uh, Uh, Ce, Uu, Uu, Qlf^Blv/, Qlf, Uu, Uu, Uu, Uh, Xur, Uh, Uu, Uu, Uu, Uu, Uu, Uu, Uu, Qlf^Blv\, Uu, Ce, Ce, Ce, Uh, Xur, Xur, Xur
Xu, Qlf, Qlf, Xur, Uh, Ce, 4 Ke, Ce, Uu, Uh, Qlf, Uu, Xur, Uu, Uu, Uh, Uu, Uu, Uu, Uh, Xur, Xur, Xur, Uu, Qlf, Uu, Ce, 5 Ke, Ce, Uh, Uh, Xur, Xur
Qlf, Qlf, Xur, Xur, Uu, Ce, Ce, Ce, Uu, Uh, Qlf^Blv/, Uu, Uh, Xur, Uu, Uu, Uu, Uu, Uu, Uh, Uu, Uu, Uu, Uu, Qlf, Uu, Uu, Ce, Uu, Uu, Uu^Vu, Xur, Xur
Xur, Xur, Xur, Xur, Uu, Uu, Uu, Uu, Uu, Uu, Qlf, Uh, Uu, Uu, Uh, Uh, Uu, Xur, Xur, Uu, Uu, Xur, Uh, Qlf, Xur, Uu, Uu, Uu, Xur, Uu, Uu, Xur, Xur
Xur, Xur, Uh, Uu, Xur, Xur, Uu, Xur, Xur, Uu, Qlf, Xur, Uu, Uu, Uu, Xur, Uu, Xur, Xur, Xur, Uu, Xur, Xur, Qlf, Uu, Uu, Uu, Uu, Xur, Xur, Uu, Xur, Xur
Xur, Xur, Xur, Uu, Xur, Uh, Uu, Uh, Uh, Uu^Vu, Uu, Qlf^Blv/, Xur, Xur, Uh, Uu, Uu, Uu, Uh, Uh, Xur, Uu, Qlf^Blv\, Qlf, Uu, Xur, Uu, Xur, Uh, Uh, Uu, Xur, Xur
Xur, Xur, Uh, Uu, Uh, Xur, Xur, Uu, Uu, Uu, Xur, Qlf, Qlf, Xur, Xur, Uu, Qlf, Qlf^Blv\, Qlf^Blv\, Qlf, Qlf, Qlf, Uu, Uu, Uu, Uu, Uu, Xur, Uu, Uu, Xur, Qlf, Qlf
Xur, Xur, Xur, Uu, Uu, Uh, Uu, Uu, Xur, Uu, Uu, Xur, Xur, Qlf, Qlf, Uu, Qlf^Blv\, Qlf, Qlf, Uu, Uu, Uu, Xur, Xur, Uu, Xur, Uu, Uu, Xur, Xur, Qlf, Qlf, Xur
Xur, Xur, Xur, Xur, Uu, Uu, Xur, Uu, Uh, Xur, Uu, Xur, Xur, Xur, Xur, Qlf, Qlf, Uu, Xur, Qlf, Qlf^Blv/, Uu, Uu, Uu, Xur, Xur, Xur, Uh, Xur, Xur, Qlf, Xur, Xur
Xur, Xur, Xur, Xur, Uu, Xur, Xur, Uu, Uu, Xur, Uu, Uu, Uh, Xur, Qlf, Qlf, Uu, Uu, Uu, Uu, Qlf^Blv/, Uu, Xur, Uu, Uu, Uh, Uh, Xur, Xur, Xur, Qlf, Xur, Xur
Xur, Xur, Xur, Xur, Xur, Uh, Xur, Uh, Xur, Xur, Xur, Uu, Xur, Xur, Qlf, Xur, Uu, Uu, Uh, Uu, Uu, Qlf, Qlf, Xur, Uu, Uu, Uu, Xur, Xur, Xur, Qlf, Xur, Qlf
Qlf, Xur, Xur, Xur, Xur, Uh, Uu, Xur, Uu, Uu, Uu, Uu, Qlf^Blv\, Qlf, Uu, Xur, Uu^Vu, Xur, Xur, Uh, Uu, Xur, Qlf, Xur, Uu, Xur, Uu, Xur, Xur, Xur, Xur, Qlf, Xur
Xur, Qlf, Qlf, Xur, Xur, Xur, Xur, Uu, Xur, Xur, Qlf, Qlf^Blv\, Uu, Uu, Xur, Xur, Xur, Xur, Xur, Uh, Uu, Xur, Qlf, Xur, Uh, Uu, Xur, Xur, Xur, Xur, Xur, Xur, Xur
Xur, Xur, Qlf, Xur, Xur, Xur, Xur, Xur, Qlf, Qlf, Uh, Uu, Uu, Uu, Xur, Xur, Xur, Xur, Uu, Uu, Uh, Xur, Qlf, Xur, Xur, Uu, Uu^Vu, Xur, Xur, Xur, Xur, Xur, Xur
Xur, Xur, Qlf, Qlf, Xur, Xur, Xur, Qlf, Xur, Xur, Uh, Uh, Xur, Uu, Xur, Xur, Xur, Uh, Uu, 7 Uu, Uu, Xur, Xur, Qlf, Xur, Uu, Uu, Xur, Uh, Xur, Xur, Xur, Qlf
Xur, Xur, Qlf, Xur, Xur, Xur, Qlf, Qlf, Xur, Xur, Xur, Xur, Uu, Uu, Xur, Xur, Xur, Uh, Uu, Uu, Uu, Uu, Xur, Qlf, Xur, Xur, Uu, Uu, Uh, Xur, Xur, Xur, Qlf
Xur, Qlf, Xur, Xur, Xur, Qlf, Xur, Xur, Xur, Xur, Xur, Xur, Uh, Uu, Uu, Uu^Vu, Xur, Xur, Uu, Uu, Uu, Xur, Xur, Qlf, Uu^Vu, Xur, Uu, Uu, Uh, Xur, Xur, Qlf, Xu
Xur, Qlf, Xur, Xur, Qlf, Qlf, Xur, Xur, Xur, Xur, Xur, Xur, Xur, Xur, Uu, Uu, Uu, Uu, Uu, Uu, Uu, Uu, Uu, Qlf, Qlf^Blv/, Uu, Uu, Uu, Xur, Xur, Xur, Qlf, Xu
Xur, Qlf, Xur, Xur, Qlf, Xur, Xur, Xur, Xur, Xur, Xur, Xur, Xur, Xur, Uh, Qxu, Uu, Ce, Ce, Ce, Ce, Ce, Uu, Uu, Uu, Qlf^Blv/, Qlf, Xur, Xur, Xur, Xur, Qlf, Qlf
Xur, Qlf, Qlf, Xur, Qlf, Xur, Xur, Xur, Xur, Xur, Xur, Xur, Xur, Uh, Uh, Uu, Uu, Uu, Ke, 1 Ke, Ke, Uu, Uu, Uu, Uh, Xu, Xu, Qlf, Qlf, Xur, Xur, Xur, Qlf
Xur, Xur, Qlf, Qlf, Qlf, Qlf, Qlf, Xur, Xur, Xur, Xur, Xur, Xur, Xur, Xur, Xur, Uu, Ce, Uu, Ce^Kov, Uu, Ce, Uu, Uh, Xu, Xu, Xu, Xu, Xu, Qlf, Qlf, Qlf, Qlf
Xur, Xur, Qlf, Qlf, Qlf, Qlf, Qlf, Xur, Xur, Xur, Xur, Xur, Xur, Xur, Xur, Xur, Uu, Uu, Uu, Ce, Uu, Uu, Uu^Vu, Xu, Xu, Xu, Xu, Xu, Xu, Xu, Qlf, Qlf, Qlf
Xur, Xur, Xur, Qlf, Qlf, Qlf, Qlf, Xur, Xur, Xur, Xur, Xur, Xur, Xur, Xur, Uh, Uh, Uu, Uu, Uu, Uu, Xu, Xu, Xu, Xu, Xu, Xu, Xu, Xu, Qlf, Qlf, Qlf, Qlf
Xur, Xur, Xur, Qlf, Qlf, Qlf, Xur, Xur, Xur, Xur, Xur, Xur, Xur, Xur, Xur, Xur, Uh, Uu, Uu, Uu, Uu, Uh, Uh, Xu, Xu, Xu, Xu, Xu, Xu, Xu, Qlf, Qlf, Qlf
Xur, Xur, Xur, Xur, Xur, Xur, Xur, Xur, Xur, Xur, Xur, Xur, Xur, Xur, Xur, Xur, Xur, Uh, Uu, Uu, Uu, Uu, Xu, Xu, Xu, Xu, Xu, Xu, Xu, Xu, Xu, Qlf, Qlf
Xur, Xur, Xur, Xur, Xur, Xur, Xur, Xur, Xur, Xur, Xur, Xur, Xur, Xur, Xur, Xur, Xur, Uh, Uu, Uu, Uu, Uh, Uh, Xu, Xu, Xu, Xu, Xu, Xu, Xu, Xu, Qlf, Xu
Xur, Xur, Xur, Xur, Xur, Xur, Xur, Xur, Xur, Xur, Xur, Xur, Xur, Xur, Xur, Uh, Uh, Uh, Uu, Uu, Uu, Uh, Uh, Xu, Xu, Xu, Xu, Xu, Xu, Xu, Xu, Xu, Xu
