Md, Md, Md, Md, Md, Md, Md, Md, Md, Md, Md, Md^Xm, Md^Xm, Md, Md^Xm, Md, Md, Md, Md, Md, Md, Md, Md, Md, Md, Hd, Dd, Dd, Rd, Dd, Dd, Dd, Hd, Hd, Hd, Hd, Rrd, Rmo, Rrd, Dd, Dd, Dd, Dd, Dd, Dd, Dd, Dd, Hd, Hd, Dd, Dd, Dd, Rrd, Rmo, Rmo, Rrd, Hd, Hd, Hd, Hd, Hd, Hd, Hd, Hd, Hd, Hd, Hd, Hd, Hd, Hd
Md, Md, Md^Xm, Md^Xm, Md, Md, Md, Md, Md, Md^Xm, Md, Md, Md, Md, Md, Md, Md, Md, Md, Md, Md, Md, Md, Md, Hd, Hd, Dd, Rd, Dd^Esd, Dd, Dd, Dd, Hd, Hd, Hd, Hd, Rrd, Rmo, Rrd, Dd, Dd, Dd^Esd, Dd, Dd, Dd, Hd, Hd, Hd, Hd, Hd, Hd, Dd, Rrd, Rmo, Rmo, Rrd, Hd, Hd, Hd, Hd, Hd, Hd, Hd, Hd, Hd, Hd, Hd, Hd, Hd, Hd
Md, Md^Xm, Md, Md, Md, Md^Xm, Md, Md, Md^Xm, Md, Md, Md, Md, Md, Md^Xm, Md, Md, Md, Md, Md, Md, Md, Md, Hd, Hd, Dd, Dd, Dd, Rd, Dd, Dd, Dd, Hd, Hd, Hd, Dd, Rrd, Rmo, Rrd, Dd, Dd, Rd, Dd, Dd^Esd, Dd, Hd, Hd, Hd, Hd, Hd, Hd, Dd, Rrd, Rmo, Rmo, Rrd, Hd, Hd, Hd, Hd, Hd, Hd, Hd, Hd, Hd, Hd, Hd, Hd, Hd, Hd
Md^Xm, Md, Md, Md, Md, Md, Md, Md^Xm, Md, Md, Md^Xm, Md, Md, Md, Md, Md, Md, Md, Md, Md, Md, Md, Hd, Hd, Dd, Dd, Rd, Rd, Dd, Dd, Dd, Dd, Dd, Dd, Dd, Dd, Rrd, Rmo, Rrd, Dd, Dd, Rd, Dd^Esd, Dd^Esd, Dd, Hd, Hd, Hd, Hd, Hd, Hd, Hd, Rrd, Rmo, Rmo, Rrd, Hd, Hd, Hd, Dd, Dd, Hd, Hd, Hd, Hd, Hd, Hd, Hd, Hd, Hd
Md^Xm, Md, Md, Md, Md^Xm, Md, Md^Xm, Md, Md^Xm, Md^Xm, Md, Md, Md, Md^Xm, Md, Md, Md, Md, Md, Md, Hd, Hd, Hd, Hd, Dd, Dd, Dd, Rd, Dd, Dd, Dd, Dd^Esd, Dd, Dd, Dd^Esd, Dd, Rrd, Rmo, Rrd, Dd, Dd, Dd, Rd, Dd, Dd, Hd, Hd, Hd, Hd, Hd, Hd, Hd, Rrd, Rmo, Rmo, Rrd, Dd, Hd, Hd, Hd, Dd, Hd, Dd, Hd, Hd, Hd, Hd, Hd, Hd, Hd
Md^Xm, Md^Xm, Md, Md, Md, Md, Md, Md, Md, Md, Md^Xm, Md, Md, Md, Md, Md, Md, Md, Md, Md, Hd, Hd, Dd, Dd, Dd, Dd^Esd, Rd, Dd, Hd, Hd, Hd, Dd, Dd, Rd, Rd, Dd, Rrd, Rmo, Rrd, Dd^Esd, Rd, Dd, Dd, Rd, Dd^Esd, Dd, Dd, Hd, Hd, Hd, Dd, Hd, Rrd, Rmo, Rmo, Rrd, Rrd, Dd, Dd, Dd, Dd, Dd, Dd, Dd, Dd, Hd, Hd, Hd, Hd, Hd
Md, Md, Md^Xm, Md, Md, Md, Md, Md, Md, Md^Xm, Md, Md, Kd, Md, Kd, Md, Md, Md, Md, Md, Hd, Dd, Dd, Rd, Dd, Rd, Dd, Hd, Hd, Hd, Hd, Dd, Dd, Dd, Rd, Dd^Esd, Rrd, Rmo, Rrd, Dd, Dd^Esd, Dd, Dd, Dd, Rd, Dd, Rd, Dd, Dd, Dd, Dd, Dd, Rrd, Rmo, Rmo, Rmo, Rmo, Rrd, Rrd, Dd, Rd^Esd, Dd, Dd, Dd, Dd, Hd, Hd, Hd, Hd, Hd
Md, Md, Md, Md^Xm, Md, Md^Xm, Md, Md, Md, Md, Md, Md, Cd, Cd, Cd, Md, Md, Md, Md, Md, Hd, Dd, Dd^Vda, Rd^Esd, Dd, Dd, Hd, Hd, Hd, Hd, Hd, Dd, Rd, Rd, Dd^Esd, Dd, Rrd, Rmo, Rrd, Dd, Dd, Dd, Dd^Esd, Rd, Rd^Esd, Rd, Rd, Dd, Rd, Dd, Dd, Dd^Esd, Dd, Rrd, Rrd, Rmo, Rmo, Rmo, Rmo, Rrd, Dd, Rd, Rd^Esd, Dd, Dd, Dd, Dd, Hd, Hd, Hd
Md, Md, Md, Md, Md, Md, Md, Md, Md, Md, Md, Kd, Cd, Cd, Cd, Md, Md, Md, Hd, Hd, Dd, Dd, Dd^Esd, Dd, Dd, Hd, Dd, Hd, Dd, Dd, Dd, Dd, Dd, Dd, Dd, Dd, Rrd, Rmo, Rrd, Dd, Dd, Dd, Dd, Dd^Esd, Dd, Rd, Rd^Esd, Dd, Dd^Vda, Dd, Dd, Rd, Rd^Esd, Dd, Dd, Rrd, Rrd, Rmo, Rmo, Rrd, Dd, Dd, Dd, Dd, Rd, Dd, Dd, Hd, Hd, Dd
Md, Md, Md, Md, Md, Md, Md, Md, Md, Md, Md, Md, Md, Cd, Md, Kd, Kd, Md, Hd, Hd, Dd, Dd, Dd, Rd, Dd, Dd, Dd, Dd, Dd, Rd, Dd, Dd, Dd, Dd, Cd^Ii, Dd, Rrd, Rmo, Rrd, Dd, Cd^Ii, Dd, Dd, Dd, Dd, Dd, Dd, Rd^Esd, Dd, Rd, Rd, Rd, Dd, Rd^Esd, Dd^Esd, Dd, Rrd, Rmo, Rmo, Rrd, Dd, Dd, Rd, Dd, Dd^Esd, Rd, Dd, Dd, Dd, Dd
Md, Md, Md, Md, Md, Md, Md, Md, Md, Md, Md, Md, Md, Kd, Kd, Md, Md, Kd, Hd, Hd, Dd, Rd, Dd, Rd^Esd, Rd^Esd, Rd, Rd, Rd, Dd, Dd, Cd^Ii, Cd^Ii, Cd^Ii, Cd^Ii, Gs, Kd^Ii, Rmo, Rmo, Rmo, Kd^Ii, Gs, Cd^Ii, Cd^Ii, Cd^Ii, Cd^Ii, Dd, Dd, Dd^Esd, Rd, Dd, Rd, Dd, Dd, Rd, Dd, Dd, Rrd, Rmo, Rmo, Rrd, Dd, Dd^Esd, Rd, Rd, Dd^Esd, Dd, Rd, Dd, Rd, Dd
Md, Md, Md, Md, Md, Md, Md, Md, Md, Md, Md, Md, Md, Md, Md, Kd, Rmo, Rmo, Rrd, Dd, Dd, Dd, Dd, Dd, Dd, Dd, Dd, Dd, Dd, Cd^Ii, Gs, Gs, Gs, Gs, Gs, Gs, Rmo, Rmo^Rs, Rmo, Gs, Gs, Gs, Gs, Gs, Gs, Cd^Ii, Dd, Dd, Dd, Dd, Dd, Dd, Dd, Dd, Rrd, Rrd, Rmo, Rmo, Rmo, Rrd, Dd, Dd^Esd, Rd, Rd, Dd, Dd, Rd^Esd, Dd, Dd, Rd^Esd
Md, Md, Hd, Md, Md, Md, Md, Md, Md, Md, Hd, Hd, Hd, Hd, Hd, Hd, Rrd, Rmo, Rmo, Rrd, Kd^Ii, Dd, Dd, Dd, Dd, Dd, Dd, Dd, Cd^Ii, Cd^Ii, Gs, Gs, Gs, Rmo^Vdm, Rmo, Rmo, Rmo, Rmo, Rmo, Rmo, Rmo, Rmo^Vdm, Gs, Gs, Gs, Cd^Ii, Cd^Ii, Dd, Cd^Ii, Dd, Cd^Ii, Dd, Cd^Ii, Cd^Ii, Rmo, Rmo, Rmo, Rmo, Rrd, Rrd, Dd, Dd, Dd, Dd, Dd, Dd^Esd, Dd, Rd^Esd, Dd, Rd
Hd, Hd, Hd, Hd, Hd, Hd, Hd, Hd, Hd, Hd, Dd, Hd, Dd, Dd, Dd, Dd, Dd, Rrd, Rmo, Rmo, Rmo, Cd^Ii, Cd^Ii, Cd^Ii, Cd^Ii, Cd^Ii, Cd^Ii, Cd^Ii, Gs, Gs, Cd, Cd, Cd, Rmo, Rmo, Rmo, Rmo, Gll^Ftr, Rmo, Rmo, Rmo, Rmo, Cd, Cd, Cd, Gs, Gs, Cd^Ii, Gs, Cd^Ii, Gs, Cd^Ii, Rmo, Rmo, Rmo, Rmo, Cd^Ii, Rrd, Dd, Dd, Dd^Vda, Rd, Hd, Dd, Dd, Dd, Dd, Rd, Dd^Esd, Dd^Esd
Hd, Hd, Hd, Dd, Dd, Hd, Hd, Dd, Dd, Dd, Dd, Dd, Dd, Dd, Rd, Rd, Dd, Kd^Ii, Cd^Ii, Rmo, Rmo, Rmo, Rmo, Gs, Gs, Gs, Gs, Gs, Rmo, Rmo, Cd, Kd, Cd, Rmo, Gs, Gs, Rmo, Gll^Ftr, Rmo, Gs, Gs, Rmo, Cd, Kd, Cd, Rmo, Rmo, Gs, Gs, Gs, Rmo, Rmo, Rmo, Rmo, Cd^Ii, Cd^Ii, Dd, Dd, Dd, Rd^Esd, Dd, Dd, Hd, Hd, Dd, Dd, Rd, Dd, Dd, Hd
Hd, Dd, Dd, Dd, Dd, Dd, Dd, Dd, Dd, Dd, Dd, Dd^Esd, Dd, Rd, Dd, Rd, Dd, Dd, Dd, Cd^Ii, Gs, Rmo, Rmo^Js, Rmo, Rmo, Gs, Cd, Rmo, Gll^Ftr, Gll^Ftr, Rmo, Cd, Gs, Gs, Gs, Gs, Cd, Rmo, Cd, Gs, Gs, Gs, Gs, Cd, Rmo, Gll^Ftr, Gll^Ftr, Rmo, Cd, Rmo, Rmo, Rmo^Ts, Rmo, Gs, Cd^Ii, Dd, Dd, Dd, Rd, Rd, Dd, Dd, Hd, Hd, Dd, Dd, Rd, Dd, Hd, Hd
Dd, Dd, Dd, Dd, Dd^Esd, Dd, Dd, Dd^Esd, Hd, Dd, Dd, Dd, Rd, Rd, Dd, Rd^Esd, Dd, Dd, Cd^Ii, Cd^Ii, Gs, Rmo, Rmo, Rmo, Rmo, Cd, Kd, Cd, Rmo, Rmo, Gs, Gs, Gs, Gs, Gll^Ftr, Cd, Qxe^Qhux, Rmo, Qxe^Qhux, Cd, Gll^Ftr, Gll^Ftr, Gs, Gs, Gs, Rmo, Rmo, Cd, Kd, Cd, Rmo, Rmo, Rmo^Vdm, Gs, Gs, Cd^Ii, Dd, Dd^Esd, Dd^Esd, Dd, Dd, Hd, Hd, Hd, Dd, Rd, Dd, Hd, Hd, Hd
Dd^Esd, Dd, Dd^Esd, Dd^Esd, Dd, Hd, Hd, Hd, Hd, Hd, Dd, Rd, Rd, Dd, Dd, Rd^Esd, Dd, Dd, Cd^Ii, Gs, Gs, Gs, Rmo, Rmo, Gll^Ftr, Cd, Cd, Cd, Gs, Gs, Gll^Ftr, Gll^Ftr, Gll^Ftr, Gll^Ftr, Qxe^Qhux, Qxe^Qhux, Qxe, Qxu^Bsb|, Qxe, Qxe^Qhux, Qxe^Qhux, Gll^Ftr, Gll^Ftr, Gs, Rmo^Vdm, Gs, Gs, Cd, Cd, Cd, Gll^Ftr, Rmo, Gs, Gs, Gs, Cd^Ii, Dd, Dd, Rd^Esd, Dd, Hd, Hd, Hd, Hd, Dd, Rd, Dd, Dd, Hd, Hd
Dd^Esd, Dd^Vdt, Dd, Dd, Hd, Hd, Hd, Hd, Hd, Hd, Dd, Rd, Dd, Rd, Dd, Dd, Dd, Dd, Cd^Ii, Gs, Cd, Cd, Cd, Gll^Ftr, Rmo, Rmo, Gs, Gs, Gs, Gs, Gll^Ftr, Gll^Ftr, Qxe^Qhux, Qxe^Qhux, Qxe, Qxe, Qxe, Qxu^Bsb|, Qxe, Qxe, Qxe, Qxe^Qhux, Qxe^Qhux, Gll^Ftr, Gll^Ftr, Gs, Gs, Gs, Gs, Rmo, Gll^Ftr, Rmo, Cd, Gs, Gs, Cd^Ii, Cd^Ii, Dd, Dd, Dd, Dd, Hd, Hd, Hd, Dd, Dd^Esd, Rd, Dd, Dd, Hd
Dd^Esd, Dd, Dd, Hd, Hd, Hd, Hd, Hd, Dd, Dd, Dd, Rd, Rd, Dd, Rd, Rd, Dd, Cd^Ii, Gs, Gs, Cd, Kd, Cd, Rmo, Gs, Gs, Gs, Gs, Gs, Gs, Qxe^Qhux, Qxe^Qhux, Qxe, Qxe, Qxe, Qxe, Cd, Cd, Cd, Qxe, Qxe, Qxe, Qxe, Qxe^Qhux, Gll^Ftr, Gs, Gs, Gs, Gs, Rmo, Rmo, Cd, Kd, Cd, Gs, Gs, Cd^Ii, Dd, Dd, Rd, Rd, Hd, Dd, Dd, Rd, Dd, Dd, Dd, Dd, Dd
Dd, Dd, Ce, Ce, Ce, Dd, Dd, Dd, Dd, Dd^Vdt, Dd, Dd, Rd, Dd, Dd, Dd, Dd, Cd^Ii, Gs, Gs, Rmo, Cd, Rmo, Gs, Rmo^Vdm, Gs, Gs, Gs, Cd, Cd, Qxe^Qhux, Qxe, Qxe, Qxe, Qxe, Qxe, Cd, Kd, Cd, Qxe, Qxe, Qxe, Qxe, Qxe^Qhux, Qxe^Qhux, Cd, Cd, Gs, Gs, Gs, Gs, Cd, Cd, Cd, Gs, Gs, Cd^Ii, Dd, Dd^Esd, Dd, Dd, Dd, Dd, Dd, Dd, Rd, Dd, Dd, Rd, Dd
Dd, Dd, Ce, Dd^Vdt, Ce, Ce, Ce, Dd, Rd, Dd^Esd, Rd, Rd, Dd, Rd, Rd, Dd, Dd, Cd^Ii, Gs, Rmo^Vdm, Rmo, Gll^Ftr, Rmo, Gs, Gs, Gs, Cd, Gs, Qxu^Bsb\, Qxe^Qhux, Qxe, Qxe, Qxe, Qxe, Qxu^Bsb/, Qxu^Bsb/, Qxe, Cd, Qxe, Qxu^Bsb\, Qxu^Bsb\, Qxe, Qxe, Qxe, Qxe, Qxe^Qhux, Gs, Gs, Cd, Gs, Gs, Rmo, Gll^Ftr, Rmo, Gs, Gs, Cd^Ii, Dd, Dd, Dd, Dd, Rd, Rd, Dd^Esd, Dd, Rd, Rd, Dd, Dd, Dd
Dd, Dd, Ce, Ce, Ce, Dd^Vdt, Ce, Rd, Rd^Esd, Rd^Esd, Dd^Esd, Rd, Dd, Dd, Dd, Dd, Cd^Ii, Cd^Ii, Gs, Gs, Rmo, Gll^Ftr, Rmo, Gs, Gs, Gs, Cd, Qxe^Qhux, Qxe, Qxu^Bsb\, Cd, Cd, Cd, Qxu^Bsb/, Qxe, Qxe, Qxe, Qxu^Bsb|, Qxe, Qxe, Qxe, Qxu^Bsb\, Cd, Cd, Cd, Qxu^Bsb/, Qxe, Qxe^Qhux, Cd, Gs, Gs, Rmo, Gll^Ftr, Rmo, Gs, Gs, Gs, Cd^Ii, Dd, Dd, Rd, Dd^Vda, Rd, Dd, Dd, Rd, Dd, Dd, Dd, Dd
Dd, Ce, Ce, 3 Ke, Ce, Ce, Ce, Dd, Rd, Rd, Dd, Rd, Rd, Dd^Esd, Dd, Dd, Cd^Ii, Gs, Gs, Gs, Cd, Cd, Cd, Gs, Gll^Ftr, Gll^Ftr, Gll^Ftr, Qxe^Qhux, Qxe, Qxe, Cd, Kd, Cd, Qxe, Qxe, Qxe, Kd, Rmp, Kd, Qxe, Qxe, Qxe, Cd, Kd, Cd, Qxe, Qxe, Qxe^Qhux, Gll^Ftr, Gs, Gs, Rmo, Cd, Rmo, Gs, Gs, Gs, Cd^Ii, Dd, Dd, Rd, Dd, Dd, Dd, Dd, Dd, Rd, Dd, Rd, Rd
Dd, Dd^Esd, Ce, Ce, Ce, Dd^Vdt, Ce, Dd, Dd, Dd, Hd, Dd, Dd, Rd, Rd, Dd, Cd^Ii, Gll^Ftr, Gll^Ftr, Gs, Cd, Kd, Cd, Gs, Gs, Gll^Ftr, Qxe^Qhux, Qxe^Qhux, Qxe, Qxe, Qxe, Cd, Qxe, Qxu^Bsb\, Rmp, Kd, Cd, Rmp, Cd, Kd, Rmp, Qxu^Bsb/, Qxe, Cd, Qxe, Qxe, Qxe, Qxe^Qhux, Gll^Ftr, Rmo^Vdm, Gs, Cd, Kd, Cd, Gs, Rmo^Vdm, Gs, Cd^Ii, Dd, Dd, Dd, Dd, Rd, Dd, Dd, Dd, Rd, Dd^Esd, Dd, Dd
Dd, Dd, Ce, Dd^Vdt, Ce, Ce, Rd^Esd, Dd, Dd, Hd, Hd, Hd, Dd, Dd, Dd^Esd, Dd, Cd^Ii, Gll^Ftr, Gs, Gs, Rmo, Cd, Rmo, Gs, Gs, Gll^Ftr, Qxe^Qhux, Qxe, Qxe, Qxe, Qxe, Qxu^Bsb|, Qxe, Qxe, Kd, Rmp, Cd, Cd, Cd, Rmp, Kd, Qxe, Qxe, Qxu^Bsb|, Qxe, Qxe, Qxe, Qxe^Qhux, Gll^Ftr, Gll^Ftr, Gs, Cd, Cd, Cd, Gs, Gs, Gs, Cd^Ii, Dd, Dd, Dd, Dd, Rd^Esd, Dd, Rd, Dd, Dd, Dd, Hd, Dd
Dd, Dd, Dd, Ce, Dd, Rd, Rd, Dd, Dd^Vdt, Hd, Hd, Hd, Hd, Dd, Dd, Dd, Cd^Ii, Gs, Rmo^Vdm, Gs, Rmo, Gll^Ftr, Rmo, Gs, Gll^Ftr, Gll^Ftr, Qxe^Qhux, Qxe, Qxe, Qxe, Qxe, Qxu^Bsb|, Qxe, Qxe, Kd, Cd, Cd, 2 Kd, Cd, Cd, Kd, Qxe, Qxe, Qxu^Bsb|, Qxe, Qxe, Qxe, Qxe^Qhux, Gll^Ftr, Gll^Ftr, Gs, Rmo, Gll^Ftr, Rmo, Gs, Gs, Gs, Cd^Ii, Dd, Rd, Rd, Rrd, Dd, Dd, Rd, Hd, Hd, Hd, Hd, Hd
Rd^Esd, Rd, Dd, Dd, Dd, Dd, Dd, Dd, Dd, Hd, Hd, Hd, Dd, Dd, Dd, Dd, Cd^Ii, Gs, Gs, Gs, Rmo, Gll^Ftr, Rmo, Gs, Gs, Gll^Ftr, Gll^Ftr, Qxe^Qhux, Qxe^Qhux, Qxe, Qxe, Qxu^Bsb|, Qxe, Qxe, Rmp, Rmp, Cd, Cd, Cd, Rmp, Rmp, Qxe, Qxe, Qxu^Bsb|, Qxe, Qxe, Qxe, Qxe^Qhux, Gll^Ftr, Gll^Ftr, Gs, Rmo, Gll^Ftr, Rmo, Gs, Rmo^Vdm, Gs, Cd^Ii, Dd, Dd, Dd, Dd, Rd, Rd, Dd, Hd, Hd, Hd, Md, Hd
Dd, Rd, Dd^Esd, Dd, Dd^Vdt, Rd^Esd, Dd, Rd, Rd, Dd, Hd, Hd, Dd, Dd, Dd^Esd, Dd, Cd^Ii, Gll^Ftr, Gll^Ftr, Gs, Cd, Cd, Cd, Gs, Gs, Gll^Ftr, Gll^Ftr, Gll^Ftr, Qxe^Qhux, Qxe, Cd, Cd, Cd, Qxu^Bsb/, Qxe, Kd, Kd, Rmp, Kd, Kd, Qxe, Qxu^Bsb\, Cd, Cd, Cd, Qxe, Qxe, Qxe^Qhux, Gll^Ftr, Gll^Ftr, Gs, Rmo, Cd, Rmo, Gs, Gs, Gs, Cd^Ii, Dd, Rd, Dd, Rd^Esd, Dd, Dd, Hd, Hd, Md, Md, Md^Xm, Md
Dd, Dd, Rd, Dd, Rd^Esd, Rd, Rd^Esd, Dd, Dd, Rd, Rd, Dd, Rd, Dd, Dd, Dd, Cd^Ii, Gll^Ftr, Gll^Ftr, Gs, Cd, Kd, Cd, Rmo, Rmo, Gs, Cd, Qxe^Qhux, Qxe, Qxe, Cd, Kd, Cd, Qxe, Qxe, Qxe, Qxe, Rmp, Qxe, Qxe, Qxe, Qxe, Cd, Kd, Cd, Qxe, Qxe^Qhux, Qxe^Qhux, Cd, Gs, Gs, Cd, Kd, Cd, Gs, Gs, Cd^Ii, Cd^Ii, Dd, Rd, Dd, Rd, Dd, Dd, Hd, Hd, Md, Md, Md, Md^Xm
Rrd, Dd, Dd, Dd, Dd, Rd, Rd, Dd, Dd, Dd, Dd, Rd, Dd, Rd, Dd^Esd, Dd, Dd, Cd^Ii, Gs, Gs, Gs, Cd, Rmo, Gs, Rmo, Gs, Cd, Qxe^Qhux, Qxu^Bsb/, Qxu^Bsb/, Qxe, Cd, Qxe, Qxu^Bsb\, Qxu^Bsb\, Qxe, Qxe, Qxu^Bsb|, Qxe, Qxe, Qxu^Bsb/, Qxu^Bsb/, Qxe, Cd, Qxe, Qxu^Bsb\, Qxu^Bsb\, Cd, Gs, Gs, Rmo, Cd, Cd, Cd, Gs, Gs, Cd^Ii, Dd, Dd, Rd, Dd, Rd, Dd, Hd, Hd, Md, Md, Md^Xm, Md, Md
Rmo, Rrd, Rrd, Dd, Dd, Dd^Vdt, Rd, Rd, Dd, Dd, Hd, Dd, Dd, Rd, Rd^Esd, Dd, Dd, Cd^Ii, Cd^Ii, Gs, Gs, Gs, Gs, Rmo, Gll^Ftr, Rmo, Gs, Gs, Qxe^Qhux, Qxe, Qxe, Qxe, Qxe, Qxe, Qxe, Qxu^Bsb\, Cd, Cd, Cd, Qxu^Bsb/, Qxe, Qxe, Qxe, Qxe, Qxe, Qxe^Qhux, Cd, Rmo, Rmo, Gs, Rmo, Gs, Rmo, Gs, Cd^Ii, Cd^Ii, Dd, Dd, Dd, Rd, Dd, Dd^Vda, Dd, Hd, Hd, Md, Md, Md, Md^Xm, Md
Rmo, Rmo, Rmo, Rrd, Rrd, Dd, Dd, Dd, Dd, Hd, Hd, Hd, Dd, Dd, Rd, Dd, Dd, Dd, Dd, Cd^Ii, Gs, Rmo^Vdm, Rmo, Rmo^Ma, Rmo, Rmo, Rmo, Cd, Cd, Qxe^Qhux, Qxe^Qhux, Qxe, Qxe, Qxe, Qxe, Qxe, Cd, 5 Kd, Cd, Qxe, Qxe, Qxe, Qxe, Qxe, Qxe^Qhux, Qxe^Qhux, Cd, Gs, Rmo^Vdm, Rmo, Rmo, Rmo^Aks, Rmo, Gs, Cd^Ii, Dd, Dd, Dd, Rd^Esd, Dd, Rd, Rd, Dd, Dd, Hd, Hd, Md, Md, Md^Xm, Md
Rrd, Rmo, Rmo, Rmo, Rmo, Rrd, Rrd, Dd, Hd, Hd, Hd, Hd, Dd, Dd, Rd, Dd^Esd, Dd, Dd^Esd, Kd^Ii, Cd^Ii, Rmo, Rmo, Rmo, Rmo, Rmo, Gll^Ftr, Rmo, Gs, Gs, Qxe^Qhux, Gll^Ftr, Qxe^Qhux, Qxe^Qhux, Qxe, Qxe, Qxe, Qxe, Cd, Qxe, Qxe, Qxe, Qxe, Qxe^Qhux, Qxe^Qhux, Gll^Ftr, Gll^Ftr, Gs, Gs, Rmo, Rmo, Gs, Rmo, Rmo, Rmo, Rmo, Kd^Ii, Rrd, Rd, Dd, Dd, Dd, Rd, Hd, Hd, Hd, Hd, Md, Md, Md^Xm, Md
Dd^Esd, Rrd, Rrd, Rmo, Rmo, Rmo, Rmo, Rrd, Rrd, Hd, Rrd, Rrd, Rrd, Dd, Dd, Rd, Rrd, Rrd, Rmo, Rmo, Rmo, Rmo, Cd^Ii, Gs, Gs, Rmo, Cd, Cd, Cd, Gs, Gll^Ftr, Gll^Ftr, Gll^Ftr, Qxe^Qhux, Qxe, Qxe, Qxe, Qxu^Bsb|, Qxe, Qxe, Qxe, Qxe, Qxe^Qhux, Gll^Ftr, Gll^Ftr, Gs, Cd, Cd, Cd, Rmo, Gs, Gs, Cd^Ii, Rmo, Rmo, Rmo, Dd, Dd, Rd, Rd, Hd, Hd, Hd, Md, Md, Md, Md^Xm, Md, Md, Md
Dd, Dd, Dd^Esd, Rrd, Rrd, Rmo, Rmo, Rmo, Rmo, Rrd, Rmo, Rmo, Rmo, Rrd, Dd^Vda, Rrd, Rmo, Rmo, Rmo, Rmo, Rrd, Kd^Ii, Dd, Cd^Ii, Cd^Ii, Gs, Cd, Kd, Cd, Gs, Gs, Gll^Ftr, Gll^Ftr, Qxe^Qhux, Qxe, Qxe, Qxe, Qxu^Bsb|, Qxe, Qxe, Qxe, Qxe, Qxe^Qhux, Qxe^Qhux, Rmo, Rmo, Cd, Kd, Cd, Gs, Cd^Ii, Cd^Ii, Dd, Kd^Ii, Rrd, Rrd, Rrd, Hd, Hd, Hd, Hd, Md, Md, Md, Md^Xm, Md^Xm, Md, Md, Md, Hd
Dd, Dd, Dd, Dd^Esd, Dd, Rrd, Rrd, Rmo, Rmo, Rmo, Rmo, Rmo, Rmo, Rmo, Rmo, Rmo, Rmo, Rmo, Rrd, Rrd, Dd^Esd, Dd, Dd, Dd, Cd^Ii, Gs, Gs, Cd, Gll^Ftr, Rmo, Rmo, Rmo^Vdm, Gs, Qxe^Qhux, Qxe, Qxe, Cd, Qxu^Bsb|, Cd, Gs^Ftp, Qxe, Qxe, Qxe^Qhux, Gll^Ftr, Rmo, Gll^Ftr, Rmo, Cd, Gs, Gs, Cd^Ii, Dd, Dd, Dd^Esd, Dd, Dd, Hd, Hd, Hd, Hd, Md, Md, Md^Xm, Md^Xm, Md^Xm, Md, Md, Hd, Hd, Hd
Dd, Dd, Dd, Dd, Hd, Hd, Hd, Rrd, Rrd, Rmo, Rrd, Rrd, Rrd, Rmo, Rmo, Rmo, Rrd, Rrd, Dd, Dd, Rd, Dd^Esd, Dd, Dd, Dd, Cd^Ii, Gs, Rmo, Rmo, Gll^Ftr, Gll^Ftr, Rmo, Rmo, Qxe^Qhux, Qxe^Qhux, Cd, Rmo, Rmo, Rmo, Cd, Gs, Qxe^Qhux, Gs, Rmo, Gll^Ftr, Gll^Ftr, Rmo, Gs, Gs, Cd^Ii, Dd, Dd, Dd^Esd, Dd^Esd, Hd, Hd, Md, Md, Md, Md, Md, Md, Md, Md, Md, Md, Hd, Hd, Hd, Hd
Hd, Hd, Hd, Hd, Hd, Hd, Hd, Hd, Hd, Rrd, Hd, Dd, Dd, Rrd, Rrd, Rrd, Dd, Dd, Rd, Rd, Rd, Dd, Rd^Esd, Dd, Dd, Cd^Ii, Cd^Ii, Gs, Gs, Rmo, Rmo, Gll^Ftr, Cd, Gs, Gs, Gs, Rmo, Gll^Ftr, Rmo, Gs, Rmo^Vdm, Gs, Cd, Rmo, Gll^Ftr, Rmo, Gs, Gs, Cd^Ii, Cd^Ii, Dd, Dd, Dd, Dd, Hd, Hd, Md, Md, Md, Md, Md^Xm, Md, Md, Md, Md, Hd, Hd, Hd, Dd, Dd
Hd, Hd, Hd, Hd, Hd, Hd, Hd, Hd, Hd, Hd, Hd, Dd, Rd, Dd, Rd, Rd, Dd, Rd^Esd, Rd, Dd, Dd, Dd, Rd, Dd, Rd, Dd, Dd, Cd^Ii, Cd^Ii, Gs, Gs, Cd, Kd, Cd, Rmo, Gs, Rmo, Gll^Ftr, Rmo, Gs, Rmo, Cd, Kd, Cd, Rmo, Rmo, Cd^Ii, Cd^Ii, Dd, Dd, Dd^Esd, Dd^Esd, Hd, Hd, Md, Md, Md^Xm, Md, Md^Xm, Md^Xm, Md, Md, Md, Md, Hd, Hd, Hd, Hd, Dd, Dd
Dd, Hd, Dd, Dd, Dd, Hd, Dd, Hd, Hd, Hd, Dd, Dd, Dd, Dd, Dd, Rd, Dd, Dd, Dd, Dd, Hd, Hd, Hd, Rd, Dd, Dd, Dd, Dd, Cd^Ii, Gs, Gs, Cd, Cd, Cd, Gll^Ftr, Rmo, Rmo, Gll^Ftr, Rmo, Rmo, Gll^Ftr, Cd, Cd, Cd, Gs, Gs, Cd^Ii, Dd, Dd, Dd, Dd, Dd, Hd, Hd, Md, Md, Md^Xm, Md^Xm, Md, Md, Md, Md, Md, Md, Hd, Hd, Dd, Dd, Dd^Esd, Rd
Dd, Dd, Dd, Dd^Esd, Dd, Dd, Dd^Esd, Dd, Dd, Dd, Dd, Dd, Dd, Dd^Esd, Dd, Dd, Dd^Esd, Dd, Dd, Dd, Dd^Vda, Hd, Hd, Dd, Dd, Rd, Dd, Dd, Dd, Cd^Ii, Cd^Ii, Gs, Gs, Rmo, Rmo, Gll^Ftr, Rmo, Gll^Ftr, Rmo, Gll^Ftr, Rmo, Rmo, Gs, Gs, Cd^Ii, Cd^Ii, Dd, Dd, Dd, Dd, Hd, Hd, Hd, Hd, Md, Md^Xm, Md^Xm, Md, Md, Md, Md, Md, Hd, Md, Hd, Dd, Dd, Dd, Rd, Dd
Dd^Esd, Dd^Esd, Dd, Dd, Dd, Dd, Dd, Dd, Dd, Dd, Dd^Esd, Dd^Esd, Dd, Dd, Dd, Dd, Dd, Rd, Rd, Dd, Dd, Hd, Hd, Hd, Dd, Rd, Dd, Dd, Dd, Dd, Dd, Cd^Ii, Gs, Gs, Gs, Rmo, Rmo, Rmo, Rmo, Rmo, Gs, Gs, Gs, Cd^Ii, Dd, Dd, Dd, Dd^Esd, Dd, Dd, Hd, Hd, Md, Md, Md^Xm, Md^Xm, Md, Md, Md, Md, Hd, Hd, Hd, Hd, Hd, Dd, Rd^Esd, Rd^Esd, Dd, Dd
Hd, Dd, Hd, Dd, Hd, Dd, Hd, Dd, Hd, Dd, Hd, Dd, Hd, Hd, Hd, Dd, Dd, Rd, Dd, Dd, Dd, Dd, Hd, Hd, Dd, Dd, Rd, Dd, Rd, Dd^Esd, Dd, Cd^Ii, Cd^Ii, Cd^Ii, Cd^Ii, Gs, Rmo, Rmo^Ms, Rmo, Gs, Cd^Ii, Cd^Ii, Cd^Ii, Cd^Ii, Dd, Dd, Dd, Dd, Dd, Hd, Hd, Md, Md, Md, Md^Xm, Md^Xm, Md, Md, Md, Hd, Hd, Hd, Dd, Dd, Dd, Dd, Rd^Esd, Dd, Dd, Dd
Hd, Hd, Hd, Hd, Hd, Hd, Hd, Hd, Hd, Hd, Hd, Hd, Md, Hd, Hd, Hd, Dd, Dd, Dd, Dd, Dd, Hd, Hd, Hd, Dd, Dd, Rd, Dd, Dd^Esd, Dd^Esd, Dd, Dd, Dd, Dd, Dd, Cd^Ii, Rmo, Rmo, Rmo, Cd^Ii, Dd, Dd, Dd, Dd, Dd, Dd^Vda, Dd^Esd, Dd, Dd, Hd, Hd, Md, Md, Md^Xm, Md^Xm, Md, Md, Md, Md, Hd, Hd, Dd, Dd^Esd, Dd^Esd, Rd, Rd, Dd, Dd, Hd, Hd
Md, Hd, Md, Md, Md, Hd, Md, Hd, Md, Md, Md, Md, Md, Md, Md, Dd, Dd, Rd, Dd, Dd^Esd, Dd^Esd, Dd, Dd, Dd, Rd, Rd, Dd, Dd, Rd, Dd, Rd, Dd, Dd^Esd, Dd, Dd, Kd^Ii, Rrd, Rmo, Rrd, Kd^Ii, Dd, Dd, Rd, Dd, Dd^Esd, Rd, Rd^Esd, Dd, Dd, Hd, Hd, Md, Md, Md^Xm, Md, Md, Md, Md, Md, Hd, Hd, Dd, Rd, Rd, Dd, Dd, Hd, Hd, Hd, Hd
Md, Md, Md, Md, Md, Md, Md, Md, Md, Md, Md, Md, Md, Md, Md, Hd, Dd, Dd, Rd, Dd, Dd, Dd, Rd, Dd^Esd, Dd, Dd^Esd, Rd, Dd, Dd, Dd, Dd, Rd, Rd, Dd, Dd, Dd, Rrd, Rmo, Rrd, Dd, Dd, Dd, Dd, Dd, Hd, Rd, Dd, Dd, Dd, Hd, Hd, Md, Md, Md, Md, Md, Md, Md, Hd, Hd, Hd, Dd, Dd^Vdt, Rd, Dd, Hd, Hd, Hd, Hd, Hd
Md, Md, Md, Md, Md, Md, Md, Md, Md, Md, Md, Md, Md, Md, Md, Hd, Rd, Rd, Dd, Dd, Dd, Dd, Dd, Dd, Dd^Esd, Rd, Dd, Dd, Hd, Hd, Hd, Dd, Dd, Dd^Esd, Rd, Dd, Rrd, Rmo, Rrd, Dd, Rd, Dd^Esd, Dd, Dd, Hd, Dd, Dd, Rd, Dd, Hd, Hd, Hd, Hd, Md, Md, Md, Md, Md, Md, Hd, Hd, Hd, Dd, Rd, Dd, Dd, Hd, Hd, Hd, Hd
Md, Md, Md, Md, Md, Md, Md, Md, Md, Md, Md, Md, Md, Md, Md, Dd, Rd, Dd, Hd, Hd, Hd, Hd, Hd, Dd, Dd, Rd, Dd, Dd, Dd, Hd, Hd, Hd, Dd, Dd, Rd, Dd, Rrd, Rmo, Rrd, Dd, Rd^Esd, Dd, Dd, Hd, Hd, Hd, Dd, Dd^Esd, Dd, Dd, Dd, Hd, Hd, Md, Md, Md, Md, Md, Hd, Hd, Hd, Ce, Ce, Ce, Rd, Dd, Dd, Hd, Hd, Hd
Md, Md, Md, Md, Md, Md, Md, Md, Md, Md, Md, Md, Md, Md, Hd, Dd, Rd, Hd, Md, Hd, Hd, Hd, Hd, Dd, Dd, Dd, Rd, Dd, Dd, Hd, Hd, Hd, Hd, Dd, Rd, Dd, Rrd, Rmo, Dd^Vda, Dd, Rd^Esd, Dd, Dd, Hd, Hd, Hd, Hd, Rd, Rd, Dd^Esd, Dd, Dd, Hd, Md, Md, Md, Hd, Hd, Hd, Hd, Ce, Ce, 1 Ke, Ce, Rd, Dd, Dd^Esd, Dd^Esd, Hd, Hd
Md, Md, Md, Md, Md, Md, Md, Md, Md, Md, Md, Md, Md, Md, Dd, Rd, Md, Md, Md, Md, Md, Md, Hd, Hd, Hd, Dd, Dd^Vdt, Rd, Dd, Dd, Hd, Hd, Dd^Vdt, Dd, Rd, Dd, Rrd, Rmo, Rrd, Dd, Dd, Rd, Dd, Dd, Hd, Hd, Dd, Dd, Rd, Dd, Dd^Esd, Dd, Hd, Hd, Hd, Hd, Hd, Hd, Dd, Dd, Dd, Ce^Kov, Ce^Kov, Ce, Dd, Dd, Dd^Vdt, Dd, Dd, Dd
Md, Md, Md, Md, Hd, Md, Md, Md, Md, Md, Md, Md, Md, Md, Rd, Rd, Md, Md, Md, Md, Md, Md, Hd, Hd, Hd, Hd, Dd, Rd^Esd, Rd, Dd, Dd, Dd, Dd^Esd, Dd, Dd, Dd, Rrd, Rmo, Rrd, Dd, Dd, Rd^Esd, Dd, Hd, Hd, Hd, Dd, Dd, Dd, Rd, Dd^Esd, Dd, Dd, Hd, Dd, Hd, Dd, Hd, Dd^Vdt, Dd^Esd, Rd^Esd, Ce, Rd, Rd, Dd, Rd, Rd, Dd^Esd, Dd, Dd
Md, Md, Hd, Hd, Dd, Dd, Rd, Hd, Rd, Dd, Rd, Md, Rd, Dd, Rd, Md, Md, Md, Md, Md, Md, Md, Md, Hd, Hd, Hd, Dd, Dd, Ce, Ce, Ce, Rd, Rd, Rd, Dd^Esd, Rd, Rrd, Rmo, Rmo, Rrd, Rrd, Dd^Esd, Dd, Hd, Dd^Esd, Dd, Dd^Esd, Dd, Rd, Rd, Rd, Dd^Esd, Dd, Hd, Dd, Dd, Dd, Dd, Rd, Rd, Dd, Rd, Dd^Vdt, Dd, Dd, Rd, Dd, Dd, Rd, Rd
Md, Hd, Dd, Dd, Rd, Rd, Hd, Rd, Dd, Rd, Dd, Rd, Dd, Rd, Hd, Md, Md, Md, Md, Md, Md, Md, Md, Hd, Hd, Hd, Dd, Dd, Ce, 4 Ke, Ce, Dd, Rd, Rd, Rd, Dd, Dd, Rrd, Rrd, Rmo, Rmo, Rrd, Rrd, Dd, Dd^Esd, Dd, Dd, Rd, Dd, Rd, Dd, Rd, Dd, Dd, Dd, Dd, Dd^Esd, Rd, Dd, Dd, Hd, Dd, Rd, Dd, Rd^Esd, Rd, Dd^Esd, Dd, Dd, Dd
Dd, Dd, Rd, Rd, Md, Md, Md, Md, Md, Md, Md, Hd, Md, Hd, Md, Md, Md, Md, Md, Md, Md, Md, Md, Md, Hd, Hd, Hd, Dd, Dd, Ce, Rd, Dd, Dd^Vdt, Dd, Dd, Rd, Dd, Rd, Dd, Rrd, Rrd, Rmo, Rmo, Rrd, Dd, Dd, Rd, Dd, Rd^Esd, Rd^Esd, Dd, Dd, Rd, Dd, Rd, Rd^Esd, Dd, Dd, Hd, Hd, Dd, Dd, Dd, Rd, Dd, Dd^Esd, Hd, Dd, Hd, Hd
Rd, Rd, Md, Md, Md, Md, Md, Md, Md, Md, Md, Md, Md, Md, Md, Md, Md, Md, Md, Md, Md, Md, Md, Md, Hd, Hd, Hd, Dd, Dd, Rd^Esd, Dd, Dd, Hd, Hd, Hd, Dd, Dd, Rd, Rd, Dd, Dd^Esd, Rrd, Rmo, Rrd, Dd, Dd, Rd, Dd, Dd, Dd, Dd, Rd, Rd, Rd, Dd, Dd, Dd, Dd, Hd, Hd, Dd, Dd, Dd, Dd, Hd, Dd, Hd, Hd, Hd, Hd
Hd, Hd, Md, Md, Md, Md, Md, Md, Md, Md, Md, Md, Md, Md, Md, Md, Md, Md, Md, Md, Md, Md, Md, Md, Hd, Hd, Hd, Dd^Vdt, Rd^Esd, Dd, Dd, Dd, Hd, Hd, Hd, Hd, Hd, Dd, Rd, Dd, Dd^Esd, Rrd, Rmo, Rrd, Dd, Dd, Dd, Rd^Esd, Rd, Dd, Dd^Esd, Rd, Rd, Dd, Dd, Dd^Esd, Dd, Dd, Hd, Hd, Hd, Dd, Hd, Hd, Hd, Hd, Hd, Hd, Hd, Hd
Md, Md, Md, Md, Md, Md, Md, Md, Md, Md, Md, Md, Md, Md, Md, Md, Md, Md, Md, Md, Md, Md, Md, Md, Hd, Hd, Hd, Dd, Rd, Dd, Hd, Hd, Hd, Hd, Hd, Hd, Hd, Hd, Rd, Rd, Dd, Rrd, Rmo, Rrd, Dd^Esd, Rd^Esd, Dd, Rd^Esd, Rd, Dd, Dd^Esd, Rd, Rd, Rd, Dd, Dd^Esd, Dd, Dd, Dd, Hd, Hd, Hd, Hd, Hd, Hd, Hd, Dd, Hd, Hd, Hd
