Xoi, Xoi, Xoi, Xoi, Xoi, Xoi, Xoi, Xoi, Xoi, Xoi, Xoi, Xoi, Xoi^Efs, Xoi, Xoi, Xoi, Xoi, Xoi, Xoi, Xoi, Xoi, Xoi, Xoi, Xoi, Xoi
Xoi, Xoi, Xoi, Xoi, Xoi, Xoi, Xoi, Xoi, Xoi, Xoi, Xoi, Xoi^Efs, Rmp^Ii, Xoi^Efs, Xoi, Xoi, Xoi, Xoi, Xoi, Xoi, Xoi, Xoi, Xoi, Xoi, Xoi
Xoi, Xoi, Xoi, Xoi, Xoi, Xoi, Xoi, Xoi, Xoi, Xoi, Xoi, Rmp^Ii, Rmp^Ms, Rmp^Ii, Xoi, Xoi, Xoi, Xoi, Xoi, Xoi, Xoi, Xoi, Xoi, Xoi, Xoi
Xoi, Xoi, Xoi, Xoi, Xoi, Xoi, Xoi, Xoi, Xoi^Efs, Xoi, Xoi^Efs, Rmp^Ii, Rmp^Ii, Rmp^Ii, Xoi^Efs, Xoi, Xoi^Efs, Xoi, Xoi, Xoi, Xoi, Xoi, Xoi, Xoi, Xoi
Xoi, Xoi, Xoi, Xoi, Xoi, Xoi, Xoi^Efs, Xoi, Rmp, Rmp, Rmp, Rmp, 2 Rmp^Ii, Rmp, Rmp, Rmp, Rmp, Xoi, Xoi^Efs, Xoi, Xoi, Xoi, Xoi, Xoi, Xoi
Xoi, Xoi, Xoi, Xoi, Xoi^Efs, Xoi, Rmp, Rmp, Rmp, Rmp, Rmp^Ii, Rmp^Ii, Rmp^Ii, Rmp^Ii, Rmp^Ii, Rmp, Rmp, Rmp, Rmp, Xoi, Xoi^Efs, Xoi, Xoi, Xoi, Xoi
Xoi, Xoi, Xoi^Efs, Xoi, Rmp, Rmp, Rmp, Rmp, Rmp^Ii, Rmp^Ii, Rmp, Rmp, Rmp^Ii, Rmp, Rmp, Rmp^Ii, Rmp^Ii, Rmp, Rmp, Rmp, Rmp, Xoi, Xoi^Efs, Xoi, Xoi
Xoi, Xoi, Rmp, Rmp, Rmp, Rmp, Rmp^Ii, Rmp^Ii, Rmp^Ii, Rmp, Rmp, Rmp, Rmp^Ii, Rmp, Rmp, 1 Rmp, Rmp^Ii, Rmp^Ii, Rmp^Ii, Rmp, Rmp, Rmp, Rmp, Xoi, Xoi
Xoi, Rmp, Rmp, Rmp, Rmp^Ii, Rmp^Ii, Rmp, Rmp, Rmp^Ii, Rmp, Rmp^Ii, Rmp^Ii, Rmp, Rmp^Ii, Rmp^Ii, Rmp, Rmp^Ii, Rmp, Rmp, Rmp^Ii, Rmp^Ii, Rmp, Rmp, Rmp, Xoi
Xoi, Rmp, Rmp^Ii, Rmp^Ii, Rmp, Rmp, Rmp^Ii, Rmp^Ii, Rmp, Rmp, Rmp, Rmp, Rmp^Ii, Rmp, Rmp, Rmp, Rmp, Rmp^Ii, Rmp^Ii, Rmp, Rmp, Rmp^Ii, Rmp^Ii, Rmp, Xoi
Xoi, Rmp, Rmp^Ii, Rmp, Rmp^Ii, Rmp^Ii, Rmp, Rmp, Rmp, Rmp, Rmp^Ii, Rmp^Ii, Rmp, Rmp^Ii, Rmp^Ii, Rmp, Rmp, Rmp, Rmp, Rmp^Ii, Rmp^Ii, Rmp, Rmp^Ii, Rmp, Xoi
Xoi, Rmp, Rmp^Ii, Rmp, Rmp^Ii, Rmp, Rmp, Rmp, Rmp^Ii, Rmp^Ii, Rmp, Rmp, Rmp^Ii, Rmp, Rmp, Rmp^Ii, Rmp^Ii, Rmp, Rmp^Ii, Rmp, Rmp^Ii, Rmp, Rmp^Ii, Rmp, Xoi
Xoi, Rmp, Rmp^Ii, Rmp, Rmp^Ii, Rmp, Rmp, Rmp, Rmp^Ii, Rmp, Rmp, Rmp^Ii, Rmp^Ii, Rmp^Ii, Rmp, Rmp, Rmp^Ii, Rmp^Ii, Rmp^Ii, Rmp, Rmp^Ii, Rmp, Rmp^Ii, Rmp, Xoi
Xoi, Rmp, Rmp^Ii, Rmp, Rmp^Ii, Rmp, Rmp, Rmp, Rmp, Rmp^Ii, Rmp^Ii, Rmp, Rmp, Rmp, Rmp^Ii, Rmp^Ii, Rmp, Rmp^Ii, Rmp, Rmp, Rmp^Ii, Rmp, Rmp^Ii, Rmp, Xoi
Xoi, Rmp, Rmp^Ii, Rmp, Rmp^Ii, Rmp, Rmp, Rmp, Rmp, Rmp^Ii, Rmp^Ii, Rmp^Ii, Rmp^Ii, Rmp^Ii, Rmp, Rmp, Rmp^Ii, Rmp, Rmp, Rmp, Rmp^Ii, Rmp, Rmp^Ii, Rmp, Xoi
Xoi, Rmp, Rmp^Ii, Rmp, Rmp^Ii, Rmp, Rmp, Rmp, Rmp, Rmp, Rmp^Ii, Rmp, Rmp^Ii, Rmp, Rmp^Ii, Rmp^Ii, Rmp, Rmp^Ii, Rmp, Rmp, Rmp^Ii, Rmp, Rmp^Ii, Rmp, Xoi
Xoi, Rmp, Rmp^Ii, Rmp, Rmp^Ii, Rmp, Rmp, Rmp, Rmp, Rmp, Rmp^Ii, Rmp, Rmp^Ii, Rmp, Rmp^Ii, Rmp, Rmp, Rmp^Ii, Rmp, Rmp, Rmp^Ii, Rmp, Rmp^Ii, Rmp, Xoi
Xoi, Rmp, Rmp^Ii, Rmp, Rmp, Rmp^Ii, Rmp, Rmp, Rmp^Ii, Rmp^Ii, Rmp, Rmp, Rmp^Ii, Rmp, Rmp, Rmp^Ii, Rmp, Rmp^Ii, Rmp, Rmp^Ii, Rmp, Rmp, Rmp^Ii, Rmp, Xoi
Xoi, Rmp, Rmp, Rmp^Ii, Rmp^Ii, Rmp, Rmp, Rmp, Rmp, Rmp, Rmp, Rmp, Rmp, Rmp^Ii, Rmp^Ii, Rmp, Rmp^Ii, Rmp^Ii, Rmp, Rmp, Rmp^Ii, Rmp^Ii, Rmp, Rmp, Xoi
Xoi, Xoi, Xoi, Rmp, Rmp, Rmp^Ii, Rmp^Ii, Rmp, Rmp^Ii, Rmp^Ii, Rmp^Ii, Rmp, Rmp, Rmp, Rmp, Rmp^Ii, Rmp, Rmp, Rmp^Ii, Rmp^Ii, Rmp, Rmp, Xoi, Xoi, Xoi
Xoi, Xoi, Xoi, Xoi, Xoi, Rmp, Rmp, Rmp^Ii, Rmp, Rmp, Xoi, Rmp, Rmp, Rmp, Xoi, Rmp, Rmp, Rmp^Ii, Rmp, Rmp, Xoi, Xoi, Xoi, Xoi, Xoi
Xoi, Xoi, Xoi, Xoi, Xoi, Xoi, Xoi, Rmp, Xoi, Xoi, Xoi, Rmp, Rmp, Rmp, Xoi, Xoi, Xoi, Rmp, Xoi, Xoi, Xoi, Xoi, Xoi, Xoi, Xoi
Xoi, Xoi, Xoi, Xoi, Xoi, Xoi, Xoi, Xoi, Xoi, Xoi, Xoi, Rmp, Rmp, Rmp, Xoi, Xoi, Xoi, Xoi, Xoi, Xoi, Xoi, Xoi, Xoi, Xoi, Xoi
Xoi, Xoi, Xoi, Xoi, Xoi, Xoi, Xoi, Xoi, Xoi, Xoi, Xoi, Rmp, Rmp, Rmp, Xoi, Xoi, Xoi, Xoi, Xoi, Xoi, Xoi, Xoi, Xoi, Xoi, Xoi
