border_size=1
usage=map

Xmw, Xmw, Xmw, Xmw, Xmw, Xmw, Xmw, Xmw, Xmw, Xmw, Xmw, Xmw, Xmw, Xmw, Xmw, Xmw, Xmw, Xmw, Xmw, Xmw, Xmw, Xmw, Xmw, Xmw, Xmw
Xmw, Xmw, Xmw, Xmw, Xmw, Xmw, Xmw, Xmw, Xmw, Xmw, Xmw, Xmw, Xmw, Xmw, Xmw, Xmw, Xmw, Xmw, Xmw, Xmw, Xmw, Xmw, Xmw, Xmw, Xmw
Xmw, Xmw, Xmw, Xmw, Xmw, Xmw, Xmw, Xmw, Xmw, Xmw, Xmw, Xmw, Xmw, Xmw, Xmw, Xmw, Xmw, Xmw, Xmw, Xmw, Xmw, Xmw, Xmw, Xmw, Xmw
Xmw, Xmw, Xmw, Xmw, Xmw, Xmw, Xmw, Xmw, Xmw, Xmw, Xmw, Xmw, Xmw, Xmw, Xmw, Xmw, Xmw, Xmw, Xmw, Xmw, Xmw, Xmw, Xmw, Xmw, Xmw
Xmw, Xmw, Xmw, Xmw, Xmw, Xmw, Xmw, Xmw, Xmw, Xmw, Xmw, Xmw, Xmw, Xmw, Xmw, Xmw, Xmw, Xmw, Xmw, Xmw, Xmw, Xmw, Xmw, Xmw, Xmw
Xmw, Xmw, Xmw, Xmw, Xmw, Xmw, Xmw, Xmw, Xmw, Xmw, Xmw, Xmw, Xmw, Xmw, Xmw, Xmw, Xmw, Xmw, Xmw, Xmw, Xmw, Xmw, Xmw, Xmw, Xmw
Xmw, Xmw, Xmw, Xmw, Xmw, Xmw, Xmw, Xmw, Xmw, Xmw, Xmw, Xmw, Xmw, Xmw, Xmw, Xmw, Xmw, Xmw, Xmw, Xmw, Xmw, Xmw, Xmw, Xmw, Xmw
Xmw, Xmw, Xmw, Xmw, Xmw, Xmw, Xmw, Xmw, Xmw, Xmw, Xmw, Xmw, Xmw, Xmw, Xmw, Xmw, Xmw, Xmw, Xmw, Xmw, Xmw, Xmw, Xmw, Xmw, Xmw
Xmw, Xmw, Xmw, Xmw, Xmw, Xmw, Xmw, Xmw, Xmw, Xmw, Xmw, Xmw, Xmw, Xmw, Xmw, Xmw, Xmw, Xmw, Xmw, Xmw, Xmw, Xmw, Xmw, Xmw, Xmw
Xmw, Xmw, Xmw, Xmw, Xmw, Xmw, Xmw, Xmw, Xmw, Xmw, Xmw, Xmw, Xmw, Xmw, Xmw, Xmw, Xmw, Xmw, Xmw, Xmw, Xmw, Xmw, Xmw, Xmw, Xmw
Xmw, Xmw, Xmw, Xmw, Xmw, Xmw, Xmw, Xmw, Xmw, Xmw, Rmp, Rmp^Ii, Rmp^As, Rmp^Ii, Rmp, Xmw, Xmw, Xmw, Xmw, Xmw, Xmw, Xmw, Xmw, Xmw, Xmw
Xmw, Xmw, Xmw, Xmw, Xmw, Xmw, Xmw, Xmw, Xmw, Rmp^Ii, Rmp, Rmp^Ii, Rmp, Rmp^Ii, Rmp, Rmp^Ii, Xmw, Xmw, Xmw, Xmw, Xmw, Xmw, Xmw, Xmw, Xmw
Xmw, Xmw, Xmw, Xmw, Xmw, Xmw, Xmw, Xmw, Xmw, Rmp, Rmp, Rmp, Rmp, Rmp, Rmp, Rmp, Xmw, Xmw, Xmw, Xmw, Xmw, Xmw, Xmw, Xmw, Xmw
Xmw, Xmw, Xmw, Xmw, Xmw, Xmw, Xmw, Xmw, Xmw, Rmp, Rmp^Ii, Rmp, Rmp, Rmp, Rmp, Rmp, Xmw, Xmw, Xmw, Xmw, Xmw, Xmw, Xmw, Xmw, Xmw
Xmw, Xmw, Xmw, Xmw, Xmw, Xmw, Xmw, Xmw, Xmw, Rmp, Rmp, Rmp, Rmp, Rmp, Rmp, Rmp, Xmw, Xmw, Xmw, Xmw, Xmw, Xmw, Xmw, Xmw, Xmw
Xmw, Xmw, Xmw, Xmw, Xmw, Xmw, Xmw, Xmw, Xmw, Rmp^Ii, Rmp, Rmp, Rmp, Rmp, Rmp, Rmp^Ii, Xmw, Xmw, Xmw, Xmw, Xmw, Xmw, Xmw, Xmw, Xmw
Xmw, Xmw, Xmw, Xmw, Xmw, Xmw, Xmw, Xmw, Xmw, Xmw, Xmw, Rmp, Rmp, Rmp, Xmw, Xmw, Xmw, Xmw, Xmw, Xmw, Xmw, Xmw, Xmw, Xmw, Xmw
Xmw, Xmw, Xmw, Xmw, Xmw, Xmw, Xmw, Xmw, Xmw, Xmw, Xmw, Rmp, Rmp, Rmp, Xmw, Xmw, Xmw, Xmw, Xmw, Xmw, Xmw, Xmw, Xmw, Xmw, Xmw
Xmw, Xmw, Xmw, Xmw, Xmw, Xmw, Xmw, Xmw, Xmw, Xmw, Xmw, Rmp, Rmp, Rmp, Xmw, Xmw, Xmw, Xmw, Xmw, Xmw, Xmw, Xmw, Xmw, Xmw, Xmw
Xmw, Xmw, Xmw, Xmw, Xmw, Xmw, Xmw, Xmw, Xmw, Xmw, Xmw, Rmp, Rmp, Rmp, Xmw, Xmw, Xmw, Xmw, Xmw, Xmw, Xmw, Xmw, Xmw, Xmw, Xmw
Xmw, Xmw, Xmw, Xmw, Xmw, Xmw, Xmw, Xmw, Xmw, Xmw, Xmw, Rmp, Rmp, Rmp, Xmw, Xmw, Xmw, Xmw, Xmw, Xmw, Xmw, Xmw, Xmw, Xmw, Xmw
Xmw, Xmw, Xmw, Xmw, Xmw, Xmw, Xmw, Xmw, Xmw, Xmw, Xmw, Rmp, Rmp, Rmp, Xmw, Xmw, Xmw, Xmw, Xmw, Xmw, Xmw, Xmw, Xmw, Xmw, Xmw
Xmw, Xmw, Xmw, Xmw, Xmw, Xmw, Xmw, Xmw, Xmw, Xmw, Xmw, Rmp, Rmp, Rmp, Xmw, Xmw, Xmw, Xmw, Xmw, Xmw, Xmw, Xmw, Xmw, Xmw, Xmw
Xmw, Xmw, Xmw, Xmw, Xmw, Xmw, Xmw, Xmw, Xmw, Xmw, Xmw, Rmp, Rmp, Rmp, Xmw, Xmw, Xmw, Xmw, Xmw, Xmw, Xmw, Xmw, Xmw, Xmw, Xmw
