border_size=1
usage=map

Xmw, Xmw, Xmw, Xmw, Xmw, Xmw, Xmw, Xmw, Xmw, Xmw, Xmw, Xmw, Xmw, Xmw, Xmw, Xmw, Xmw, Xmw, Xmw, Xmw, Xmw, Xmw, Xmw, Xmw, Xmw
Xmw, Xmw, Xmw, Xmw, Xmw, Xmw, Xmw, Xmw, Xmw, Xmw, Xmw, Xmw, Rmp^Ii, Xmw, Xmw, Xmw, Xmw, Xmw, Xmw, Xmw, Xmw, Xmw, Xmw, Xmw, Xmw
Xmw, Xmw, Xmw, Xmw, Xmw, Xmw, Xmw, Xmw, Xmw, Xmw, Xmw, Rmp^Ii, Rmp^Ms, Rmp^Ii, Xmw, Xmw, Xmw, Xmw, Xmw, Xmw, Xmw, Xmw, Xmw, Xmw, Xmw
Xmw, Xmw, Xmw, Xmw, Xmw, Xmw, Xmw, Xmw, Xmw, Xmw, Xmw, Rmp^Ii, Rmo^Ii, Rmp^Ii, Xmw, Xmw, Xmw, Xmw, Xmw, Xmw, Xmw, Xmw, Xmw, Xmw, Xmw
Xmw, Xmw, Xmw, Xmw, Xmw, Xmw, Xmw, Xmw, Rmp, Rmp, Rmp, Rmp, 2 Rmo, Rmp, Rmp, Rmp, Rmp, Xmw, Xmw, Xmw, Xmw, Xmw, Xmw, Xmw, Xmw
Xmw, Xmw, Xmw, Xmw, Xmw, Xmw, Rmp, Rmp, Rmo, Rmo, Rmo, Rmo, Rmo, Rmo, Rmo, Rmo, Rmo, Rmp, Rmp, Xmw, Xmw, Xmw, Xmw, Xmw, Xmw
Xmw, Xmw, Xmw, Xmw, Rmp, Rmp, Rmo, Rmo, Rmp, Rmp, Rmp, Rmp, Rmo, Rmp, Rmp, Rmp, Rmp, Rmo, Rmo, Rmp, Rmp, Xmw, Xmw, Xmw, Xmw
Xmw, Xmw, Rmp, Rmp, Rmo, Rmo, Rmp, Rmp, Rmo, Rmo, Rmo, Rmo, Rmp, Rmo, Rmo, 1 Rmo, Rmo, Rmp, Rmp, Rmo, Rmo, Rmp, Rmp, Xmw, Xmw
Xmw, Rmp, Rmo, Rmo, Rmp, Rmp, Rmo, Rmo, Rmp, Rmp, Rmp, Rmp, Rmo, Rmp, Rmp, Rmp, Rmp, Rmo, Rmo, Rmp, Rmp, Rmo, Rmo, Rmp, Xmw
Xmw, Rmp, Rmo, Rmp, Rmo, Rmo, Rmp, Rmp, Rmp, Rmp, Rmo, Rmo, Rmo, Rmo, Rmo, Rmp, Rmp, Rmp, Rmp, Rmo, Rmo, Rmp, Rmo, Rmp, Xmw
Xmw, Rmp, Rmo, Rmp, Rmo, Rmp, Rmp, Rmp, Rmo, Rmo, Rmo, Rmo, Rmp^Ii, Rmo, Rmo, Rmo, Rmo, Rmp, Rmo, Rmp, Rmo, Rmp, Rmo, Rmp, Xmw
Xmw, Rmp, Rmo, Rmp, Rmo, Rmp, Rmp, Rmo, Rmo, Rmo, Rmp^Ii, Rmp^Ii, Rmo, Rmp^Ii, Rmp^Ii, Rmo, Rmo, Rmo, Rmo, Rmp, Rmo, Rmp, Rmo, Rmp, Xmw
Xmw, Rmp, Rmo, Rmp, Rmo, Rmp, Rmp, Rmo, Rmo, Rmp^Ii, Rmp^Ii, Rmo, Rmo, Rmo, Rmp^Ii, Rmp^Ii, Rmo, Rmo, Rmo, Rmp, Rmo, Rmp, Rmo, Rmp, Xmw
Xmw, Rmp, Rmo, Rmp, Rmo, Rmp, Rmp, Rmp, Rmp, Rmo, Rmo, Rmp^Ii, Rmp^Ii, Rmp^Ii, Rmo, Rmo, Rmp, Rmo, Rmp, Rmp, Rmo, Rmp, Rmo, Rmp, Xmw
Xmw, Rmp, Rmo, Rmp, Rmo, Rmp, Rmp, Rmp, Rmp, Rmo, Rmo, Rmo, Rmo, Rmo, Rmp, Rmp, Rmo, Rmp, Rmp, Rmp, Rmo, Rmp, Rmo, Rmp, Xmw
Xmw, Rmp, Rmo, Rmp, Rmo, Rmp, Rmp, Rmp, Rmp, Rmp, Rmo, Rmp, Rmo, Rmp, Rmo, Rmo, Rmp, Rmo, Rmp, Rmp, Rmo, Rmp, Rmo, Rmp, Xmw
Xmw, Rmp, Rmo, Rmp, Rmo, Rmp, Rmp, Rmp, Rmp, Rmp, Rmo, Rmp, Rmo, Rmp, Rmo, Rmp, Rmp, Rmo, Rmp, Rmp, Rmo, Rmp, Rmo, Rmp, Xmw
Xmw, Rmp, Rmo, Rmo, Rmp, Rmp, Rmp, Rmp, Rmo, Rmo, Rmp, Rmp, Rmo, Rmp, Rmp, Rmo, Rmp, Rmo, Rmp, Rmp, Rmp, Rmo, Rmo, Rmp, Xmw
Xmw, Rmp, Rmp, Rmo, Rmo, Rmp, Rmp, Rmp, Rmp, Rmp, Rmp, Rmp, Rmp, Rmo, Rmo, Rmp, Rmo, Rmo, Rmp, Rmp, Rmo, Rmo, Rmp, Rmp, Xmw
Xmw, Xmw, Xmw, Rmp, Rmp, Rmo, Rmo, Rmp, Rmp, Rmp, Rmp, Rmp, Rmp, Rmp, Rmp, Rmo, Rmp, Rmp, Rmo, Rmo, Rmp, Rmp, Xmw, Xmw, Xmw
Xmw, Xmw, Xmw, Xmw, Xmw, Rmp, Rmp, Rmo, Rmo, Rmp, Xmw, Rmp, Rmp, Rmp, Xmw, Rmp, Rmo, Rmo, Rmp, Rmp, Xmw, Xmw, Xmw, Xmw, Xmw
Xmw, Xmw, Xmw, Xmw, Xmw, Xmw, Xmw, Rmp, Xmw, Xmw, Xmw, Rmp, Rmp, Rmp, Xmw, Xmw, Xmw, Rmp, Xmw, Xmw, Xmw, Xmw, Xmw, Xmw, Xmw
Xmw, Xmw, Xmw, Xmw, Xmw, Xmw, Xmw, Xmw, Xmw, Xmw, Xmw, Rmp, Rmp, Rmp, Xmw, Xmw, Xmw, Xmw, Xmw, Xmw, Xmw, Xmw, Xmw, Xmw, Xmw
Xmw, Xmw, Xmw, Xmw, Xmw, Xmw, Xmw, Xmw, Xmw, Xmw, Xmw, Rmp, Rmp, Rmp, Xmw, Xmw, Xmw, Xmw, Xmw, Xmw, Xmw, Xmw, Xmw, Xmw, Xmw
