border_size=1
usage=map

Hh^Fms, Hh^Fms, Hh^Fms, Hh^Fms, Gs^Fms, Gll, Gll, Gll, Gs^Fms, Gs^Fms, Gs^Fms, Gs, Gg, Gg, Gs, Gll, Gg, Gs, Gs^Fms, Gs^Fms, Gg, Gg, Gs^Fms, Gg, Gs^Fms, Gg, Gs^Fms, Gg, Gg, Gg, Gs, Gs, Gs, Gs^Fms, Gs^Fms, Gll, Gs^Fms, Gll, Gll, Gll, Gs^Fms, Gll, Gll, Gll, Gll, Gll, Gs^Fms, Gg, Gs^Fms, Gg, Gs^Fms, Gs, Gg, Gg, Ww, Ww, Ww, Gs, Gs^Fms, Gll, Gs^Fms, Gll, Gs^Fms, Hh^Fms, Mm, Mm, Mm, Mm, Mm, Mm, Mm, Mm
Mm, Hh^Fms, Hh^Fms, Hh^Fms, Gll, Gs^Fms, Gs^Fms, Gll, Gs^Fms, Gll, Gll, Gs, Gs, Gs, Gg, Gg, Gs, Gs, Gs, Gs^Fms, Gs, Gs^Fms, Gs^Fms, Gg, Gs, Gs, Gs, Gll, Gs^Fms, Gs^Fms, Gg, Gs^Fms, Gll, Gs^Fms, Gs^Fms, Gll, Gll, Gs^Fms, Gs, Gs^Fms, Gs^Fms, Gs^Fms, Gs^Fms, Gll, Gs^Fms, Gs^Fms, Gll, Gs^Fms, Gs^Fms, Gg, Gs, Gs, Ww, Ww, Ww, Ww, Gs, Gll, Gll, Gll, Gs^Fms, Gll, Gll, Hh^Fms, Mm, Mm, Mm, Mm, Mm, Mm, Mm, Mm
Mm, Hh^Fms, Hh^Fms, Hh^Fms, Hh^Fms, Gll, Gll, Gs^Fms, Gll, Gs^Fms, Gll, Gs^Fms, Gs, Gg, Gg, Gll, Gg, Gll, Gll, Gs, Gg, Gs, Gs, Gs, Gll, Re^Vct, Gg, Gg, Gll, Gs, Gll, Gs^Fms, Gs^Fms, Gll^Em, Gs, Gs^Fms, Gs^Fms, Gg, Gg^Em, Gll, Gs^Fms, Gs^Fms, Hh, Gll, Gll, Gs^Fms, Gll, Gs^Fms, Gs, Gs, Gg, Ww, Ww, Ww, Gs, Gs, Gs^Fms, Gs^Fms, Gs^Fms, Gs^Fms, Gs^Fms, Gs^Fms, Gll, Hh^Fms, Hh^Fms, Hh^Fms, Mm, Mm, Mm, Mm, Mm, Mm
Mm, Hh^Fms, Hh^Fms, Hh^Fms, Hh^Fms, Gll, Gll, Gs^Fms, Gll, Gs^Fms, Gs, Gll, Gs^Fms, Gg, Gs, Gg^Es, Gll, Gg, Gg, Gll, Gg, Re^Vct, Gs, Gll, 1 Ce, Gll, Gs, Gs^Fms, Gg, Gs^Fms, Gs^Fms, Gll, Gs^Fms, Gs, Gll, Gs^Fms, Gs^Fms, Gs, Gg, Gs^Fms, Hh^Fms, Hh^Fms, Hh^Fms, Gs^Fms, Gll, Gll, Gs^Fms, Gs, Gg, Gg, Ww, Ww, Ww, Gs, Gg, Gs^Fms, Gs^Fms, Gll, Gll, Gs^Fms, Gs^Fms, Gll, Gs^Fms, Gs^Fms, Gll, Hh^Fms, Hh^Fms, Hh^Fms, Mm, Mm, Mm, Mm
Mm, Mm, Hh^Fms, Hh^Fms, Hh^Fms, Hh^Fms, Gs^Fms, Gs^Fms, Gs^Fms, Gll^Em, Gs^Fms, Gs^Fms, Gll, Gll, Gs^Fms, Gs, Gg, Gg, Gs, Gs, Gs, Gll, Gs, Ce, Ke, Ce, Gg, Gs, Re^Vct, Gs, Gs, Gs^Fms, Gs^Fms, Gll, Gs^Fms, Gll, Gg^Em, Gll, Gs^Fms, Hh^Fms, Hh^Fms, Hh^Fms, Hh^Fms, Hh^Fms, Gs^Fms, Gll, Gs, Gs, Gg, Gs, Ww, Ww, Gg, Gs, Gs^Fms, Gs^Fms, Gs^Fms, Gll, Gll, Gs^Fms, Gs^Fms, Gs^Fms, Gs^Fms, Gll, Hh^Fms, Hh^Fms, Hh^Fms, Hh^Fms, Hh^Fms, Mm, Mm, Mm
Mm, Mm, Mm, Hh^Fms, Hh^Fms, Hh^Fms, Hh^Fms, Gll, Gs^Fms, Gll, Gs^Fms, Gs^Fms, Gll, Gs^Fms, Gll, Gs^Fms, Gll, Gs, Gs^Fms, Gs, Gs^Fms, Gs, Gs^Fms, Ce, Ce, Ce, Gs, Gll, Gll, Gll, Gg, Gs, Gs, Gs^Fms, Gg, Gs, Gs^Em, Gs^Fms, Gll, Gs^Fms, Hh, Hh^Fms, Hh^Fms, Hh^Fms, Gll, Gll, Gs, Gg, Gg, Gs, Ww, Ww, Gg, Gs, Gll, Gll, Gll, Gll, Gs^Fms, Gs^Fms, Gll, Gs^Fms, Gs^Fms, Gs^Fms, Gs^Fms, Hh^Fms, Hh^Fms, Hh^Fms, Hh^Fms, Hh^Fms, Mm, Mm
Mm^Xm, Mm, Mm, Hh^Fms, Hh^Fms, Hh^Fms, Hh^Fms, Hh^Fms, Gll, Gll, Gs^Fms, Gs^Fms, Gs^Fms, Gs, Gll, Gs^Fms, Gs^Fms, Gs^Fms, Gll, Gll, Gs^Fms, Gll, Gs^Fms, Gs, Gs, Gll, Gg, Gll, Gg, Gg, Gg, Gll, Gg, Gs, Gs^Fms, Gg, Gs^Fms, Gll, Gs^Fms, Gll, Hh, Hh^Fms, Hh, Gll, Gs^Fms, Gs^Fms, Gs, Gd^Vo, Gg, Gg, Ww, Ww, Gs, Gs^Fms, Gs^Fms, Gll, Gll, Gs^Fms, Gll, Gll, Gll, Gs^Fms, Gs^Fms, Gll, Gll, Hh^Fms, Hh^Fms, Hh^Fms, Hh^Fms, Hh^Fms, Mm, Mm
Mm^Xm, Mm, Mm, Mm, Mm, Hh^Fms, Hh^Fms, Hh^Fms, Hh^Fms, Gs, Gs, Gs^Fms, Gs^Fms, Gll, Gll, Gs^Fms, Gs^Fms, Gll, Gll, Gs^Fms, Gll, Gll, Gll^Em, Gs^Fms, Gs^Fms, Gs, Re^Vct, Gll, Gll, Gg, Gg, Gg, Gs, Gs, Gs, Gll, Gs^Fms, Gll, Gll, Gg, Gs, Hh, Hh, Gs^Fms, Gs^Fms, Gs^Fms, Gs^Fms, Gs, Gs, Gg, Ww, Ww, Ww, Gll, Gll, Gll, Gs^Fms, Gs^Fms, Gll, Gll, Gs^Fms, Gs^Fms, Gll, Gs^Fms, Hh^Fms, Hh^Fms, Hh^Fms, Hh^Fms, Mm, Mm, Mm, Mm
Mm^Xm, Mm, Mm, Mm, Mm, Hh^Fms, Hh^Fms, Hh^Fms, Hh^Fms, Hh^Fms, Gg, Gll, Gs^Fms, Gll^Em, Gs^Fms, Gs^Fms, Gs^Fms, Gs^Fms, Gll, Gll, Gs^Fms, Gll, Gll, Gs^Fms, Gs^Fms, Gs, Gs, Gg, Gll, Gg, Gg, Gll, Gg, Gg, Gg, Gs, Gs, Gs^Fms, Gs, Gg, Gg, Gs, Gg, Gll, Gs^Fms, Gll, Gs^Fms, Gs^Fms, Gs, Gg, Gg, Ww, Ww, Gll, Gs^Fms, Gs^Fms, Gll, Gs^Fms, Gs^Fms, Gll, Gll, Gll, Gs^Fms, Gs^Fms, Hh^Fms, Hh^Fms, Mm, Mm, Mm, Mm, Mm, Mm
Mm^Xm, Mm^Xm, Mm^Xm, Mm, Mm, Mm, Mm, Hh^Fms, Hh^Fms, Hh^Fms, Hh^Fms, Gll, Gll, Gs^Fms, Hh^Fms, Gll, Hh^Fms, Gll, Hh^Fms, Gll, Hh^Fms, Gs^Fms, Gs^Fms, Gs^Fms, Gll, Gs^Fms, Gs^Fms, Gs, Gs, Gg, Gg, Gll, Gg, Gs, Gg, Gll, Gg, Gs^Fms, Gll, Gs^Fms, Gs^Fms, Gs, Gs^Fms, Gs^Fms, Gs^Fms, Gll, Gll, Gs^Fms, Gs^Fms, Gs, Gg, Ww, Ww, Gs, Gs, Gs^Fms, Gs^Fms, Gll, Gs^Fms, Gs^Fms, Gll, Gll, Gll, Hh^Fms, Hh^Fms, Mm, Mm, Mm, Mm, Mm, Mm, Mm
Mm^Xm, Mm, Mm^Xm, Mm^Xm, Mm, Mm, Mm, Mm, Hh^Fms, Hh^Fms, Hh^Fms, Hh^Fms, Hh^Fms, Hh^Fms, Hh^Fms, Hh^Fms, Hh^Fms, Hh^Fms, Hh^Fms, Hh^Fms, Hh^Fms, Hh^Fms, Hh^Fms, Gll, Gll, Gll, Gs^Fms, Gs^Fms, Gs, Gll, Gg, Gll, Gll, Gg, Gs, Gg, Gg, Gs, Gll, Gs^Fms, Gs^Fms, Gll, Gll, Gs^Fms, Gs^Fms, Gll, Gs^Fms, Gs^Fms, Gs^Fms, Gs, Gg, Ww, Ww, Ww, Gg, Gs^Fms, Gs^Fms, Gs^Fms, Gs^Fms, Gll, Gs^Fms, Gll, Gll, Hh^Fms, Mm, Mm, Mm, Mm, Mm, Mm, Mm, Mm
Mm^Xm, Mm, Mm, Mm, Mm, Mm, Mm, Mm, Mm, Hh^Fms, Hh^Fms, Hh^Fms, Hh^Fms, Hh^Fms, Hh^Fms, Hh^Fms, Hh^Fms, Hh^Fms, Hh^Fms, Hh^Fms, Hh^Fms, Hh^Fms, Hh^Fms, Hh^Fms, Gs^Fms, Gs^Fms, Gll^Em, Gs^Fms, Gs, Gs, Gg, Gg^Es, Gg, Gll, Gg, Gg, Gll, Gs, Gs^Fms, Gs^Fms, Gs^Fms, Gll, Gs^Fms, Gs^Fms, Gll^Em, Gs^Fms, Gs^Fms, Gs^Fms, Gs, Gs, Gg, Gg, Ww, Ww, Gg, Gs, Gs, Gll, Gll, Gll, Gs^Fms, Gs^Fms, Gll, Hh^Fms, Hh^Fms, Mm, Mm, Mm, Mm, Mm, Mm, Mm
Mm^Xm, Mm, Mm^Xm, Mm, Mm^Xm, Mm, Mm, Mm, Mm, Hh^Fms, Hh^Fms, Hh^Fms, Mm, Hh^Fms, Hh^Fms, Hh^Fms, Mm, Mm, Mm, Hh^Fms, Mm, Hh^Fms, Hh^Fms, Hh^Fms, Gs^Fms, Gll, Gll, Gs^Fms, Gll, Gs, Gs, Gg, Gg, Gs, Gg, Gs, Gs, Gs, Gs, Gs^Fms, Gll, Gll, Gll, Gs^Fms, Gs^Fms, Gs^Fms, Gs, Gs, Gg, Gs, Ww, Ww, Ww, Ww, Gg, Gg, Gs, Gs^Fms, Gll, Gs^Fms, Gs^Fms, Gs^Fms, Gll, Hh^Fms, Hh^Fms, Mm, Mm, Mm, Mm, Mm, Mm, Mm
Mm^Xm, Mm^Xm, Mm, Mm^Xm, Mm^Xm, Mm^Xm, Mm, Mm, Mm, Mm, Mm, Mm, Mm, Mm, Mm, Mm, Mm, Mm, Mm, Mm, Mm, Hh^Fms, Hh^Fms, Hh^Fms, Hh^Fms, Gs^Fms, Gs^Fms, Gs^Fms, Gll, Gs^Fms, Gs^Fms, Gs, Gg, Gg, Gg, Gg, Gg, Gg, Gs, Gs^Fms, Gll, Gs^Fms, Gs^Em, Gs^Fms, Gs^Fms, Gs, Gg, Gg, Gs, Gg, Ww, Ww, Gg, Gg, Gs^Fms, Gg, Gs, Gs^Fms, Gs^Fms, Gll, Gs^Fms, Gs^Fms, Gs^Fms, Gll, Hh^Fms, Hh^Fms, Hh^Fms, Mm, Mm, Mm, Mm, Mm
Mm^Xm, Mm^Xm, Mm, Mm, Mm^Xm, Mm, Mm^Xm, Mm, Mm, Mm, Mm, Mm, Mm, Mm, Mm, Mm, Mm, Mm, Mm, Mm, Mm, Mm, Hh^Fms, Hh^Fms, Hh^Fms, Gll, Gs^Fms, Gll, Gll, Gll, Gs^Fms, Gs, Gg, Gg, Gg, Gs, Gg, Gg, Gs, Gs^Fms, Gs, Gs, Gg, Gs, Gs, Gs, Ww, Ww, Ww, Ww, Ww, Ww, Gg, Gll, Gs^Fms, Gs, Gd^Vo, Gs, Gs, Gs^Fms, Gs^Fms, Gll, Gll^Em, Gs^Fms, Gs^Fms, Hh^Fms, Hh^Fms, Hh^Fms, Hh^Fms, Hh^Fms, Mm, Mm
Mm^Xm, Mm, Mm, Mm, Mm, Mm^Xm, Mm, Mm^Xm, Mm^Xm, Mm, Mm, Mm, Mm^Xm, Mm, Mm, Mm, Mm, Mm, Mm, Mm, Mm, Mm, Hh^Fms, Hh^Fms, Hh^Fms, Gll^Em, Gll, Gs^Fms, Gs^Fms, Gll, Gs^Fms, Gs, Gs, Gg, Gs^Es, Gg, Gd^Vo, Gg, Gg, Gs, Gg, Gg, Gg, Gg, Ww, Ww, Ww, Ww, Ww, Ww, Gd^Vo, Gg, Gs, Gs^Fms, Gg, Gg, Gg, Gg, Gg, Gs, Gs, Gs^Fms, Gll, Gll, Gll, Gs^Fms, Gs^Fms, Hh^Fms, Hh^Fms, Hh^Fms, Mm, Mm
Mm^Xm, Mm, Mm, Mm, Mm, Mm, Mm, Mm, Mm, Mm, Mm^Xm, Mm^Xm, Mm, Mm, Mm, Mm^Xm, Mm, Mm^Xm, Mm^Xm, Mm, Mm, Mm, Mm, Hh^Fms, Hh^Fms, Hh^Fms, Hh^Fms, Gll, Gll, Gll, Gll, Gs^Fms, Gs, Gs, Gg, Gg, Gg, Gg, Gg, Gg, Gg, Gs, Ww, Ww, Ww, Ww, Gll, Gg, Gs, Gs, Gs, Gg, Gs, Gs, Gg, Gg, Csk, Gg, Csk, Gg, Gg, Gs, Gs^Fms, Gs^Fms, Gll^Em, Gll, Gs^Fms, Gs^Fms, Gll, Hh^Fms, Hh^Fms, Hh^Fms
Mm^Xm, Mm, Mm, Mm, Mm, Mm, Mm, Mm, Mm, Mm, Mm, Mm, Mm, Mm, Mm, Mm, Mm, Mm, Mm^Xm, Mm, Mm, Mm, Mm, Hh^Fms, Hh^Fms, Hh^Fms, Hh^Fms, Gs^Fms, Gll, Gs^Fms, Gs^Fms, Gs, Gg, Gs, Gs, Gg, Gg, Gs, Gs, Gs, Gg, Ww, Ww, Ww, Gs^Fms, Gll, Gs^Fms, Gs^Fms, Gll, Gs^Fms, Hh, Gs, Gs^Fms, Gs, Gg, Csk, Gs, 5 Ksk, Gg, Csk, Gg, Gs, Gs^Fms, Gll, Gs^Fms, Gs^Fms, Gs^Fms, Gll, Gll^Em, Hh^Fms, Hh^Fms, Hh^Fms
Mm^Xm, Mm^Xm, Mm^Xm, Mm, Mm^Xm, Mm, Mm^Xm, Mm, Mm^Xm, Mm, Mm, Mm, Mm, Mm, Mm, Mm^Xm, Ww, Mm, Mm, Mm^Xm, Mm, Mm, Hh^Fms, Hh^Fms, Hh^Fms, Hh^Fms, Hh^Fms, Gs^Fms, Gll, Gs^Fms, Gs, Gs, Ww, Gg, Ww, Gg, Ww, Gg, Gg, Gg^Es, Ww, Ww, Ww, Gll, Hh^Fms, Gs^Fms, Gll, Gll^Em, Gs^Fms, Hh^Fms, Hh^Fms, Hh, Hh^Fms, Gs^Fms, Gll, Csk, Gg, Gs, Gg, Csk, Gg, Gs, Gs^Fms, Gll, Gll^Em, Gll, Gs^Fms, Gll, Gs^Fms, Gs^Fms, Gs^Fms, Gs^Fms
Mm, Mm, Mm, Mm^Xm, Mm, Mm, Mm, Mm, Mm, Mm, Mm^Xm, Mm, Mm, Mm^Xm, Mm, Mm, Mm, Ww, Ww, Mm, Ww, Mm, Ww, Hh^Fms, Hh^Fms, Hh^Fms, Hh^Fms, Gs^Fms, Gs^Fms, Gs^Fms, Ww, Ww, Ww, Wwf, Ww, Ww, Ww, Ww, Ww, Ww, Ww, Ww, Gll, Hh^Fms, Hh, Hh^Fms, Hh, Gll, Gll^Em, Gs^Fms, Gs, Hh, Hh, Gll, Gs^Fms, Csk, Csk, Gs, Csk, Csk, Gg, Gs, Gs^Fms, Gll^Em, Gs^Fms, Gs^Fms, Gll, Gs^Fms, Gll, Gs^Fms, Gll, Gs^Fms
Mm^Xm, Mm, Mm, Mm, Mm^Xm, Mm^Xm, Mm, Mm, Mm, Mm, Mm^Xm, Mm^Xm, Mm^Xm, Mm, Mm^Xm, Mm, Mm^Xm, Mm, Mm, Ww, Mm, Ww, Ww, Ww, Ww, Ww, Ww, Ww, Ww, Ww, Ww, Ww, Gg, Wwf, Gll, Ww, Gs^Fms, Ww, Ww, Ww, Gs^Fms, Gs^Fms, Hh, Hh, Hh, Hh, Hh^Fms, Gs^Fms, Gll^Em, Gll, Hh^Fms, Hh, Hh, Hh^Fms, Gs^Fms, Gs, Gg, Gg, Gg, Gg, Gs, Gs, Gs, Gs^Fms, Gll, Gg, Gg^Em, Gg, Gs^Fms, Gs^Fms, Gll, Gll
Mm^Xm, Mm^Xm, Mm, Mm, Mm, Mm, Mm, Mm, Mm, Mm, Mm, Mm, Mm, Mm, Mm, Mm, Mm^Xm, Mm^Xm, Mm, Mm, Mm, Mm, Mm, Ww, Ww, Ww, Ww, Ww, Ww, Ww, Gll, Gs^Fms, Gll, Gs^Fms, Gll, Gs^Fms, Gll, Gs^Fms, Ww, Ww, Gs^Fms, Hh^Fms, Hh^Fms, Hh^Fms, Hh^Fms, Hh^Fms, Gs^Fms, Gs^Fms, Gll, Gs^Fms, Hh^Fms, Hh^Fms, Gs, Hh^Fms, Gs^Fms, Gll, Gll, Gs, Gs, Gs, Gs^Fms, Gs^Fms, Gg, Gg, Gs^Fms, Gg, Gs^Fms, Gs^Fms, Gll, Gll, Gs^Fms, Gs^Fms
Mm^Xm, Mm, Mm, Mm, Mm, Mm, Mm, Mm, Mm^Xm, Mm^Xm, Mm, Mm, Mm, Mm, Mm, Mm, Mm, Mm^Xm, Mm, Mm, Mm, Mm, Mm, Mm, Hh^Fms, Hh^Fms, Hh^Fms, Gll, Gll, Gs^Fms, Gs, Gs, Gg, Gg, Gs^Fms, Gs, Gg, Gs, Wwf, Wwf, Gg^Es, Gll^Em, Gs^Fms, Hh, Gs^Fms, Hh^Fms, Gs^Fms, Gll, Gll, Gs^Fms, Gs^Fms, Gs^Fms, Gll, Gll, Gs^Fms, Gs^Fms, Gs^Fms, Gs^Fms, Gll, Gs^Fms, Gll, Gs^Fms, Gg, Gs, Gs^Fms, Gll, Gs^Fms, Gll^Em, Gs^Fms, Gs^Fms, Gs^Fms, Gg
Mm^Xm, Mm, Mm^Xm, Mm, Mm, Mm, Mm, Mm^Xm, Mm, Mm, Mm, Mm, Mm, Mm, Mm, Mm, Mm, Mm, Mm, Mm, Mm, Mm, Mm, Mm, Hh^Fms, Hh^Fms, Hh^Fms, Gs^Fms, Gs^Fms, Gs^Fms, Gs, Gg^Es, Gg, Gs, Gs, Gg, Gg, Gg, Wwf, Wwf, Ww, Gs, Gll, Gs^Fms, Gs^Fms, Gll, Gll, Gll, Gs^Fms, Gll, Gll^Em, Gll^Em, Gll, Gs^Fms, Gs^Fms, Gll, Gll^Em, Gll, Gs, Gg, Gs^Fms, Gs, Gg, Gs, Gs, Gs, Gs, Gs^Fms, Gg, Gll, Gg, Gll
Mm, Mm^Xm, Mm, Mm, Mm, Mm^Xm, Mm, Mm, Mm, Mm, Mm, Mm, Mm, Mm, Hh^Fms, Mm, Hh^Fms, Mm, Mm, Mm, Mm, Mm, Mm, Mm, Hh^Fms, Hh^Fms, Gll, Gll^Em, Gs^Fms, Gs^Fms, Gs, Gs, Gg, Gg, Gg, Gg, Gg, Gg, Gg, Ww, Ww, Ww, Ww, Ww, Ww, Ww, Ww, Gs^Fms, Ww, Gs, Gs^Fms, Gs^Fms, Gg, Gll, Gs^Fms, Gs^Fms, Gll^Em, Gs^Fms, Gll, Gs^Fms, Gll, Gs^Fms, Gll, Gg, Gs, Gg, Gg, Gs^Es, Csk, Csk, Csk, Csk
Mm^Xm, Mm^Xm, Mm, Mm, Mm^Xm, Mm^Xm, Mm, Mm, Mm, Mm, Mm, Mm, Mm, Hh^Fms, Hh^Fms, Hh^Fms, Hh^Fms, Hh^Fms, Hh^Fms, Hh^Fms, Hh^Fms, Hh^Fms, Hh^Fms, Hh^Fms, Hh^Fms, Hh^Fms, Gs^Fms, Gs^Fms, Gll, Gs, Gg, Gg, Gg, Gs, Gs^Fms, Gll, Gll, Gg, Gg, Gg, Gg, Ww, Ww, Ww, Ww, Ww, Ww, Ww, Ww, Ww, Ww, Gll, Gg, Gll, Gs^Fms, Gs^Fms, Gs^Fms, Gs^Fms, Gs^Fms, Gll, Gll, Gs^Fms, Gs^Fms, Gg, Csk, Csk, Gg^Es, Gg^Es, Gs^Es, Gg^Es, Gs^Es, Gg^Es
Mm^Xm, Mm^Xm, Mm, Mm^Xm, Mm, Mm, Mm, Mm, Mm, Mm, Hh^Fms, Hh^Fms, Hh^Fms, Hh^Fms, Hh^Fms, Hh^Fms, Hh^Fms, Hh^Fms, Hh^Fms, Hh^Fms, Hh^Fms, Hh^Fms, Hh^Fms, Hh^Fms, Hh^Fms, Hh^Fms, Gll^Em, Gs^Fms, Gs^Fms, Gg, Gg, Gs, Gg, Gs, Gg, Gg, Gs, Gs^Fms, Gs^Fms, Gg, Gs, Gg, Gg^Es, Gg, Gg, Gs, Gs, Ww, Gg, Ww, Ww, Gs, Gs^Fms, Gg, Gs^Fms, Gs^Fms, Gll, Gs^Fms, Gll, Gg, Gs^Fms, Gs^Fms, Gll, Gg, Gg^Es, Gs^Es, Gs, Gs, Gs^Fms, Gs, Gs^Fms, Gs
Mm^Xm, Mm, Mm, Mm, Mm, Mm, Hh^Fms, Mm, Hh^Fms, Hh^Fms, Hh^Fms, Hh^Fms, Hh^Fms, Hh^Fms, Hh^Fms, Hh^Fms, Hh^Fms, Hh^Fms, Hh^Fms, Hh^Fms, Hh^Fms, Hh^Fms, Hh^Fms, Hh^Fms, Hh^Fms, Hh^Fms, Gs^Fms, Gs^Fms, Gs^Fms, Gs, Gg, Gg, Gs, Gg, Gg, Gg, Gg, Gs, Gg, Gg, Gg, Gs, Gs, Gg^Es, Gs, Gs, Gg, Gg^Es, Gs^Es, Ww, Ww, Ww, Gll, Gll, Gs^Fms, Gll^Em, Gs, Gs^Fms, Gs^Fms, Gs, Gs, Gs, Gg, Gs^Fms, Gll, Gs^Fms, Gs, Gs^Fms, Gll, Gll, Gll, Gll
Mm^Xm, Mm, Mm, Mm, Mm, Hh^Fms, Hh^Fms, Hh^Fms, Hh^Fms, Hh^Fms, Hh^Fms, Hh^Fms, Hh^Fms, Hh^Fms, Hh^Fms, Hh^Fms, Hh^Fms, Hh^Fms, Gll^Em, Hh^Fms, Gs^Fms, Hh^Fms, Hh^Fms, Hh^Fms, Gs^Fms, Gll, Gs^Fms, Gs^Fms, Gs, Gs, Gg, Gd^Vo, Gg^Es, Gg, Gs, Gg, Gs, Gg, Gg, Gd^Vo, Gg, Gg, Gg, Gs, Gg, Gg, Gs, Gg, Gg, Gg, Wwf, Ww, Gs^Fms, Gg, Gs, Gll, Gs^Fms, Gs^Fms, Gs^Fms, Gll, Gs^Fms, Gd^Vo, Gg, Gg, Csk, Gs, Gs, Gs^Fms, Gs^Fms, Gs^Fms, Gll, Gs^Fms
Mm^Xm, Mm, Mm, Mm, Mm, Hh^Fms, Hh^Fms, Hh^Fms, Hh^Fms, Hh^Fms, Gs^Fms, Gll, Gll, Gll^Em, Gll, Gll, Gll, Gll, Gs, Gll, Gs^Fms, Gs^Fms, Gll, Gll, Gs^Fms, Gll, Gll, Gs^Fms, Gs, Gg, Gg, Gg, Gg, Gg, Gg, Gg, Gs^Fms, Gg, Gg, Gg, Csk, Csk, Csk, Gs, Gg^Es, Gg, Gs, Gs, Wwr, Ww, Ww, Wwf, Gll, Gs, Gs^Fms, Gs^Fms, Gll, Gll, Gs^Fms, Gs^Fms, Gll, Gg, Gg, Csk, Gg, Gs, Gs^Fms, Gll^Em, Gs^Fms, Gs^Fms, Gs^Fms, Gs^Fms
Mm, Mm, Mm, Mm, Mm, Mm, Hh^Fms, Hh^Fms, Hh^Fms, Gs^Fms, Gs^Fms, Gs^Fms, Gs^Fms, Gll, Gs^Fms, Gs^Fms, Gs^Fms, Gs^Fms, Gs^Fms, Gs^Fms, Gll, Gs^Fms, Gs^Fms, Gs^Fms, Gll, Gs^Fms, Gs^Fms, Gs^Fms, Gs, Gg, Gs, Gs, Gs, Gs, Gll, Gs, Gg, Gll, Gg, Csk, Gll, Gg, 4 Ksk, Csk, Gs, Gs, Gs, Gg, Ww, Ww, Gs, Gs, Gs, Gll, Gs^Fms, Gs^Fms, Gg, Gs, Gs^Fms, Gs^Fms, Gs, Gg, Gg^Es, Csk, Gg, Gs^Es, Gs, Gll, Gs^Fms, Gs^Fms, Gs^Fms, Gll
Mm^Xm, Mm^Xm, Mm^Xm, Mm^Xm, Mm^Xm, Mm, Mm, Hh^Fms, Hh^Fms, Hh^Fms, Gll, Gs^Fms, Gs^Fms, Gs^Fms, Gll^Em, Gll, Gs^Fms, Gs^Fms, Gs, Gs^Fms, Gs, Gll^Em, Gll, Gll, Gs, Gs^Fms, Gs, Gs^Es, Gg, Gg, Gs^Fms, Gll, Gs^Fms, Gs^Fms, Gs^Fms, Gs, Gg, Gg, Gg, Gg, Gg, Gs^Fms, Csk, Csk, Gg, Gg^Es, Gg^Es, Gg^Es, Ww, Ww, Gg, Gs, Gs^Fms, Gs^Fms, Gll, Gs, Gg, Gs, Gs, Gs, Csk, Csk, Gg^Es, Gg^Es, Gs, Gs, Gg, Gs, Gg, Gll^Em, Gs^Fms, Gll
Mm^Xm, Mm, Mm^Xm, Mm^Xm, Mm^Cov, Mm^Cov, Mm, Hh^Fms, Hh^Fms, Hh^Fms, Hh^Fms, Gll, Gs^Fms, Gs^Fms, Gll, Gll, Gs, Gs, Gg, Gs, Gs, Gs^Fms, Gs, Gs^Fms, Gs, Gg, Gg, Gg, Gg, Gs, Gs^Fms, Gs^Em, Gs^Fms, Gll, Gs^Fms, Gg, Gg, Gg, Gg, Gg, Gs, Csk, Gg, Gd^Vo, Gs, Gg^Es, Gg, Ww, Wwf, Ww, Gs^Fms, Gs, Gs, Gs^Fms, Gs, Gg, Csk, Gg^Es, Gg^Es, Csk, Gg, Gg, Gll, Gs, Gs^Fms, Gs^Fms, Gs^Fms, Gll, Gs^Fms, Gg, Gs^Fms, Gll
Mm^Xm, Mm, Mm^Xm, 6 Mm^Kov, Mm^Cov, Mm, Mm, Hh^Fms, Hh^Fms, Hh^Fms, Gll, Gll, Gll, Gs^Fms, Gs^Fms, Gs^Fms, Gs, Gg, Gg^Es, Gs, Gg, Gs, Gg, Gs, Gg, Gg, Gs^Es, Gs, Gg, Gs, Gs^Fms, Gs^Fms, Gll, Gs^Fms, Gs^Fms, Gs, Gg, Gg, Gd^Vo, Gs, Gs^Fms, Gs, Gg, Gg, Gg, Gg, Ww, Wwf, Wwr, Gs, Csk, Gg, Gg, Gs, Gs, Csk, Gs, Csk, Gg^Es, Gg, Gs^Fms, Gs^Fms, Gs^Fms, Gs^Fms, Gll^Es, Gll^Es, Gll, Gs^Fms, Gll, Gs, Gs, Gs
Mm^Xm, Mm, Mm^Xm, Mm^Cov, Mm, Mm^Cov, Hh^Fms, Hh^Fms, Hh^Fms, Hh^Fms, Gs^Fms, Gs^Fms, Gs, Gll, Gs^Fms, Gll, Gs, Gg, Gg, Gs^Fms, Gg, Gg, Gg, Gg, Gs, Gg, Gs, Gg, Gg, Gs, Ww, Ww, Ww, Ww, Ww, Gg, Gg, Gg, Gg, Gs, Gs^Fms, Gs, Gg, Gg, Gs, Ww, Ww, Wwr, Csk, Csk, Gs^Es, Csk, Gs^Es, Gs^Fms, Gg, Gg, Gs^Fms, Gg^Es, Gg^Es, Gs^Fms, Gll, Gs^Fms, Gll^Em, Gll, Csk, Csk, Csk, Gll^Es, Gs^Fms, Gll, Gll^Em, Gll
Mm^Xm, Mm, Mm, Mm^Cov, Mm, Mm, Hh^Fms, Hh^Fms, Hh^Fms, Hh^Fms, Hh^Fms, Gs^Fms, Gll, Gll, Gs^Fms, Gs^Fms, Gs^Fms, Gs, Gg, Gll, Gg, Gg, Gs^Fms, Gs, Gs^Fms, Gg, Gs^Fms, Gs, Ww, Ww, Ww, Ww, Ww, Ww, Ww, Gs, Gs, Gg, Gg, Gs, Gs, Gs, Gg, Gs, Ww, Ww, Ww, Wwr, Csk, Gs, Gg^Es, Gs^Es, Gs^Fms, Gs^Fms, Gs^Fms, Gll, Gs^Fms, Gs, Gs^Fms, Gs^Fms, Gs, Gll^Em, Gs^Fms, Gll^Es, Gs^Es, Ksk, Csk, Gll^Em, Gs^Fms, Gs^Fms, Gs^Fms, Gg
Mm^Xm, Mm, Mm, Mm^Xm, Mm, Mm, Mm, Hh^Fms, Hh^Fms, Hh^Fms, Hh^Fms, Hh^Fms, Hh^Fms, Gs^Fms, Gll, Gll, Gs^Fms, Gs, Gg, Gs^Fms, Gg, Gs, Gs^Fms, Gs^Fms, Gs^Fms, Gs^Fms, Gs^Fms, Ww, Ww, Ww, Ww, Ww, Ww, Ww, Ww, Gs^Fms, Gs^Fms, Gs, Gs, Gg, Gg, Gg, Gg, Gs, Ww, Ww, Gs^Fms, Csk, Gs^Fms, Gg^Es, Gll, Gs^Fms, Gll, Gll, Hh^Fms, Gll, Gs^Fms, Gll, Gll, Gs, Gg, Gs, Gs, Gs^Fms, Gs^Fms, Csk, Gll^Es, Gll, Gs^Fms, Gs^Fms, Gll, Gll
Mm^Xm, Mm, Mm, Mm, Mm, Mm, Mm, Mm, Mm, Hh^Fms, Hh^Fms, Hh^Fms, Hh^Fms, Gll, Gll, Gs^Fms, Gs, Gs, Gg, Gg, Gs, Gs, Gs^Fms, Gll, Gs^Fms, Gll^Em, Gs^Fms, Ww, Ww, Ww, Wo, Wo, Ww, Ww, Ww, Gs^Fms, Gs^Fms, Gs^Fms, Gs, Gg^Es, Gg, Gg, Gs, Gg, Ww, Ww, Wwr, Gs^Fms, Gg^Es, Gs^Es, Gs^Fms, Gs^Fms, Hh^Fms, Hh^Fms, Mm, Hh^Fms, Hh^Fms, Gs^Fms, Gg, Gg, Ksk, Gg, Gg^Es, Gs, Gll, Gs^Fms, Gs^Fms, Gs^Fms, Gs^Fms, Gll^Em, Gs^Fms, Gs^Fms
Mm^Xm, Mm, Mm^Xm, Mm, Mm^Xm, Mm^Xm, Mm, Mm, Mm, Mm, Mm, Hh^Fms, Hh^Fms, Hh^Fms, Hh^Fms, Gll, Gs^Fms, Gs, Gs, Gg, Gs, Gs, Gs, Gs^Fms, Gs^Fms, Gs^Fms, Gll, Ww, Ww, Ww, Wo, Wo, Ww, Ww, Gs^Fms, Gs^Fms, Gs^Fms, Gs, Gg, Gg, Gs, Gg, Ww, Ww, Ww, Wwr, Gs^Es, Gs, Gg^Es, Gs, Gs^Fms, Gs^Fms, Hh^Fms, Mm, Mm, Mm, Hh^Fms, Gll, Ksk, Gg, Gg^Es, Gg^Es, Ksk, Gg, Gs, Gs^Fms, Gll, Gll^Em, Gs^Fms, Gll, Gs^Fms, Gs^Fms
Mm^Xm, Mm, Mm, Mm^Xm, Mm, Mm^Xm, Mm, Mm^Xm, Mm, Mm, Mm, Hh^Fms, Hh^Fms, Hh^Fms, Hh^Fms, Gs^Fms, Gs^Fms, Gs^Fms, Gs^Fms, Gs, Gg, Gg, Ww, Ww, Ww, Gll, Wwf, Ww, Ww, Ww, Wo, Wo, Ww, Ww, Ww, Gs^Fms, Gs, Gs, Gg, Gg, Gs, Gg, Ww, Ww, Gs^Fms, Gg^Es, Csk, Gs, Gs^Fms, Gll, Gll, Gs^Fms, Hh^Fms, Mm, Hh^Fms, Mm, Hh^Fms, Gs^Fms, Gs^Fms, Gg, Gs^Fms, Gg, Gs, Gg, Gg^Es, Gs, Gs^Fms, Gs^Fms, Gs^Fms, Gs^Fms, Gll, Gll
Mm^Xm, Mm^Xm, Mm^Xm, Mm, Mm^Xm, Mm, Mm, Mm, Mm^Xm, Mm, Mm, Mm, Mm, Hh^Fms, Hh^Fms, Gs^Fms, Gll, Gs^Fms, Gs^Fms, Gs, Ww, Ww, Ww, Ww, Ww, Ww, Ww, Wwf, Ww, Ww, Ww, Wo, Wo, Ww, Ww, Ww, Gg, Gg, Gg, Gg, Gg, Gg, Ww, Ww, Gs^Fms, Gs^Es, Csk, Gs^Fms, Gll, Gs^Fms, Gll, Gs^Fms, Gll^Em, Hh^Fms, Gll, Hh^Fms, Gs^Fms, Gs^Fms, Gll, Gll, Gs, Gll, Gs^Fms, Gs, Gg, Gs, Gs^Fms, Gll, Gll^Em, Gll, Gll, Gs^Fms
Mm^Xm, Mm, Mm, Mm, Mm, Mm^Xm, Mm, Mm, Mm, Mm^Xm, Mm, Mm, Mm, Hh^Fms, Hh^Fms, Hh^Fms, Gll^Em, Gll, Gs^Fms, Gs, Ww, Ww, Wo, Wo, Wo, Ww, Ww, Wwf, Ww, Ww, Ww, Wo, Wo, Wo, Ww, Ww, Gs, Gg, Gg, Gg^Es, Gs, Gg, Ww, Ww, Ww, Gs^Es, Gs^Fms, Gs^Fms, Gs^Fms, Gg^Es, Gs^Fms, Gll, Gg, Gs^Fms, Gg, Gs^Fms, Gll, Gs^Fms, Gs^Fms, Gs^Fms, Gg, Gs^Es, Gs, Gs^Fms, Gs, Gs^Es, Gs, Gs, Gs^Es, Gs^Fms, Gs^Fms, Gs^Fms
Mm^Xm, Mm, Mm^Xm, Mm, Mm, Mm, Mm^Xm, Mm, Mm^Xm, Mm, Mm, Mm, Hh^Fms, Hh^Fms, Hh^Fms, Gs^Fms, Gs^Fms, Gs^Fms, Gll, Gs, Ww, Ww, Wo, Wo, Wo, Ww, Ww, Wwf, Gs^Fms, Ww, Ww, Wo, Wo, Wo, Wo, Ww, Ww, Gg, Gg, Gg, Gs, Gg, Gg, Ww, Wwf, Gs, Gg, Gll^Es, Csk, Gll^Es, Gll, Gs^Fms, Gll, Csk, Csk, Gg, Gg, Gs^Fms, Gs^Fms, Gs, Gg^Es, Gg, Csk, Gll, Gs^Fms, Gs^Es, Csk, Gg, Gll^Es, Gs^Fms, Gs^Fms, Gll
Mm^Xm, Mm^Xm, Mm, Mm^Xm, Mm, Mm^Xm, Mm^Xm, Mm^Xm, Mm, Mm, Mm, Mm, Hh^Fms, Hh^Fms, Hh^Fms, Gs^Fms, Gs^Fms, Gs^Fms, Gs, Gs, Gg^Es, Ww, Ww, Wo, Ww, Ww, Gs^Fms, Gs^Fms, Gs^Fms, Ds, Ww, Ww, Ww, Wo, Ww, Ww, Ww, Gg, Gs, Gg, Gg, Gs, Gg, Wwf, Ww, Ww, Gs^Fms, Gll, Gll^Em, Csk, Gll^Em, Gs^Fms, Gll, Ksk, Gg, Gs, Gs, Gg, Gg, Gs^Es, Csk, Csk, Gs, Csk, Gll, Csk, Gg, Csk, Csk, Gll, Gll^Em, Gll
Mm^Xm, Mm, Mm^Xm, Mm, Mm^Xm, Mm, Mm, Mm, Mm, Mm, Hh^Fms, Hh^Fms, Hh^Fms, Hh^Fms, Hh^Fms, Gll, Gll, Gs^Fms, Gs, Gg, Gs, Gg, Ww, Ww, Ww, Ww, Ds, Gs^Fms, Gll^Em, Gs^Fms, Ww, Ww, Wo, Wo, Wo, Ww, Ww, Ww, Gs^Fms, Gs, Gg, Gg, Gs, Gg, Ww, Ww, Ww, Gs^Fms, Gs^Fms, Csk, Gs^Fms, Gs^Fms, Gll, Csk, Gg, Gg, Gs^Fms, Gg^Es, Gg^Es, Csk, Gs, Gs^Es, Gg, Gg, Gs^Fms, Gg, Gs^Es, Gg, Gs, Csk, Gll, Gs^Fms
Mm^Xm, Mm^Xm, Mm^Xm, Mm^Xm, Mm, Mm, Mm, Mm, Mm, Mm, Hh^Fms, Hh^Fms, Hh^Fms, Hh^Fms, Ww, Ww, Ww, Ww, Ww, Gg, Ww, Ww, Ww, Ww, Wo, Ww, Ww, Gs^Fms, Gs^Fms, Gs^Fms, Ww, Ww, Ww, Wo, Wo, Ww, Ww, Gll, Gs^Fms, Gs, Gs, Gg, Gg, Gg, Ww, Ww, Ww, Gs^Fms, Gll^Es, Gs^Fms, Gll^Es, Gs^Fms, Gs^Fms, Gll, Gg, Gs^Fms, Gs, Gg, Gg^Es, Csk, Gg^Es, Gs, Gs^Fms, Gs^Fms, Gs^Fms, Gs^Fms, Gd^Vo, Gg, Gg, Csk, Gll^Es, Gs^Fms
Mm^Xm, Mm^Xm, Mm^Xm, Mm, Mm, Mm, Mm, Mm, Hh^Fms, Hh^Fms, Hh^Fms, Hh^Fms, Ww, Ww, Ww, Ww, Ww, Ww, Ww, Ww, Ww, Ww, Ww, Wo, Wo, Ww, Ww, Ww, Wwf, Ww, Ww, Ww, Wo, Wo, Ww, Ww, Gll, Gs^Fms, Gll^Em, Gs^Fms, Gs, Gg, Gg, Gs, Gg, Ww, Wwf, Gs, Gg^Es, Csk, Gs, Gs^Es, Gll^Es, Gs^Fms, Gs^Fms, Gs^Fms, Gs, Gg^Es, Csk, Gg, Gs^Fms, Gs^Fms, Gll^Em, Gs^Fms, Gs, Gs^Fms, Gs^Fms, Gs^Es, Gs^Es, Gg, Csk, Gll
Mm^Xm, Mm, Ww, Mm, Ww, Mm, Ww, Ww, Ww, Ww, Ww, Gll, Ww, Ww, Gs, Gg, Gs, Gg, Gg, Ww, Ww, Ww, Ww, Wo, Wo, Wo, Ww, Ww, Wwf, Ww, Ww, Ww, Wo, Wo, Ww, Ww, Gs^Fms, Gs^Fms, Gs^Fms, Gs^Fms, Gs, Gg, Gg^Es, Gs, Gg, Wwf, Ww, Ww, Ww, Csk, Csk, Gg^Es, Gs^Fms, Gll^Em, Gs^Fms, Gs, Gg, Csk, Gg, Gll, Gs^Fms, Gs^Fms, Gg, Gg, Csk, Gs, Gg^Es, Gs^Fms, Gs^Fms, Gg^Es, Gg^Es, Csk
Mm^Xm, Mm^Xm, Mm, Ww, Mm, Ww, Ww, Ww, Ww, Ww, Ww, Ww, Ww, Ww, Gg, Gg, Gg, Gg, Gs^Es, Gs, Gg, Ww, Ww, Wo, Wo, Wo, Ww, Ww, Wwf, Ww, Ww, Ww, Ww, Wo, Ww, Ww, Gs^Fms, Gs^Fms, Gs^Fms, Gs, Gg, Gg, Gg, Gs, Gg, Gg, Gg, Ww, Ww, Ww, Wwr, Gs, Csk, Gll, Gs, Gll, Gg^Es, Csk, Gs, Gs^Fms, Gs^Es, Gs, Gg^Es, Csk, 2 Ksk, Csk, Gg, Gg^Es, Gll^Es, Gs^Es, Gs^Es, Csk
Mm^Xm, Mm, Mm, Mm, Mm, Mm, Hh^Fms, Hh^Fms, Hh^Fms, Hh^Fms, Hh^Fms, Ww, Gs^Fms, Gs, Gg, Gg, Gg, Gg, Gs, Gg, Gg, Ww, Ww, Ww, Ww, Wo, Wo, Ww, Ww, Wwf, Wwf, Ww, Ww, Ww, Ww, Ww, Gs^Fms, Gll, Gs^Fms, Gs, Gg, Gg, Gs^Fms, Gs^Fms, Gs, Gg, Gg, Gg, Gg, Ww, Ww, Wwr, Wwr, Gg^Es, Gg^Es, Gs^Fms, Gg, Gg, Gg, Gs^Es, Gs^Fms, Gd^Vo, Gs^Es, Csk, Csk, Csk, Gg, Gs^Fms, Gll, Gs^Fms, Gs, Gg
Mm^Xm, Mm^Xm, Mm^Xm, Mm, Mm, Mm, Mm, Hh^Fms, Hh^Fms, Hh^Fms, Hh^Fms, Gll, Gll^Em, Gs, Gs, Gs, Gs, Gs, Gs^Fms, Gs, Gs, Ww, Ww, Ww, Ww, Ww, Ww, Ww, Ww, Ww, Gs, Ww, Ww, Ww, Ww, Ww, Gs^Fms, Gll, Gs^Fms, Gs, Gd^Vo, Gs, Gg, Gs, Gg, Gs, Gs^Fms, Gg, Gg, Gd^Vo, Ww, Ww, Wwr, Gs^Fms, Gll, Gll, Gg, Csk, Gg, Gg^Es, Gs^Fms, Gll, Gg^Es, Gg, Gg, Gg, Gs^Fms, Gs^Fms, Gg, Gs^Fms, Gg, Csk
Mm, Mm, Mm, Mm^Xm, Mm^Xm, Mm, Mm, Mm, Hh^Fms, Hh^Fms, Hh^Fms, Gll, Gll, Gs^Fms, Gs^Fms, Gs^Fms, Gll, Gs^Fms, Gll, Gs^Fms, Gs^Fms, Gs, Gs^Fms, Gs^Fms, Gs^Fms, Ww, Ww, Ww, Gs^Fms, Gll, Gs^Fms, Gll, Gs^Fms, Gs, Gg, Gs, Gs, Gs^Fms, Gs, Gs, Gg, Gg, Gg, Gg, Gg, Gg, Gs, Gll, Gg, Gg, Ww, Ww, Ww, Csk, Gg^Es, Gs^Fms, Gs^Fms, Csk, Csk, Gg^Es, Gll, Gs^Fms, Gs^Fms, Gll^Es, Gs^Fms, Gs^Fms, Gll^Em, Gs^Fms, Gd^Vo, Gg^Es, Csk, Csk
Mm, Mm, Mm, Mm, Mm, Mm^Xm, Mm, Mm, Hh^Fms, Hh^Fms, Gs^Fms, Gs^Fms, Gs^Fms, Gs^Fms, Gs^Fms, Gs^Fms, Gs^Fms, Gs^Fms, Gs^Fms, Gll, Gll, Gs^Fms, Hh^Fms, Hh^Fms, Hh^Fms, Gs^Fms, Gs^Fms, Gll^Em, Gs^Fms, Gs^Fms, Gs^Fms, Gs^Fms, Gs^Fms, Gs, Gg, Gs, Gg, Gs, Gg^Es, Gg, Gg, Gg^Es, Gg, Gg, Gg, Gg, Gg, Gs^Fms, Gg, Gg, Gg, Ww, Ww, Csk, Gs^Es, Gll, Gs^Fms, Gll, Gg^Es, Gg^Es, Gg, Gs^Fms, Gs^Fms, Gll, Gs^Fms, Gll, Gs^Fms, Gs^Fms, Gs, Gg^Es, Gg, Gg
Mm^Xm, Mm^Xm, Mm, Mm^Xm, Mm, Mm^Xm, Mm, Mm, Hh^Fms, Hh^Fms, Hh^Fms, Gs^Fms, Gll, Gll, Hh^Fms, Gll, Gll^Em, Gll, Hh^Fms, Hh^Fms, Hh^Fms, Hh^Fms, Hh^Fms, Hh^Fms, Hh^Fms, Hh^Fms, Hh^Fms, Gs^Fms, Gs^Fms, Gs^Fms, Gs^Fms, Gll, Gg, Gs, Gs, Gs^Fms, Gg, Gg, Gg, Gg, Gg, Gg, Gg^Es, Csk, Ksk, Csk, Csk, Gg^Es, Gg^Es, Gg, Gs^Fms, Ww, Ww, Wwr, Wwr, Gg^Es, Gll, Gs^Fms, Gll, Csk, Gs, Gll^Em, Gll^Es, Gs^Fms, Gll, Gs^Fms, Gs^Es, Gs^Es, Gg^Es, Csk, Gs^Es, Gll
Mm^Xm, Mm, Mm, Mm, Mm, Mm, Mm, Hh^Fms, Hh^Fms, Hh^Fms, Hh^Fms, Hh^Fms, Hh^Fms, Hh^Fms, Hh^Fms, Hh^Fms, Hh^Fms, Hh^Fms, Hh^Fms, Hh^Fms, Hh^Fms, Hh^Fms, Hh^Fms, Hh^Fms, Hh^Fms, Hh^Fms, Hh^Fms, Hh^Fms, Gs^Fms, Gs^Fms, Gg^Fet, Gg^Fet, Gs, Gs^Es, Gs^Fms, Gll, Gs^Fms, Gg, Gg, Gg, Csk, Csk, Gg^Es, Gg^Es, Csk, Gg^Es, Gg^Es, Gg, Gg, Gll^Es, Gs^Fms, Ww, Ww, Ww, Ww, Csk, Csk, Gs^Fms, Gs^Fms, Csk, Csk, Gs^Es, Gg, Gg^Es, Gg, Gs, Gg, Gg^Es, Csk, Csk, Gs^Es, Gs^Fms
Mm, Mm^Xm, Mm, Mm, Mm^Xm, Mm, Mm, Hh^Fms, Hh^Fms, Hh^Fms, Hh^Fms, Hh^Fms, Hh^Fms, Hh^Fms, Hh^Fms, Hh^Fms, Hh^Fms, Hh^Fms, Hh^Fms, Hh^Fms, Mm, Mm, Mm, Mm, Mm, Hh^Fms, Hh^Fms, Hh^Fms, Gg^Fet, Gs^Fms, Gs, Gg, Gg, Gg, Gg^Fet, Gll, Gs^Fms, Gll, Gg^Es, Gg^Es, Gg^Es, Ksk, Csk, Gg^Es, Csk, Gg^Es, Csk, Ksk, Csk, Gg^Es, Gg, Gll, Gg, Ww, Ww, Gs^Es, Csk, Gll^Es, Gs^Fms, Gll^Em, Gg^Es, Csk, Csk, Csk, Gs^Fms, Csk, Csk, Csk, Gll^Es, Gg^Es, Gll, Gll
Mm, Mm, Mm^Xm, Mm^Xm, Mm, Mm^Xm, Mm, Mm, Mm, Hh^Fms, Mm, Hh^Fms, Hh^Fms, Hh^Fms, Hh^Fms, Hh^Fms, Hh^Fms, Hh^Fms, Mm, Mm, Mm^Xm, Mm^Xm, Mm^Xm, Mm, Mm, Mm, Hh^Fms, Hh^Fms, Gg, Gg, Gg, Gg, Gs, Gs, Gs, Gs^Fms, Gll, Gs^Fms, Gs^Es, Gg, Gg^Es, Gg^Es, Gg^Es, Csk, 3 Ksk, Csk, Gg^Es, Gg^Es, Csk, Gg, Gs, Gs^Fms, Gll, Ww, Ww, Ww, Wwr, Gg^Es, Gs, Gll, Gs^Fms, Gg^Es, Gs^Fms, Gs^Fms, Gll^Es, Gs^Fms, Gs^Fms, Gll, Gs^Fms, Gll^Em, Gs^Fms, Gs^Fms
Mm, Mm, Mm, Mm, Mm, Mm^Xm, Mm, Mm, Mm, Mm, Mm, Mm, Mm, Mm, Mm, Hh^Fms, Mm, Mm, Mm^Xm, Mm^Xm, Mm, Mm, Mm, Mm, Hh^Fms, Hh^Fms, Gg^Fet, Gg^Fet, Gg, Gg, Gs^Fms, Gs^Fms, Gll, Gs^Fms, Gs^Fms, Gll^Em, Gs^Fms, Gs^Fms, Gs^Es, Gg, Csk, Gg^Es, Csk, Gg^Es, Csk, Csk, Csk, Gg^Es, Csk, Gg, Gs^Es, Gs^Fms, Gll^Em, Gs^Fms, Gs^Fms, Ww, Ww, Wwr, Wwr, Gs^Fms, Gg, Gll^Es, Gs^Fms, Gll^Es, Gg^Es, Gll^Es, Gs^Fms, Gs^Fms, Gs^Fms, Gs^Fms, Gll^Es, Gll
Mm, Mm, Mm, Mm, Mm, Mm^Xm, Mm^Xm, Mm^Xm, Mm^Xm, Mm^Xm, Mm^Xm, Mm, Mm^Xm, Mm, Mm^Xm, Mm, Mm^Xm, Mm, Mm, Mm, Hh^Fms, Mm, Hh^Fms, Hh^Fms, Gg^Fet, Gg^Fet, Gg^Es, Gg, Gg^Fet, Gg^Fet, Gs^Fms, Gll^Em, Gs^Fms, Gg^Fet, Gs^Fms, Gll^Em, Gs^Fms, Gs^Fms, Gs, Gg^Es, Gg, Ksk, Gg^Es, Gg^Es, Csk, Gg^Es, Gg^Es, Ksk, Gg, Gs^Es, Gs^Fms, Gs^Fms, Gll, Gll^Em, Hh^Fms, Gs^Fms, Gll^Em, Ww, Wwr, Gs, Gg, Gll^Es, Gs^Fms, Gs^Fms, Gg^Es, Gs^Fms, Gll^Em, Gs^Fms, Gs^Fms, Gs^Fms, Gll^Es, Gs^Fms
Hh^Fms, Mm, Hh^Fms, Mm, Mm, Mm, Mm, Mm, Mm, Mm, Mm, Mm^Xm, Mm, Mm^Xm, Mm, Mm^Xm, Mm, Mm, Hh^Fms, Hh^Fms, Gg^Fet, Hh^Fms, Gg^Fet, Gg^Fet, Gg, Gg, Gg^Fet, Gg^Fet, Hh^Fms, Hh^Fms, Hh^Fms, Hh^Fms, Hh^Fms, Gs^Fms, Gs^Fms, Gs^Fms, Gll, Gs^Fms, Gs, Gg, Gg^Es, Csk, Csk, Gg^Es, Ksk, Gg^Es, Csk, Csk, Gg, Gs, Gs^Fms, Gs^Fms, Hh^Fms, Hh, Hh, Hh, Hh^Fms, Ww, Ww, Wwr, Gs^Fms, Gll, Gs^Fms, Gll, Gs^Fms, Gll^Es, Gs^Fms, Gll, Gll, Gll^Es, Gs^Fms, Gs^Fms
Gg^Fet, Hh^Fms, Gg^Fet, Hh^Fms, Hh^Fms, Hh^Fms, Hh^Fms, Hh^Fms, Hh^Fms, Mm, Hh^Fms, Mm, Hh^Fms, Mm, Hh^Fms, Hh^Fms, Hh^Fms, Hh^Fms, Gg^Fet, Gg^Fet, Gg^Es, Gg^Fet, Gg, Gg, Gg^Fet, Gg^Fet, Hh^Fms, Hh^Fms, Hh^Fms, Hh^Fms, Hh^Fms, Hh^Fms, Hh^Fms, Gll, Gs^Fms, Gs^Fms, Gs^Fms, Gs^Fms, Gg, Gg^Es, Gs, Gg^Es, Gg^Es, Gg, Gg, Csk, Gg, Gg, Gs^Es, Gg, Gll, Gs^Fms, Hh^Fms, Hh, Hh, Hh, Hh^Fms, Gs^Fms, Ww, Wwr, Gs^Fms, Gs^Fms, Gll^Em, Gll, Gs^Fms, Gs^Fms, Gll^Es, Gs^Fms, Gll^Em, Gs^Fms, Gs^Fms, Gll
Gg^Es, Gg, Gg, Gg^Fet, Gg, Gg^Fet, Gg^Fet, Gg^Fet, Gg^Fet, Hh^Fms, Gg^Fet, Hh^Fms, Gg^Fet, Hh^Fms, Gg^Fet, Gg^Fet, Gg^Fet, Gg^Fet, Gg, Gg, Gg, Gg, Gg^Fet, Gg^Fet, Hh^Fms, Hh^Fms, Mm, Hh^Fms, Hh^Fms, Hh^Fms, Hh^Fms, Hh^Fms, Hh^Fms, Gll, Gs^Fms, Gll^Em, Gs^Fms, Gll, Gs^Fms, Gs, Gg, Gg, Gs, Gg, Gg^Es, Gg, Gs^Es, Gg, Gg, Gg, Gg, Gs^Fms, Gs^Fms, Hh^Fms, Gll^Em, Hh, Gs^Fms, Gs^Fms, Ww, Wwr, Gs^Fms, Gs^Fms, Gll, Gs^Fms, Gs, Gg, Gll^Em, Gll^Es, Gll, Gs^Fms, Gll, Gll
Gg^Fet, Gg, Gg^Fet, Gg, Gg^Fet, Gg^Es, Gg^Es, Gg, Gg, Gg, Gg, Gg, Gg, Gg, Gg^Es, Gg, Gg, Gg, Gg^Fet, Gg, Gg^Fet, Gg^Fet, Hh^Fms, Hh^Fms, Mm, Mm, Mm, Mm, Hh^Fms, Hh^Fms, Hh^Fms, Hh^Fms, Hh^Fms, Gll, Gs^Fms, Gs^Fms, Gs, Gg, Gll, Gs^Fms, Gll, Gs^Fms, Gs, Gs, Gd^Vo, Gg, Gg, Gg, Ww, Ww, Ww, Ww, Ww, Gs^Fms, Wwf, Gll, Ww, Ww, Ww, Wwr, Gs, Gs^Fms, Gg^Es, Gs^Es, Gs, Gs^Fms, Gs^Fms, Gs^Fms, Gll, Gs^Fms, Csk, Gll^Es
Hh^Fms, Hh^Fms, Hh^Fms, Hh^Fms, Hh^Fms, Gg^Fet, Hh^Fms, Gg^Fet, Gg^Fet, Gg^Fet, Hh^Fms, Gg^Fet, Hh^Fms, Gg^Fet, Hh^Fms, Gg^Fet, Gg^Fet, Gg^Fet, Hh^Fms, Gg^Fet, Hh^Fms, Hh^Fms, Mm^Xm, Mm, Mm^Xm, Mm^Xm, Mm, Mm, Hh^Fms, Hh^Fms, Hh^Fms, Hh^Fms, Gll^Em, Gll, Gs^Fms, Gll, Gs^Fms, Gg, Gs^Fms, Gg, Gg, Gll, Gs^Fms, Gg, Gg, Gg, Ww, Ww, Ww, Ww, Ww, Ww, Ww, Ww, Wwf, Ww, Ww, Ww, Gs^Es, Gg, Gg^Es, Gs^Es, Gg^Es, Gg, Gg, Gs^Es, Gs^Es, Gll, Gs^Fms, Csk, Gs^Es, Csk
Mm, Mm, Mm, Mm, Mm, Hh^Fms, Mm, Hh^Fms, Hh^Fms, Hh^Fms, Mm, Hh^Fms, Mm, Hh^Fms, Mm, Hh^Fms, Hh^Fms, Hh^Fms, Mm, Hh^Fms, Mm, Mm, Mm^Xm, Mm^Xm, Mm, Mm, Mm, Mm, Hh^Fms, Hh^Fms, Hh^Fms, Hh^Fms, Hh^Fms, Gs^Fms, Gs^Fms, Gll, Gg, Gll^Em, Gs^Fms, Gs, Gg, Gs^Fms, Gs, Gs, Ww, Ww, Ww, Ww, Gs^Fms, Gll, Gs^Fms, Gs, Gs, Ww, Gg, Ww, Gg, Gs, Gll^Es, Csk, Csk, Csk, Gll, Csk, Csk, Csk, Csk, Gg^Es, Gs^Fms, Gs^Fms, Gg^Es, Gs
Mm^Xm, Mm^Xm, Mm^Xm, Mm, Mm^Xm, Mm, Mm, Mm, Mm, Mm, Mm, Mm, Mm, Mm, Mm, Mm, Mm, Mm, Mm, Mm, Mm, Mm^Xm, Mm, Mm, Mm, Mm, Mm, Hh^Fms, Hh^Fms, Hh^Fms, Hh^Fms, Hh^Fms, Hh^Fms, Gs^Fms, Gll, Gs^Fms, Gs, Gll, Gs^Fms, Gs, Gg^Es, Gg, Gg, Gg, Ww, Ww, Gs^Em, Gll, Gs^Fms, Gs^Fms, Gs^Fms, Gs^Fms, Gs^Fms, Gg^Es, Gs^Fms, Gll, Gs^Fms, Gs^Fms, Gs^Fms, Gll, Gs^Fms, Gll, Gs^Fms, Gll, Gll, Gs, Gll, Gll^Es, Gll, Gll, Gll, Gll
Mm, Mm, Mm, Mm^Xm, Mm, Mm^Xm, Mm^Xm, Mm, Mm^Xm, Mm^Xm, Mm^Xm, Mm^Xm, Mm^Xm, Mm, Mm, Mm, Mm, Mm, Mm^Xm, Mm^Xm, Mm, Mm^Xm, Mm, Mm, Mm, Mm, Mm, Mm, Mm, Hh^Fms, Hh^Fms, Hh^Fms, Hh^Fms, Hh^Fms, Gg, Gs^Fms, Gs^Fms, Gs^Fms, Gg, Gs, Gg, Gg, Gg, Gg, Ww, Ww, Ww, Gs^Fms, Gs^Fms, Gs^Fms, Gg, Gll, Gg, Gs^Fms, Gg, Gll, Gg, Gs^Fms, Gg, Gll^Em, Gg, Gs^Fms, Gg, Gs^Fms, Gg, Gg, Gs^Fms, Gs^Fms, Gg, Gs^Fms, Gs^Fms, Gs^Fms
