Ur^Ii, Ur, Qxua, Uu^Ufi, Xue, Qxua, Qxua, Xue, Xue, Xue, Uue, Ur^Ii, Xue, Uue^Vcl, Xue, Xue, Xue, Xue, Xue, Xue, Xue, Xue, Xue, Xue, Xue, Xue, Xue, Xue, Xue, Xue, Xue, Xue, Xue, Xue, Xue, Xue, Xue, Xue, Xue, Xue, Xue, Xue, Xue, Xue, Xue
Uu^Ufi, Qxua, Qxua, Xue, Xue, Qxua, Qxua, Xue, Xue, Uu^Ufi, Ur^Ii, Ur^Ii, Xue, Uue, Uu^Ufi, Xue, Xue, Xue, Xue, Xue, Xue, Xue, Xue, Xue, Xue, Xue, Xue, Xue, Xue, Xue, Xue, Xue, Xue, Xue, Xue, Xue, Xue, Xue, Xue, Xue, Xue, Xue, Xue, Xue, Xue
Xue, Xue, Qxua, Xue, Qxua, Qxua, Qxua, Xue, Xue, Ur, Xue, Xue, Xue, Uue, Uue^Ii, Xue, Xue, Xue, Xue, Xue, Xue, Xue, Xue, Xue, Xue, Xue, Xue, Xue, Xue, Xue, Xue, Xue, Xue, Xue, Xue, Xue, Xue, Xue, Xue, Xue, Xue, Xue, Xue, Xue, Xue
Xue, Qxua, Qxua, Qxua, Qxua, Qxua, Qxua, Qxua, Xue, Ur^Ii, Ur^Ii, Xue, Xue, Xue, Uue^Ii, Xue, Xue, Xue, Xue, Xue, Xue, Xue, Xue, Xue, Xue, Xue, Xue, Xue, Xue, Xue, Xue, Xue, Xue, Xue, Xue, Xue, Xue, Xue, Xue, Xue, Xue, Xue, Xue, Xue, Xue
Xue, Xue, Xue, Qxua, Qxua, Qxua, Qxua, Qxua, Xue, Uue^Ii, Uue^Ii, Ur, Uu^Ufi, Uue^Ii, Xue, Xue, Xue, Xue, Xue, Xue, Xue, Xue, Xue, Xue, Xue, Xue, Xue, Xue, Xue, Xue, Xue, Xue, Xue, Xue, Xue, Xue, Xue, Xue, Xue, Xue, Xue, Xue, Xue, Xue, Xue
Xue, Xue, Xue, Xue, Xue, Xue, Xue, Qxua, Xue, Xue, Uue, Ur^Ii, Uu^Ufi, Uue^Ii, Xue, Xue, Xue, Xue, Xue, Xue, Xue, Xue, Xue, Xue, Xue, Xue, Xue, Xue, Xue, Xue, Xue, Xue, Xue, Xue, Xue, Xue, Xue, Xue, Xue, Xue, Xue, Xue, Xue, Xue, Xue
Ur^Ii, Uu^Ufi, Uue, Uue, Uue^Ii, Xue, Xue, Qxua, Qxua, Xue, Uue, Ur, Ur, Uue, Xue, Xue, Xue, Xue, Xue, Xue, Xue, Xue, Xue, Xue, Xue, Xue, Xue, Xue, Xue, Xue, Xue, Xue, Xue, Xue, Xue, Xue, Xue, Xue, Xue, Xue, Xue, Xue, Xue, Xue, Xue
Ur, Uue^Ii, Xue, Xue, Xue, Uue^Ii, Uue^Ii, Xue, Qxua, Qxua, Uu^Ufi, Uu^Ufi, Uue, Uh, Uh^Ii, Xue, Xue, Xue, Xue, Xue, Xue, Xue, Xue, Xue, Xue, Xue, Xue, Xue, Xue, Xue, Xue, Xue, Xue, Xue, Xue, Xue, Xue, Xue, Xue, Xue, Xue, Xue, Xue, Xue, Xue
Ur, Uue^Ii, Uu^Ufi, Xue, Xue, Xue, Uh^Ii, Uue, Uue^Vcl, Qxua, Uue^Ii, Uue^Ii, Uue^Ii, Uue^Vcl, Uue, Qxua, Qxua, Xue, Xue, Xue, Xue, Xue, Xue, Xue, Xue, Xue, Xue, Xue, Xue, Xue, Xue, Xue, Xue, Xue, Xue, Xue, Xue, Xue, Xue, Xue, Xue, Xue, Xue, Xue, Xue
Uu^Ufi, Ur^Ii, Ur, Ur, Ur, Uh, Uh, Uue^Ii, Uue, Uue^Ii, Uue^Cov, Uue^Cov, Uue^Cov, Uh^Ii, Uh, Qxua, Qxua, Xue, Xue, Xue, Xue, Xue, Xue, Xue, Xue, Xue, Xue, Xue, Xue, Xue, Xue, Xue, Xue, Xue, Xue, Xue, Xue, Xue, Xue, Xue, Xue, Xue, Xue, Xue, Xue
Uu^Ufi, Ur, Xue, Xue, Xue, Ur, Ur, Uue^Ii, Uh^Ii, Uh^Ii, Uue^Cov, Uue^Kov, Uue^Cov, Uh^Ii, Uh^Ii, Uu^Ufi, Uu^Ufi, Xue, Xue, Xue, Xue, Xue, Xue, Xue, Xue, Xue, Xue, Xue, Xue, Xue, Xue, Xue, Xue, Xue, Xue, Xue, Xue, Xue, Xue, Xue, Xue, Xue, Xue, Xue, Xue
Ur, Ur, Xue, Xue, Xue, Xue, Uu^Ufi, Uue^Vcl, Uh^Ii, Uue^Cov, Uue^Kov, Uue^Vs, Uue^Kov, Uue^Cov, Uue^Ii, Uue^Vcl, Uu^Ufi, Xue, Xue, Xue, Xue, Xue, Xue, Xue, Xue, Xue, Xue, Xue, Xue, Xue, Xue, Xue, Xue, Xue, Xue, Xue, Xue, Xue, Xue, Xue, Xue, Xue, Xue, Xue, Xue
Uue, Uue^Ii, Uue, Xue, Uu^Ufi, Xue, Uu^Ufi, Uue^Ii, Uh^Ii, Uue^Cov, Uue^Cov, Uue^Cov, Uue^Cov, Uue^Cov, Uue^Ii, Uue^Ii, Qxua, Xue, Xue, Xue, Xue, Xue, Xue, Xue, Xue, Xue, Xue, Xue, Xue, Xue, Xue, Xue, Xue, Xue, Xue, Xue, Xue, Xue, Xue, Xue, Xue, Xue, Xue, Xue, Xue
Uue, Uue^Ii, Xue, Uue, Uue, Xue, Uue^Ii, Uue^Ii, Uue^Vcl, Uh^Ii, Uue^Cov, 2 Uue^Kov, Uue^Cov, Uh^Ii, Uue^Vcl, Qxua, Qxua, Xue, Xue, Xue, Xue, Xue, Xue, Xue, Xue, Xue, Xue, Xue, Xue, Xue, Xue, Xue, Xue, Xue, Xue, Xue, Xue, Xue, Xue, Xue, Xue, Xue, Xue, Xue, Xue
Uh^Ii, Xue, Xue, Xue, Xue, Uue^Ii, Uue, Uue^Ii, Uu^Ufi, Uue^Ii, Uue^Ii, Uue^Cov, Uh^Ii, Uh^Ii, Qxua, Qxua, Qxua, Xue, Xue, Xue, Xue, Xue, Xue, Xue, Xue, Xue, Xue, Xue, Xue, Xue, Xue, Xue, Xue, Xue, Xue, Xue, Xue, Xue, Xue, Xue, Xue, Xue, Xue, Xue, Xue
Xue, Xue, Xue, Xue, Xue, Xue, Xue, Qxua, Qxua, Uu^Ufi, Uue, Uue^Ii, Uue^Ii, Uue^Vcl, Qxua, Qxua, Xue, Xue, Xue, Xue, Xue, Xue, Xue, Xue, Xue, Xue, Xue, Xue, Xue, Xue, Xue, Xue, Xue, Xue, Xue, Xue, Xue, Xue, Xue, Xue, Xue, Xue, Xue, Xue, Xue
Xue, Xue, Xue, Xue, Xue, Xue, Xue, Xue, Qxua, Uu^Ufi, Uue, Uue^Ii, Uue, Uue^Ii, Xue, Xue, Xue, Xue, Xue, Xue, Xue, Xue, Xue, Xue, Xue, Xue, Xue, Xue, Xue, Xue, Xue, Xue, Xue, Xue, Xue, Xue, Xue, Xue, Xue, Xue, Xue, Xue, Xue, Xue, Xue
Xue, Xue, Xue, Xue, Xue, Xue, Xue, Xue, Qxua, Uue^Ii, Uue^Ii, Uue^Ii, Uue, Uue^Ii, Xue, Xue, Xue, Xue, Xue, Xue, Xue, Xue, Xue, Xue, Xue, Xue, Xue, Xue, Xue, Xue, Xue, Xue, Xue, Xue, Xue, Xue, Xue, Xue, Xue, Xue, Xue, Xue, Xue, Xue, Xue
Xue, Xue, Xue, Xue, Xue, Xue, Xue, Xue, Xue, Qxua, Uu^Ufi, Uue, Uue^Ii, Uu^Ufi, Xue, Xue, Xue, Xue, Xue, Xue, Xue, Xue, Xue, Xue, Xue, Xue, Xue, Xue, Xue, Xue, Xue, Xue, Xue, Xue, Xue, Xue, Xue, Xue, Xue, Xue, Xue, Xue, Xue, Xue, Xue
Xue, Xue, Xue, Xue, Xue, Xue, Xue, Xue, Xue, Xue, Uu^Ufi, Uue^Ii, Uue, Uu^Ufi, Uu^Ufi, Xue, Xue, Xue, Xue, Xue, Xue, Xue, Xue, Xue, Xue, Xue, Xue, Xue, Xue, Xue, Xue, Xue, Xue, Xue, Xue, Xue, Xue, Xue, Xue, Xue, Xue, Xue, Xue, Xue, Xue
Xue, Xue, Xue, Xue, Xue, Xue, Xue, Xue, Xue, Uu^Ufi, Uue, Uue^Ii, Uu^Ufi, Uue, Uu^Ufi, Xue, Xue, Xue, Xue, Xue, Xue, Xue, Xue, Xue, Xue, Xue, Xue, Xue, Xue, Xue, Xue, Xue, Xue, Xue, Xue, Xue, Xue, Xue, Xue, Xue, Xue, Xue, Xue, Xue, Xue
Xue, Xue, Xue, Xue, Xue, Xue, Xue, Xue, Uh^Ii, Uh^Ii, Uue^Ii, Uh^Ii, Uh^Ii, Uue, Xue, Xue, Xue, Xue, Xue, Xue, Xue, Xue, Xue, Xue, Xue, Xue, Xue, Xue, Xue, Xue, Xue, Xue, Xue, Xue, Xue, Xue, Xue, Xue, Xue, Xue, Xue, Xue, Xue, Xue, Xue
Xue, Xue, Xue, Xue, Xue, Xue, Xue, Xue, Uh^Ii, Uu^Ufi, Uue, Uue^Vcl, Uue, Uue^Ii, Uh^Ii, Xue, Xue, Xue, Xue, Xue, Xue, Xue, Xue, Xue, Xue, Xue, Xue, Xue, Xue, Xue, Xue, Xue, Xue, Xue, Xue, Xue, Xue, Xue, Xue, Xue, Xue, Xue, Xue, Xue, Xue
Xue, Xue, Xue, Xue, Xue, Xue, Xue, Xue, Xue, Uu^Ufi, Uue, Xue, Uue, Uue, Uu^Ufi, Uh^Ii, Xue, Xue, Xue, Xue, Xue, Xue, Xue, Xue, Xue, Xue, Xue, Xue, Xue, Xue, Xue, Xue, Xue, Xue, Xue, Xue, Xue, Xue, Xue, Xue, Xue, Xue, Xue, Xue, Xue
Xue, Xue, Xue, Xue, Xue, Xue, Xue, Xue, Xue, Xue, Uue, Xue, Uue^Ii, Uue, Uh^Ii, Uh^Ii, Xue, Xue, Xue, Xue, Xue, Xue, Qxua, Qxua, Qxua, Qxua, Qxua, Xue, Xue, Xue, Xue, Xue, Xue, Xue, Xue, Xue, Xue, Xue, Xue, Xue, Xue, Xue, Xue, Xue, Xue
Xue, Xue, Xue, Xue, Xue, Xue, Xue, Qxua, Xue, Uu^Ufi, Uu^Ii, Uue^Ii, Xue, Uu^Ufi, Uh^Ii, Uh^Ii, Xue, Xue, Xue, Xue, Qxua, Qxua, Xue, Xue, Xue, Xue, Xue, Qxua, Qxua^Xo, Xue, Xue, Xue, Xue, Xue, Xue, Xue, Xue, Xue, Uu^Ufi, Uu^Ufi, Uu^Ufi, Uh^Ii, Uh, Xue, Xue
Xue, Xue, Xue, Xue, Xue, Xue, Qxua, Qxua, Qxua^Ii, Uh^Ii, Uh, Xue, Xue, Uu^Ufi, Uh^Ii, Xue, Qxua, Qxua, Qxua, Qxua, Qxua, Qxua, Qxua, Xue, Qxua, Qxua, Qxua, Qxua, Qxua^Xo, 1 Qxua, Xue, Xue, Xue, Xue, Xue, Uh, Uh, Uh^Ii, Uue^Ii, Uue^Ii, Ce, Uue^Ii, Uue, Uh, Uue
Xue, Xue, Qxua, Xue, Qxua, Xue, Qxua, Xue, Uue, Uh, Uue, Uu^Ufi, Uu^Ufi, Uu^Ufi, Uue, Uh, Uue, Xue, Qxua, Xue, Xue, Xue, Xue, Qxua, Qxua, Xue, Xue, Xue, Qxua, Qxua^Xo, Qxua, Xue, Xue, Xue, Qxua, Xue, Uue, Re^Vct, Uue, Ce, Ke, Ce, Ur, Re^Vct, Ur
Xue, Qxua, Xue, Qxua, Qxua, Qxua, Qxua, Qxua, Uue, Uue, Uue^Ii, Uue, Uue^Vcl, Uue, Uue^Ii, Uue, Uue, Qxua, Qxua, Qxua, Qxua, Xue, Xue, Xue, Qxua, Qxua, Qxua, Qxua, Qxua, Qxua, Qxua, Qxua, Qxua, Qxua, Xue, Uue^Ii, Xue, Xue, Ur, Ce, Ce, Ce, Uue, Ur, Uue
Qxua, Qxua, Qxua, Qxua, Xue, Qxua, Qxua, Xue, Uue, Uue, Uue, Uue^Vcl, Uue^Ii, Uue^Vcl, Uue, Uue, Uue, Xue, Qxua, Qxua, Xue, Qxua, Qxua, Qxua, Qxua, Qxua, Qxua, Qxua, Xue, Qxua, Qxua, Qxua, Xue, Qxua, Uh^Ii, Uu^Ufi, Uue^Ii, Ur^Ii, Uu^Ufi, Uue, Uue, Uue, Uh, Uh, Uh
Qxua, Qxua, Xue, Xue, Xue, Xue, Qxua, Xue, Uue, Uue^Ii, Uue, Uue^Vcl, Uue^Vcl, Uue^Vcl, Uue, Uue^Ii, Uue, Xue, Qxua, Xue, Xue, Xue, Xue, Qxua, Qxua, Qxua, Xue, Qxua, Qxua, Qxua, Xue, Qxua, Xue, Xue, Qxua, Uu^Ufi, Xue, Ur^Ii, Uu^Ufi, Uu^Ufi, Uue^Ii, Re^Vct, Uh, Xue, Xue
Qxua, Qxua, Xue, Xue, Xue, Qxua, Qxua, Qxua, Uue, Uue, Uue^Ii, Uue, Uue, Uue, Uue^Ii, Uue, Uue, Qxua, Qxua, Xue, Xue, Xue, Xue, Qxua, Qxua, Qxua, Qxua, Xue, Qxua, Qxua, Xue, Qxua, Qxua, Qxua, Uue, Uue^Ii, Uue, Uue, Xue, Uue^Ii, Xue, Xue, Uue, Xue, Xue
Qxua, Xue, Xue, Xue, Xue, Qxua, Qxua, Xue, Qxua, Uue, Uue, Uue, Uue, Uue, Uue, Uue, Qxua, Xue, Qxua, Xue, Xue, Xue, Uu^Ufi, Uu^Ufi, Uu^Ufi, Qxua, Qxua, Qxua, Xue, Xue, Qxua, Qxua, Uue^Vcl, Uue, Xue, Xue, Ur, Ur, Uue, Uue, Uue, Xue, Uue, Xue, Xue
Qxua, Xue, Xue, Xue, Xue, Qxua, Xue, Qxua, Qxua, Xue, Xue, Uue, Uue, Uue, Xue, Xue, Qxua, Qxua, Xue, Xue, Uue, Uh, Uue^Ii, Xue, Uue^Ii, Uue^Ii, Uue^Vcl, Qxua, Qxua, Qxua, Uu^Ufi, Uu^Ufi, Uue^Ii, Xue, Ur, Uue, Xue, Xue, Ur^Ii, Uue, Xue, Uue, Uue, Xue, Xue
Xue, Qxua, Qxua, Qxua, Qxua, Qxua, Xue, Qxua, Qxua, Qxua, Qxua, Uue, Uue, Uue, Qxua, Qxua, Qxua, Qxua, Ur, Ur, Ur^Ii, Uue^Ii, Xue, Uue^Ii, Xue, Uue, Xue, Uue, Uue, Uh^Ii, Uh^Ii, Uh, Uue, Ur, Xue, Xue, Uh^Ii, Xue, Ur^Ii, Xue, Xue, Xue, Uue, Xue, Xue
Qxua, Xue, Qxua, Qxua, Qxua, Xue, Qxua, Xue, Qxua, Xue, Xue, Uue^Vcl, Uue^Ii, Uue, Xue, Xue, Uue, Uue^Vcl, Xue, Xue, Uu^Ufi, Ur^Ii, Uue^Ii, Uue, Uu^Ufi, Uu^Ufi, Ur^Ii, Ur, Ur, Ur, Ur, Uue, Xue, Ur, Uue^Ii, Uu^Ufi, Uu^Ufi, Uu^Ufi, Xue, Ur, Xue, Uue, Xue, Xue, Xue
Qxua, Qxua, Xue, Xue, Xue, Qxua, Xue, Qxua, Qxua, Xue, Xue, Uue^Ii, Uu^Ufi, Uue^Ii, Ur, Ur, Qxua, Qxua, Qxua, Xue, Uue^Ii, Uue, Xue, Ur^Ii, Ur^Ii, Ur^Ii, Qxua, Qxua, Xue, Xue, Uue^Ii, Uue^Ii, Ur, Ur, Uue^Vcl, Uue^Ii, Ur, Xue, Ur, Uue, Uue, Uue, Xue, Xue, Xue
Qxua, Qxua, Xue, Qxua, Qxua, Qxua, Qxua, Qxua, Qxua, Xue, Xue, Uh^Ii, Xue, Uu^Ufi, Uue^Ii, Uue^Ii, Uu^Ufi, Ur^Ii, Xue, Uu^Ufi, Uh^Ii, Xue, Qxua, Qxua, Xue, Uue, Xue, Uu^Ufi, Uue^Ii, Uue^Vcl, Ur, Uue^Ii, Uue, Xue, Xue, Xue, Uue, Ur, Xue, Xue, Xue, Xue, Xue, Xue, Xue
Xue, Xue, Xue, Xue, Xue, Xue, Qxua, Xue, Xue, Xue, Xue, Xue, Xue, Uh^Ii, Qxua, Uu^Ufi, Uu^Ufi, Uue^Ii, Uue^Ii, Uu^Ufi, Qxua, Uh, Uu^Ufi, Xue, Uu^Ufi, Uu^Ufi, Uu^Ufi, Uue^Ii, Ur, Ur, Uue^Ii, Xue, Uue^Ii, Uue, Uue, Xue, Uue, Xue, Xue, Xue, Xue, Xue, Xue, Xue, Xue
Xue, Xue, Xue, Xue, Xue, Xue, Xue, Qxua, Qxua, Xue, Qxua, Xue, Qxua, Qxua, Qxua, Qxua, Qxua, Qxua, Ur, Xue, Ur^Ii, Uu^Ufi, Uue^Ii, Uue^Ii, Xue, Uh^Ii, Xue, Uue^Ii, Ur, Xue, Uu^Ufi, Uu^Ufi, Uu^Ufi, Uue^Ii, Uue^Vcl, Uue, Xue, Xue, Xue, Xue, Xue, Xue, Xue, Xue, Xue
Xue, Xue, Xue, Xue, Xue, Xue, Xue, Xue, Xue, Qxua, Xue, Qxua, Xue, Xue, Uh, Xue, Uh, Qxua, Uue^Vcl, Ur, Xue, Uue^Ii, Qxua, Qxua, Uue^Vcl, Xue, Xue, Uue, Qxua, Qxua, Xue, Uh^Ii, Xue, Uh, Xue, Xue, Xue, Xue, Xue, Xue, Xue, Xue, Xue, Xue, Xue
Xue, Xue, Xue, Xue, Xue, Xue, Xue, Xue, Xue, Xue, Xue, Xue, Uh, Uh, Xue, Xue, Xue, Uue, Xue, Uue, Uue, Uue, Ur, Ur, Ur, Xue, Xue, Ur, Xue, Xue, Xue, Xue, Xue, Xue, Xue, Xue, Xue, Xue, Xue, Xue, Xue, Xue, Xue, Xue, Xue
Xue, Xue, Xue, Xue, Xue, Xue, Xue, Xue, Xue, Xue, Xue, Uh, Uh, Xue, Xue, Xue, Uue, Uue, Ur, Xue, Ur, Uue, Uue, Xue, Uue, Xue, Ur, Ur, Xue, Xue, Xue, Xue, Xue, Xue, Xue, Xue, Xue, Xue, Xue, Xue, Xue, Xue, Xue, Xue, Xue
Xue, Xue, Xue, Xue, Xue, Xue, Xue, Xue, Xue, Xue, Xue, Uh, Xue, Uu^Ufi, Uu^Ufi, Uu^Ufi, Xue, Xue, Uue, Ur, Uue^Vcl, Uue, Uue, Xue, Ur, Xue, Uue, Xue, Xue, Xue, Xue, Xue, Xue, Xue, Xue, Xue, Xue, Xue, Xue, Xue, Xue, Xue, Xue, Xue, Xue
Xue, Xue, Xue, Xue, Xue, Xue, Xue, Xue, Xue, Xue, Xue, Xue, Xue, Uh, Xue, Uue, Uu^Ufi, Uue, Uu^Ufi, Uue, Xue, Uue, Uu^Ufi, Uu^Ufi, Uu^Ufi, Ur, Xue, Xue, Xue, Xue, Xue, Xue, Xue, Xue, Xue, Xue, Xue, Xue, Xue, Xue, Xue, Xue, Xue, Xue, Xue
Xue, Xue, Xue, Xue, Xue, Xue, Xue, Xue, Xue, Xue, Xue, Xue, Xue, Xue, Xue, Uh, Uh, Uu^Ufi, Uh, Uu^Ufi, Uue, Uue, Xue, Uh, Xue, Xue, Xue, Xue, Xue, Xue, Xue, Xue, Xue, Xue, Xue, Xue, Xue, Xue, Xue, Xue, Xue, Xue, Xue, Xue, Xue
Xue, Xue, Xue, Xue, Xue, Xue, Xue, Xue, Xue, Xue, Xue, Xue, Xue, Xue, Xue, Xue, Xue, Xue, Xue, Xue, Xue, Xue, Xue, Xue, Xue, Xue, Xue, Xue, Xue, Xue, Xue, Xue, Xue, Xue, Xue, Xue, Xue, Xue, Xue, Xue, Xue, Xue, Xue, Xue, Xue
Xue, Xue, Xue, Xue, Xue, Xue, Xue, Xue, Xue, Xue, Xue, Xue, Xue, Xue, Xue, Xue, Xue, Xue, Xue, Xue, Xue, Xue, Xue, Xue, Xue, Xue, Xue, Xue, Xue, Xue, Xue, Xue, Xue, Xue, Xue, Xue, Xue, Xue, Xue, Xue, Xue, Xue, Xue, Xue, Xue
