Xu, Xu, Xu, Xu, Xu, Xu, Xu, Xu, Xu, Xu, Xu, Xu, Xu, Xu, Xu, Xu, Ql, Xuc, Ql, Ql, Xu, Xu, Xu, Xu, Xu, Xu, Ql, Xu, Xu, Xu, Xu, Xu, Xu, Ql, Ql, Xu, Ql, Ql, Xu, Xu, Xu, Xu, Xu, Xu, Xu, Xu, Xu, Xu, Xu, Xu, Xu, Xu, Xu
Xu, Xu, Xu, Xu, Xu, Xu, Xu, Xu, Xu, Xu, Xu, Xu, Xu, Xu, Xu, Ql, Xu, Ql, Ql, Ql, Xu, Xu, Xu, Xu, Cud, Cud, Cud, Cud, Cud, Xu, Xu, Xu, Ql, Ql, Xu, Xu, Xu, Ql, Xu, Xu, Xu, Xu, Xu, Xu, Xu, Xu, Xu, Xu, Xu, Xu, Xu, Xu, Xu
Xu, Xu, Xu, Xu, Xu, Xu, Xu, Xu, Xu, Xu, Xu, Xu, Xu, Xu, Xu, Ql, Xu, Xu, Ql, Ql, Ql, Xu, Ql, Cud, Urb^Vov, Urb^Vov, Cud, Urb^Vov, Urb^Vov, Cud, Ql, Xu, Ql, Ql, Ql, Xu, Xu, Ql, Xu, Xu, Xu, Xu, Xu, Xu, Xu, Xu, Xu, Xu, Xu, Xu, Xu, Xu, Xu
Xu, Xu, Xu, Xu, Xu, Xu, Xu, Xu, Xu, Xu, Xu, Xu, Xu, Xu, Xu, Ql, Xu, Ql, Xu, Xu, Xu, Ql, Urb^Vov, Kud, Urb, Cud, 2 Kud, Cud, Urb, Kud, Urb^Vov, Ql, Xu, Xu, Ql, Ql, Xu, Ql, Xu, Xu, Xu, Xu, Xu, Xu, Xu, Xu, Xu, Xu, Xu, Xu, Xu, Xu, Xu
Xu, Xu, Xu, Xu, Xu, Xu, Xu, Xu, Xu, Xu, Xu, Xu, Xu, Xu, Xu, Ql, Ql, Ql, Xu, Xu, Xu, Ql, Urb, Ql, Urb, Cud, Cud, Cud, Urb, Ql, Urb, Ql, Xu, Xu, Xu, Ql, Ql, Ql, Xu, Xu, Xu, Xu, Xu, Xu, Xu, Xu, Xu, Xu, Xu, Xu, Xu, Xu, Xu
Xu, Xu, Xu, Xu, Xu, Xu, Xu, Xu, Xu, Xu, Uh, Xu, Uh, Xu, Xu, Ql, Ql, Xu, Xu, Xu, Xu, Cud, Ql, Ql, Urb^Cov, Urb, Cud, Urb, Urb^Cov, Ql, Ql, Cud, Xu, Xu, Xu, Ql, Ql, Xu, Xu, Xu, Xu, Xu, Xu, Xu, Xu, Xu, Xu, Xu, Xu, Xu, Xu, Xu, Xu
Ql, Ql, Xu, Xu, Ql, Xu, Xu, Xu, Xu, Xu, Uh, Uh, Uh, Xu, Ql, Ql, Ql, Ql, Xu, Xu, Xu, Cud, Urb, Ql^Cov, Kud, Urb^Cov, Cud, Urb^Cov, Kud, Ql^Cov, Urb, Cud, Xu, Xu, Xu, Xu, Xu, Xu, Xu, Xu, Uh, Xu, Uh, Xu, Xu, Xu, Xu, Xu, Xu, Xu, Ql, Xu, Xu
Ql, Xu, Xu, Ql, Xu, Ql, Ql, Xu, Xu, Xu, Uu^Vov, Urb, Uu, Xu, Xu, Ql, Xu, Xu, Xu, Xu, Uu, Uu, Urb, Urb^Cov, Ql^Cov, Cud, Urb, Cud, Ql^Cov, Urb^Cov, Urb, Uu, Uu, Xu, Xu, Xu, Xu, Xu, Xu, Xu, Uh, Uh, Uh, Xu, Xu, Xu, Xu, Ql, Ql, Xu, Xu, Ql, Ql
Ql, Ql, Ql, Xu, Xu, Xu, Ql, Xu, Xu, Xu, Uu, Urb, Uu, Xu, Xu, Xu, Xu, Xu, Uu, Uu^Vov, Urb, Urb, Uu, Urb, Ql, Ql, Urb, Ql, Ql, Urb, Uu, Urb, Urb, Uu, Uu, Xu, Xu, Xu, Xu, Xu, Uh, Uh, Uu, Xu, Xu, Xu, Ql, Xu, Xu, Xu, Xu, Xu, Xu
Xu, Ql, Xu, Ql, Ql, Xu, Ql, Xu, Xu, Xu, Uu, Urb, Uu, Xu, Xu, Xu, Uu, Uu, Urb, Urb, Uu, Uu, Xu, Cud, Cud, Uu, Urb, Uu, Cud, Cud, Xu, Uu, Uu, Urb, Urb, Uu^Vov, Uu, Xu, Xu, Xu, Uu, Urb, Uu^Vov, Xu, Xu, Ql, Xu, Xu, Ql, Xu, Xu, Ql, Xu
Xu, Xu, Ql, Ql, Ql, Ql, Xu, Xu, Xu, Xu, Xu, Urb, Xu, Xu, Cud, Uu, Urb, Urb, Uu, Uu, Xu, Xu, Xu, Xu, Xu, Uu, Urb, Uu, Xu, Xu, Xu, Xu, Xu, Uu, Uu, Urb, Urb, Uu, Cud, Xu, Xu, Urb, Xu, Xu, Xu, Ql, Xu, Ql, Ql, Xu, Xu, Ql, Xu
Xu, Ql, Xu, Xu, Ql, Ql, Ql, Xu, Xu, Xu, Cud, Urb, Cud, Xu, Urb, Urb, Uu, Uu^Vov, Xu, Xu, Xu, Xu, Xu, Xu, Xu, 1 Uu, Urb, Uu, Xu, Xu, Xu, Xu, Xu, Xu, Xu, Uu, Uu, Urb, Urb, Xu, Cud, Urb, Cud, Xu, Xu, Ql, Xu, Xu, Xu, Ql, Ql, Xu, Xu
Xu, Ql, Ql, Xu, Ql, Xu, Ql, Xu, Xu, Cud, Ql, Urb, Urb, Urb, Xu, Cud, Xu, Xu, Xu, Xu, Xu, Xu, Xu, Xu, Xu, Uu, Urb, Uu^Vov, Xu, Xu, Xu, Xu, Xu, Xu, Xu, Xu, Xu, Cud, Xu, Urb, Urb, Urb, Ql, Cud, Xu, Xu, Ql, Xu, Ql, Ql, Ql, Xu, Xu
Xu, Ql, Xu, Xu, Ql, Xu, Xu, Xu, Xu, Cud, Cud, Kud, Urb, Cud, Xu, Xu, Xu, Xu, Xu, Xu, Xu, Xu, Xu, Xu, Xu, Uu, Urb, Uu, Xu, Xu, Xu, Xu, Xu, Xu, Xu, Xu, Xu, Xu, Xu, Cud, Urb, Kud, Cud, Cud, Xu, Xu, Xu, Ql, Xuc, Ql, Xu, Xu, Xu
Xu, Ql, Xu, Ql, Xu, Xu, Ql, Xu, Ql, Ql, Cud, Ql, Cud, Urb, Urb, Uu, Uu^Vov, Xu, Xu, Xu, Xu, Xu, Xu, Xu, Xu, Uu, Urb, Uu, Xu, Xu, Xu, Xu, Xu, Xu, Xu, Xu, Uu, Uu, Urb, Urb, Cud, Ql, Cud, Ql, Ql, Xu, Ql, Ql, Ql, Ql, Ql, Ql, Xu
Xu, Xu, Xu, Ql, Ql, Xu, Ql, Ql, Ql, Xu, Xu, Cud, Xu, Xu, Uu, Urb, Urb, Uu, Uu, Xu, Xu, Xu, Xu, Xu, Xu, Uu, Urb, Uu, Xu, Xu, Xu, Xu, Xu, Xu, Uu, Uu, Urb, Urb, Uu, Xu, Xu, Cud, Xu, Xu, Ql, Ql, Xu, Ql, Xu, Ql, Xu, Ql, Xu
Xu, Xu, Ql, Ql, Xu, Xu, Ql, Ql, Ql, Xu, Xu, Xu, Xu, Xu, Xu, Uu, Uu, Urb, Urb, Uu, Uu, Xu, Xu, Xu, Xu, Uu, Urb, Uu, Xu, Xu, Xu, Xu, Uu, Uu, Urb, Urb, Uu, Uu^Vov, Xu, Xu, Xu, Xu, Xu, Xu, Xu, Xu, Ql, Xu, Xu, Ql, Xu, Ql, Xu
Xu, Xu, Ql, Xu, Xu, Xu, Xu, Xu, Ql, Ql, Xu, Xu, Xu, Xu, Xu, Xu, Urb, Urb, Uu, Urb, Urb, Uu, Uu, Xu, Xu, Cud, Urb, Cud, Xu, Xu, Uu, Uu^Vov, Urb, Urb, Uu, Urb, Urb, Xu, Xu, Xu, Xu, Xu, Xu, Xu, Xu, Ql, Xu, Ql, Ql, Ql, Xu, Ql, Xu
Xu, Xu, Ql, Ql, Ql, Xu, Ql, Ql, Xu, Xu, Xu, Xu, Xu, Xu, Uu, Uu, Urb, Urb, Xu, Uu, Uu, Urb, Urb, Uu, Xu, Xu, Urb, Xu, Xu, Uu, Urb, Urb, Uu, Uu, Xu, Urb, Urb, Uu, Uu, Xu, Xu, Xu, Xu, Xu, Xu, Ql, Xu, Xu, Ql, Xu, Ql, Qlf, Qlf
Xu, Xu, Ql, Ql, Ql, Xu, Ql, Ql, Ql, Xu, Cud, Cud, Uu, Uu, Urb, Urb, Uu, Uu, Xu, Xu, Xu, Uu, Uu, Urb, Urb, Cud, Urb, Cud, Urb, Urb, Uu, Uu, Xu, Xu, Xu, Uu, Uu, Urb, Urb, Uu, Uu, Cud, Cud, Xu, Ql, Ql, Ql, Xu, Xu, Ql, Qlf, Qlf, Qlf
Xu, Xu, Xu, Ql, Xu, Ql, Xu, Xu, Xu, Ql, Cud, Urb, Urb, Urb, Uu^Vov, Uu, Xu, Xu, Ql, Ql, Ql, Xu, Xu, Xu, Cud, Urb, Kud, Urb, Cud, Xu, Xu, Xu, Ql, Xu, Xu, Xu, Xu, Uu^Vov, Uu, Urb, Urb, Urb, Cud, Ql, Xu, Xu, Xu, Ql, Ql, Qlf, Qlf, Qlf, Qlf
Xu, Xu, Xu, Xu, Xu, Xu, Xu, Xu, Xu, Cud, Urb, Kud, Urb, Uu, Xu, Xu, Xu, Xu, Xu, Ql, Ql, Xu, Xu, Xu, Ql, Ql, Urb, Ql, Ql, Xu, Ql, Ql, Ql, Ql, Xu, Xu, Xu, Xu, Xu, Uu, Urb, Kud, Urb, Cud, Xu, Xu, Xu, Ql, Xu, Qlf, Qlf, Qlf, Qlf
Xu, Xu, Xu, Xu, Xu, Xu, Xu, Xu, Xu, Cud, Uu, Urb, Uu, Urb, Urb, Uu, Uu, Xu, Xu, Ql, Xu, Ql, Ql, Ql, Xu, Cud, Urb, Cud, Xu, Ql, Ql, Ql, Xu, Ql, Xu, Xu, Uu, Uu, Urb, Urb, Uu^Vov, Urb, Uu, Cud, Xu, Xu, Xu, Xu, Ql, Qlf, Qlf, Qlf, Qlf
Xu, Xu, Xu, Xu, Xu, Xu, Xu, Xu, Xu, Xu, Xu, Urb, Xu, Xu, Uu, Urb, Urb, Uu^Vov, Uu, Xu, Xu, Xu, Xu, Xu, Xu, Xu, Urb, Xu, Xu, Ql, Xu, Ql, Xu, Xu, Uu^Vov, Uu, Urb, Urb, Uu, Xu, Xu, Urb, Xu, Xu, Xu, Xu, Xu, Ql, Xu, Ql, Qlf, Qlf, Qlf
Xu, Xu, Xu, Xu, Xu, Xu, Xu, Xu, Xu, Xu, Cud, Urb, Cud, Xu, Xu, Uu, Uu, Urb, Urb, Uu, Uu, Xu, Xu, Xu, Xu, Uu, Urb, Uu, Xu, Xu, Xu, Xu, Uu, Uu, Urb, Urb, Uu, Uu, Xu, Xu, Cud, Urb, Cud, Xu, Xu, Xu, Xu, Ql, Xu, Ql, Qlf, Qlf, Qlf
Xu, Xu, Xu, Xu, Xu, Xu, Xu, Xu, Xu, Xu, Uu, Urb, Uu, Xu, Xu, Xu, Xu, Uu, Uu, Urb, Urb, Uu, Uu, Xu, Xu, Uu, Urb, Uu, Xu, Xu, Uu, Uu, Urb, Urb, Uu, Uu, Xu, Xu, Xu, Xu, Uu, Urb, Uu, Xu, Xu, Xu, Xu, Ql, Xu, Ql, Ql, Qlf, Xu
Xu, Xu, Xu, Xu, Xu, Xu, Xu, Xu, Xu, Xu, Uu, Urb, Uu, Xu, Xu, Xu, Xu, Xu, Xu, Uu, Uu^Vov, Urb, Urb, Uu, Uu, Uu^Vov, Urb, Uu, Uu, Uu, Urb, Urb, Uu, Uu, Xu, Xu, Xu, Xu, Xu, Xu, Uu, Urb, Uu, Xu, Xu, Xu, Xu, Ql, Ql, Xu, Xu, Ql, Xu
Xu, Xu, Xu, Xu, Xu, Xu, Xu, Xu, Xu, Xu, Uu, Urb, Uu, Xu, Xu, Xu, Xu, Xu, Xu, Xu, Xu, Uu, Uu, Urb, Urb, Uu, Urb, Uu, Urb, Urb, Uu^Vov, Uu, Xu, Xu, Xu, Xu, Qlf, Xu, Xu, Xu, Uu, Urb, Uu, Xu, Xu, Xu, Ql, Ql, Xu, Ql, Ql, Ql, Ql
Xu, Xu, Xu, Xu, Xu, Xu, Xu, Xu, Xu, Xu, Uu^Vov, Urb, Uu, Xu, Xu, Xu, Qlf, Xu, Qlf, Xu, Xu, Xu, Xu, Uu, Cud, Urb, Urb, Urb, Cud, Uu, Xu, Xu, Xu, Qlf, Qlf, Qlf, Xu, Qlf, Xu, Xu, Uu, Urb, Uu^Vov, Xu, Xu, Ql, Ql, Xu, Xu, Xu, Ql, Xu, Ql
Xu, Xu, Xu, Xu, Xu, Xu, Xu, Xu, Xu, Xu, Uu, Urb, Uu, Xu, Xu, Xu, Qlf, Qlf, Qlf, Qlf, Qlf, Xu, Xu, Xu, Xu, Cud, Urb, Cud, Xu, Xu, Xu, Xu, Qlf, Qlf, Qlf, Qlf, Xu, Qlf, Xu, Xu, Uu, Urb, Uu, Xu, Xu, Xu, Ql, Xu, Xu, Xu, Xu, Xu, Ql
Xu, Xu, Xu, Xu, Xu, Xu, Xu, Xu, Xu, Xu, Uu, Urb, Uu, Xu, Xu, Qlf, Qlf, Xuc, Qlf, Xuc, Qlf, Qlf, Xu, Xu, Xu, Cud, Urb, Cud, Xu, Xu, Qlf, Qlf, Xu, Qlf, Qlf, Qlf, Xu, Xu, Xu, Xu, Uu, Urb, Uu, Xu, Xu, Ql, Ql, Ql, Xu, Ql, Xu, Xu, Ql
Xu, Xu, Xu, Xu, Xu, Xu, Xu, Xu, Xu, Xu, Uu, Urb, Cud, Xu, Xu, Qlf, Qlf, Qlf, Qlf, Qlf, Qlf, Xu, Xu, Xu, Xu, Uu, Urb, Uu, Xu, Xu, Xu, Qlf, Qlf, Qlf, Qlf, Qlf, Qlf, Xu, Xu, Xu, Cud, Urb, Uu, Xu, Xu, Ql, Xu, Xu, Xu, Ql, Ql, Ql, Xu
Xu, Xu, Xu, Xu, Xu, Xu, Xu, Xu, Xu, Xu, Cud, Urb, Cud, Xu, Xu, Xu, Xu, Xu, Xu, Qlf, Qlf, Xu, Xu, Xu, Xu, Cud, Urb, Cud, Xu, Xu, Xu, Xu, Xu, Qlf, Xu, Qlf, Xu, Xu, Xu, Xu, Cud, Urb, Cud, Xu, Xu, Ql, Xu, Xu, Xu, Ql, Ql, Ql, Xu
Xu, Xu, Xu, Xu, Xu, Xu, Xu, Xu, Xu, Xu, Cud, Urb, Urb, Cud, Uu, Xu, Xu, Xu, Xu, Xu, Xu, Qlf, Xu, Xu, Cud, Cud, Urb, Cud, Cud, Xu, Xu, Xu, Qlf, Qlf, Xu, Xu, Xu, Xu, Uu, Cud, Urb, Urb, Cud, Xu, Xu, Ql, Ql, Xu, Xu, Xu, Ql, Xu, Xu
Xu, Xu, Xu, Xu, Xu, Xu, Xu, Xu, Xu, Xu, Xu, Cud, Uu, Urb, Urb, Uu, Uu, Xu, Xu, Xu, Xu, Qlf, Qlf, Uh, Urb, Urb, Urb, Urb, Urb, Uh, Qlf, Qlf, Xu, Xu, Xu, Xu, Uu, Uu, Urb, Urb, Uu, Cud, Xu, Xu, Xu, Xu, Ql, Xu, Xu, Xu, Ql, Qlf, Qlf
Xu, Xu, Xu, Xu, Xu, Xu, Xu, Xu, Xu, Xu, Xu, Xu, Xu, Uu, Uu, Urb, Urb, Uu, Cud, Xu, Urb, Uh, Uh, Qlf^Blv/, Qlf^Blv/, Uh, Uh, Uh, Qlf^Blv\, Qlf^Blv\, Uh, Uh, Urb, Xu, Cud, Uu, Urb, Urb, Uu, Uu, Xu, Xu, Xu, Xu, Ql, Xu, Ql, Ql, Xu, Ql, Qlf, Qlf, Qlf
Xu, Xu, Xu, Xu, Xu, Xu, Xu, Xu, Xu, Xu, Xu, Xu, Xu, Xu, Xu, Uu^Vov, Uu, Urb, Urb, Urb, Urb, Urb, Urb, Uh, Qlf, Uh, Uh, Qlf, Uh, Uh, Urb, Urb, Urb, Urb, Urb, Urb, Uu, Uu, Xu, Xu, Xu, Xu, Ql, Ql, Xu, Xu, Qlf, Qlf, Qlf, Qlf, Qlf, Qlf, Qlf
Xu, Xu, Ql, Xu, Ql, Xu, Ql, Xu, Xu, Xu, Xu, Xu, Xu, Xu, Xu, Xu, Xu, Cud, Urb, Urb, Urb^Cov, Cud^Cov, Urb, Uh, Qlf, Uh, Xu, Qlf, Uh, Urb, Urb, Cud^Cov, Urb^Cov, Urb, Urb, Cud, Xu, Xu, Xu, Xu, Xu, Xu, Ql, Ql, Ql, Ql, Xu, Qlf, Qlf, Qlf, Qlf, Qlf, Qlf
Xu, Ql, Xu, Xu, Ql, Ql, Xu, Xu, Ql, Xu, Xu, Ql, Ql, Xu, Xu, Xu, Xu, Xu, Urb, Cud^Cov, Urb^Cov, Urb^Er|, Urb, Uh, Qlf, Xu, Xu, Qlf, Xu, Urb, Urb, Urb^Er|, Urb^Cov, Cud^Cov, Urb, Xu, Xu, Xu, Xu, Xu, Ql, Ql, Xu, Xu, Xu, Ql, Ql, Qlf, Xu, Qlf, Qlf, Qlf, Xu
Ql, Xu, Xu, Ql, Xu, Xu, Xu, Xu, Xu, Ql, Xu, Ql, Ql, Xu, Xu, Xu, Xu, Xu, Urb, Urb^Er|, Urb^Er/, Cud^Cov, Urb, Xu, Xu, Qlf, Qlf, Qlf, Xu, Xu, Urb, Cud^Cov, Urb^Er\, Urb^Er|, Urb, Xu, Xu, Xu, Ql, Ql, Ql, Ql, Ql, Xu, Xu, Ql, Xu, Ql, Xu, Ql, Xu, Xu, Ql
Ql, Xu, Xu, Ql, Xu, Xu, Xu, Xu, Ql, Ql, Ql, Ql, Ql, Ql, Xu, Xu, Xu, Xu, Urb^Cov, Cud^Cov, Urb^Cov, Urb^Cov, Uh, Xu, Qlf, Qlf, Ql^Ii, Qlf, Qlf, Xu, Uh, Urb^Cov, Urb^Cov, Cud^Cov, Urb^Cov, Xu, Xu, Ql, Xu, Xu, Xu, Xu, Xu, Ql, Ql, Ql, Ql, Ql, Ql, Ql, Ql, Ql, Xu
Qlf, Xu, Ql, Ql, Ql, Ql, Ql, Ql, Ql, Ql, Ql, Ql, Ql, Xu, Xu, Xu, Xu, Xu, Urb^Cov, Urb^Er|, Uh, Uh, Qlf, Qlf, Xu, Qlf, Ql^Er|, Qlf, Xu, Qlf, Qlf, Uh, Uh, Urb^Er|, Urb^Cov, Xu, Xu, Ql, Xu, Xu, Qlf, Qlf, Xu, Ql, Ql, Ql, Xu, Ql, Xu, Ql, Xu, Xu, Xu
Qlf, Qlf, Qlf, Ql, Qlf, Ql, Ql, Ql, Xu, Xu, Xu, Xu, Ql, Ql, Ql, Xu, Xu, Xu, Uh^Cov, Uh^Er|, Qlf, Qlf, Uh, Xu, Xu, Xu, Ql^Er|, Xu, Xu, Xu, Uh, Qlf, Qlf, Uh^Er|, Uh^Cov, Xu, Xu, Ql, Qlf, Qlf, Qlf, Xu, Xu, Xu, Ql, Xu, Xu, Ql, Xu, Xu, Xu, Xu, Xu
Qlf, Qlf, Qlf, Qlf, Ql, Ql, Ql, Xu, Ql, Ql, Xu, Xu, Ql, Ql, Xu, Xu, Qlf, Xu, Qlf, 4 Cud^Kov, Uh^Er\, Uh, Urb, Urb, Uu^Vov, Xu, Qxu^Er|, Xu, Uu^Vov, Urb, Urb, Uh, Uh^Er/, 5 Cud^Kov, Qlf, Xu, Qlf, Qlf, Qlf, Qlf, Qlf, Qlf, Qlf, Ql, Ql, Xu, Ql, Ql, Ql, Ql, Ql, Ql, Xu
Qlf, Qlf, Qlf, Qlf, Qlf, Qlf, Qlf, Ql, Ql, Ql, Ql, Ql, Qlf, Xu, Qlf, Qlf, Xu, Qlf, Uh, Uh, Urb, Urb^Er\, Cud^Cov, Urb, Urb, Urb, Urb^Er|, Urb, Urb, Urb, Cud^Cov, Urb^Er/, Urb, Uh, Uh, Qlf, Xu, Qlf, Qlf, Qlf, Qlf, Qlf, Qlf, Xu, Xu, Xu, Ql, Xu, Ql, Xu, Ql, Xu, Xu
Qlf, Qlf, Qlf, Qlf, Qlf, Qlf, Qlf, Ql, Xu, Ql, Qlf, Qlf, Qlf, Qlf, Xu, Xu, Xu, Xu, Xu, Urb, Uu^Vov, Urb, Urb^Cov, Urb^Er\, Cud^Cov, Urb, Urb^Er|, Urb, Cud^Cov, Urb^Er/, Urb^Cov, Urb, Uu^Vov, Urb, Xu, Xu, Xu, Qlf, Qlf, Qlf, Qlf, Qlf, Qlf, Xu, Ql, Ql, Xu, Ql, Ql, Ql, Ql, Xu, Xu
Qlf, Qlf, Qlf, Qlf, Qlf, Qlf, Xu, Xu, Xu, Qlf, Qlf, Qlf, Xu, Xu, Xu, Xu, Xu, Xu, Xu, Xu, Xu, Urb, Uu^Vov, Urb^Cov, Urb^Cov, Urb^Er\, 3 Cud^Kov, Urb^Er/, Urb^Cov, Urb^Cov, Uu^Vov, Urb, Xu, Xu, Xu, Xu, Xu, Xu, Xu, Qlf, Qlf, Qlf, Qlf, Xu, Xu, Ql, Ql, Xu, Ql, Ql, Xu, Xu, Xu
Qlf, Qlf, Qlf, Qlf, Qlf, Xu, Xu, Xu, Qlf, Qlf, Qlf, Qlf, Qlf, Xu, Xu, Xu, Xu, Xu, Xu, Xu, Xu, Xu, Xu, Urb, Uu^Vov, Urb^Cov, Urb, Urb^Cov, Uu^Vov, Urb, Xu, Xu, Xu, Xu, Xu, Xu, Xu, Xu, Xu, Xu, Xu, Qlf, Xu, Qlf, Xu, Ql, Ql, Ql, Xu, Ql, Xu, Xu, Xu
Xu, Xu, Xu, Xu, Qlf, Xu, Xu, Qlf, Qlf, Qlf, Xu, Qlf, Xu, Xu, Xu, Xu, Xu, Xu, Xu, Xu, Xu, Xu, Xu, Xu, Xu, Urb, Uu^Vov, Urb, Xu, Xu, Xu, Xu, Xu, Xu, Xu, Xu, Xu, Xu, Xu, Xu, Xu, Ql, Ql, Xu, Xu, Xu, Xu, Xu, Xu, Xu, Xu, Xu, Xu
Xu, Xu, Xu, Xu, Xu, Xu, Xu, Qlf, Xu, Qlf, Xu, Qlf, Xu, Xu, Xu, Xu, Xu, Xu, Xu, Xu, Xu, Xu, Xu, Xu, Xu, Xu, Xu, Xu, Xu, Xu, Xu, Xu, Xu, Xu, Xu, Xu, Xu, Xu, Xu, Xu, Xu, Xu, Ql, Xu, Xu, Xu, Xu, Xu, Xu, Xu, Xu, Xu, Xu
Xu, Xu, Xu, Xu, Xu, Xu, Xu, Xu, Xu, Xu, Xu, Xu, Xu, Xu, Xu, Xu, Xu, Xu, Xu, Xu, Xu, Xu, Xu, Xu, Xu, Xu, Xu, Xu, Xu, Xu, Xu, Xu, Xu, Xu, Xu, Xu, Xu, Xu, Xu, Xu, Xu, Xu, Xu, Xu, Xu, Xu, Xu, Xu, Xu, Xu, Xu, Xu, Xu
Xu, Xu, Xu, Xu, Xu, Xu, Xu, Xu, Xu, Xu, Xu, Xu, Xu, Xu, Xu, Xu, Xu, Xu, Xu, Xu, Xu, Xu, Xu, Xu, Xu, Xu, Xu, Xu, Xu, Xu, Xu, Xu, Xu, Xu, Xu, Xu, Xu, Xu, Xu, Xu, Xu, Xu, Xu, Xu, Xu, Xu, Xu, Xu, Xu, Xu, Xu, Xu, Xu
Xu, Xu, Xu, Xu, Xu, Xu, Xu, Xu, Xu, Xu, Xu, Xu, Xu, Xu, Xu, Xu, Xu, Xu, Xu, Xu, Xu, Xu, Xu, Xu, Xu, Xu, Xu, Xu, Xu, Xu, Xu, Xu, Xu, Xu, Xu, Xu, Xu, Xu, Xu, Xu, Xu, Xu, Xu, Xu, Xu, Xu, Xu, Xu, Xu, Xu, Xu, Xu, Xu
