border_size=1
usage=map

Md, Md, Md, Ha^Fpa, Aa^Fma, Aa, Aa, Gs, Gll^Es, Gs, Gll, Gll, Gll^Es, Gll^Fmw, Hh^Fp, Md, Md, Mm, Ms, Ms, Ms, Mm, Ms^Xm, Ms^Xm, Ms^Xm, Ms^Xm, Mm, Mm, Ms^Xm, Ms^Xm, Ms^Xm, Ms^Xm, Ms^Xm, Ms^Xm, Ms^Xm, Mm, Mm, Mm, Mm, Mm, Ms, Mm, Md, Hh^Fp, Aa^Fma, Gll^Fmw, Aa^Fma, Gll, Gll, Aa, Aa^Fma, Gll, Gll^Fmw, Gll, Gll^Fmw, Gll, Aa, Aa^Fma, Hh^Fp, Hh^Fp, Md, Mm, Mm
Ms, Md, Hh^Fp, Ha^Fpa, Aa^Fma, Aa, Gll, Gs, Gs^Es, Gll, Gll^Em, Gs, Gs, Gd^Vo, Gll^Fmw, Hh^Fp, Ha^Fpa, Ms, Ms, Ms, Ms^Xm, Ms^Xm, Ms^Xm, Ms^Xm, Ms, Ms, Ms^Xm, Ms^Xm, Xu, Xu, Xu, Xu, Xu, Xu, Xu, Ms^Xm, Mm, Ms, Ms^Xm, Mm, Mm, Md, Md, Ha^Fpa, Aa^Fma, Aa, Aa^Fma, Gll^Fmw, Aa^Fma, Aa^Fma, Gll^Fmw, Aa^Fma, Aa^Fma, Aa^Fma, Aa^Fma, Gll^Fmw, Gll^Fmw, Aa^Fma, Ha^Fpa, Md, Mm, Mm, Ms
Ms, Ha^Fpa, Aa^Fma, Aa^Fma, Gd^Vo, Gll, Gll^Fmw, Aa^Es, Aa^Fma, Gll^Fmw, Gll^Fmw, Aa, Aa^Fma, Aa, Gll, Aa^Fma, Aa^Fma, Ha^Fpa, Md, Mm, Mm, Mm, Ms, Mm, Ms^Xm, Ms^Xm, Xu, Xu, Uu^Ii, Uu^Ii, Uu^Emf, Uu^Vud, Uu^Ufi, Uh, Xu, Ms^Xm, Mm, Ms, Ms^Xm, Mm, Ms, Md, Hh^Fp, Hh^Fp, Gll^Fmw, Gll^Fmw, Aa^Fma, Aa, Gll, Aa, Aa^Fma, Aa, Gll, Gll^Fmw, Aa^Fma, Aa^Fma, Gll^Fmw, Hh^Fp, Hh^Fp, Md, Mm, Ms, Mm
Md, Ha^Fpa, Aa^Fma, Gll^Fmw, Gll^Fmw, Gll^Fmw, Gll^Fmw, Aa^Fma, Ha^Fpa, Hh^Fp, Hh^Fp, Aa^Fma, Ha^Fpa, Aa^Fma, Gll, Aa, Aa, Hh^Fp, Hh^Fp, Md, Mm, Ms^Xm, Ms, Mm, Ms^Xm, Xu, Uh, Uu^Uf, Uu^Emf, Uu^Emf, Wwg^Ii, Uu^Emf, Uu^Emf, Uu^Ufi, Xu, Ms^Xm, Mm, Ms, Ms^Xm, Mm, Mm, Ms, Md, Ha^Fpa, Aa^Fma, Aa, Aa^Fma, Gll^Fmw, Gll^Fmw, Aa^Fma, Ha^Fpa, Aa^Fma, Gll^Fmw, Aa, Gll^Fmw, Aa, Aa^Fma, Hh^Fp, Md, Mm, Ms, Ms, Mm
Md, Hh^Fp, Ha^Fpa, Hh^Fp, Ha^Fpa, Hh^Fp, Hh^Fp, Ha^Fpa, Md, Md, Md, Hh^Fp, Md, Ha^Fpa, Hh^Fp, Gll^Em, Gll, Gll^Fmw, Hh^Fp, Md, Md, Mm, Mm, Mm, Ms^Xm, Xu, Xu, Uu^Ufi, Uu^Emf, Wwg, Wwg^Ii, Wwg, Uu^Emf, Uu^Vud, Xu, Ms^Xm, Mm, Mm, Ms, Ms^Xm, Ms^Xm, Ms, Md, Ha^Fpa, Hh^Fp, Gll^Fmw, Ha^Fpa, Hh^Fp, Hh^Fp, Ha^Fpa, Md, Hh^Fp, Ha^Fpa, Aa^Fma, Hh^Fp, Gll^Fmw, Ha^Fpa, Ha^Fpa, Md, Mm, Ms, Mm, Mm
Ms^Xm, Md, Ms^Xm, Ha^Fpa, Ms^Xm, Ms^Xm, Ms^Xm, Ms^Xm, Ms^Xm, Ms^Xm, Md, Md, Mm, Md, Hh^Fp, Gll^Fmw, Gd^Vo, Gs, Gll, Uu, Ms^Xm, Mm, Mm, Ms, Ms^Xm, Ms^Xm, Xu, Uu^Vud, Uu^Emf, Wwg^Ii, Wwg, Wwg, Uu^Emf, Xu, Xu, Ms^Xm, Ms^Xm, Mm, Mm, Ms, Mm, Ms^Xm, Ms^Xm, Ha^Fpa, Hh^Fp, Hh^Fp, Md, Md, Md, Md, Ms, Md, Md, Hh^Fp, Md, Hh^Fp, Md, Md, Mm, Mm, Mm, Ms, Mm
Ms^Xm, Ms^Xm, Md, Ms, Md, Md, Md, Ms, Ms, Md, Ms, Mm, Ms^Xm, Md, Md, Hh^Fp, Uu, Gs, Uu, Uu, Xu, Ms^Xm, Ms^Xm, Mm, Ms^Xm, Ms^Xm, Ms^Xm, Xu, Uu^Ufi, Uu^Emf, Wwg, Uu^Emf, Uu^Ii, Uu^Ii, Xu, Ms^Xm, Ms^Xm, Ms^Xm, Ms^Xm, Ms, Mm, Ms, Mm, Md, Md, Md, Ms, Mm, Mm, Ms, Ms, Mm, Mm, Md, Mm, Md, Mm, Mm, Ms, Mm, Ms, Ms, Mm
Mm, Mm, Mm, Md, Ms^Xm, Ms^Xm, Ms^Xm, Mm, Mm, Mm, Mm, Ms^Xm, Ms^Xm, Ms^Xm, Mm, Md, Xu, Ur, Ur, Uu, Uh, Xu, Xu, Ms^Xm, Ms^Xm, Ms^Xm, Ms^Xm, Xu, Uh, Uu^Ufi, Ur, Wwg, Uu, Uu, Uu^Ufi, Xu, Xu, Ms^Xm, Ms^Xm, Ms^Xm, Mm, Mm, Mm, Mm, Ms^Xm, Mm, Mm^Xm, Mm, Mm, Mm, Mm, Mm, Mm, Mm, Mm, Mm, Mm, Ms, Mm, Ms, Mm, Mm, Mm
Mm, Ms^Xm, Ms^Xm, Ms^Xm, Xu, Xu, Xu, Ms^Xm, Ms^Xm, Mm, Mm, Ms^Xm, Ms^Xm, Ms^Xm, Ms, Ms^Xm, Xu, Xu, Uu, Ur, Uh, Uh, Xu, Ms^Xm, Ms^Xm, Ms^Xm, Xu, Xu, Xu, Uu^Uf, Uu^Ii, Wwg^Ii, Uu^Ii, Uu, Uu^Uf, Uh, Xu, Ms^Xm, Ms^Xm, Ms^Xm, Ms^Xm, Ms^Xm, Ms^Xm, Ms^Xm, Ms^Xm, Mm, Mm, Mm, Mm, Ms^Xm, Ms^Xm, Mm, Mm, Ms, Mm, Ms, Ms, Mm, Mm, Ms, Mm, Mm, Mm
Mm, Ms^Xm, Xu, Xu, Uu^Uf, Qxu, Qxu, Xu, Xu, Ms^Xm, Mm, Ms, Mm, Ms^Xm, Ms, Ms^Xm, Ms^Xm, Xu, Uh, Uu, Uu, Xu, Ms^Xm, Ms^Xm, Ms^Xm, Ms^Xm, Ha^Fpa, Mm^Xm, Mm^Xm, Xu, Ur, Wwg, Uu, Uu, Xu, Xu, Ms^Xm, Ms^Xm, Xu, Ms^Xm, Xu, Ms^Xm, Xu, Ms^Xm, Ms^Xm, Ms^Xm, Ms^Xm, Mm, Mm, Mm, Mm, Ms^Xm, Mm, Mm, Mm, Mm, Mm, Mm, Mm, Mm, Ms, Mm, Mm
Mm, Ms^Xm, Xu, Qxu, Uu^Vud, Uu^Vud, Uu, Xu, Xu, Ms^Xm, Ms^Xm, Ms, Mm, Ms^Xm, Mm, Ms^Xm, Xu, Xu, Uh, Ur, Uu^Uf, Xu, Xu, Ms^Xm, Ms^Xm, Ms^Xm, Ha^Fpa, Hh^Fp, Hh^Fp, Xu, Ur, Wwg, Xu, Xu, Xu, Ms^Xm, Xu, Xu, Xu, Xu, Uu^Uf, Xu, Uu^Vud, Xu, Xu, Ms^Xm, Ms^Xm, Ms^Xm, Ms^Xm, Mm, Mm, Ms^Xm, Mm, Ms, Ms, Mm, Mm, Ms, Ms, Mm, Mm, Mm, Mm
Ms^Xm, Ms^Xm, Xu, Qxu, Uu^Uf, Uu^Vud, Ur, Uu^Uf, Uu^Uf, Xu, Xu, Ms^Xm, Ms^Xm, Mm, Mm, Ms^Xm, Xu, Uh, Uu, Ur, Uu, Uh, Xu, Ms^Xm, Ms^Xm, Ha^Fpa, Aa^Fma, Aa^Fma, Gll^Fmw, Gll^Fmw, Wwg, Wwg, Mm^Xm, Xu, Mm^Xm, Xu, Xu, Xu, Uu^Vud, Uu^Uf, Uu, Uu, Uh, Uh, Qxu, Xu, Xu, Ms^Xm, Xu, Ms^Xm, Mm, Ms^Xm, Ms^Xm, Mm, Ms, Mm, Ms, Mm, Ms, Ms, Mm, Mm, Mm
Mm, Ms^Xm, Xu, Xu, Xu, Qxu, Qxu, Ur, Ur, Qxu, Qxu, Xu, Ms^Xm, Mm, Ms^Xm, Ms^Xm, Xu, Uu^Uf, Ur, Ur, Ur, Uu, Uu^Uf, Xu, Xu, Ha^Fpa, Aa^Fma, Aa, Gll, Aa, Wwg, Gll^Fmw, Hh^Fp, Mm^Xm, Mm^Xm, Xu, Qxu, Qxu, Ur, Ur, Xu, Xu, Uu, Uh, Qxu, Qxu, Qxu, Xu, Xu, Ms^Xm, Mm, Mm, Mm, Mm, Mm, Mm, Mm, Mm, Mm, Ms, Md, Ms, Mm
Mm, Ms^Xm, Ms^Xm, Xu, Xu, Xu, Qxu, Uu, Ur, Qxu, Qxu, Xu, Ms^Xm, Ms^Xm, Xu, Xu, Uu^Vud, Uu, Xu, Xu, Xu, Ur, Ur, Xu, Xu, Aa^Fma, Aa, Aa, Aa^Fma, Aa^Fma, Wwg, Gll^Fmw, Hh^Fp, Ha^Fpa, Mm^Xm, Xu, Qxu, Uu, Ur, Xu, Uu, Ur, Uu, Uu, Wwg, Qxu, Qxu, Uh, Xu, Ms^Xm, Ms^Xm, Mm, Mm, Ms^Xm, Mm, Mm, Mm, Mm, Md, Md, Md, Md, Md
Ms, Ms^Xm, Ms^Xm, Ms^Xm, Ms^Xm, Xu, Xu, Uu, Uu, Uu^Uf, Qxu, Xu, Ms^Xm, Xu, Xu, Xu, Ur, Ur, Xu, Xu, Xu, Uu, Ur, Uu^Vud, Ur, Uu, Ur, Aa^Fma, Ha^Fpa, Wwg, Ha^Fma, Hh^Fp, Ha^Fpa, Ha^Fpa, Mm^Xm, Xu, Uh, Uu, Uu, Uu, Qxu, Ur, Uu, Xu, Uh, Wwg, Uu, Uh, Xu, Ms^Xm, Ms^Xm, Mm, Mm, Mm, Mm, Ms^Xm, Coa, Co, Coa, Hh^Fp, Ha^Fpa, Hh^Fp, Hh^Fp
Mm, Mm, Mm, Ms^Xm, Ms^Xm, Ms^Xm, Xu, Uh, Ur, Uu, Xu, Xu, Xu, Xu, Uu, Uu, Ur, Uu, Uh, Xu, Xu, Uu, Uu, Ur, Uu, Ur, Uu, Xu, Xu, Wwg, Xu, Hh^Fp, Mm^Xm, Mm^Xm, Mm^Xm, Xu, Uh, Uh, Uu, Ur, Xu, Qxu, Uu, Xu, Wwg, Wwf, Uu, Uu, Uu^Vud, Xu, Xu, Ms^Xm, Ms^Xm, Mm, Mm, Ms^Xm, Coa, Koa, Co, Hh^Fp, Aa^Fma, Aa^Fma, Aa
Mm, Ms, Mm, Mm, Ms^Xm, Ms^Xm, Xu, Uh, Ur, Uu^Uf, Xu, Xu, Xu, Uu, Xu, Ur, Xu, Uu, Uu^Uf, Xu, Xu, Uu, Ur, Ur, Uu^Uf, Ur, Ur, Xu, Uu, Wwg, Xu, Mm^Xm, Xu, Mm^Xm, Xu, Xu, Xu, Xu, Ur, Ur, Uu, Uu, Uu, Uu^Vud, Wwf, Xu, Xu, Uu, Uu, Uu^Uf, Xu, Ms^Xm, Ms^Xm, Ms^Xm, Mm, Md, Ms^Xm, Coa, Coa, Aa, Gll, Aa, Ha^Fpa
Ms, Ms, Mm, Ms^Xm, Ms^Xm, Ms^Xm, Xu, Qxu, Ur, Uu, Uu, Uh, Ur, Uu, Ur, Uu, Uu, Ur, Ur, Uu, Uu, Xu, Ur, Uu^Uf, Uh, Uu^Uf, Ur, Uu, Uu, Wwg, Wwf, Xu, Uu^Uf, Xu, Xu, Xu, Uu, Ur, Uu, Uu, Cud, Uu, Wwg, Wwf, Uu, Uh, Xu, Uh, Uu, Uu, Qxu, Xu, Xu, Ms^Xm, Ms^Xm, Md, Ms^Xm, Ha^Fpa, Hh^Fp, Aa^Fma, Aa^Fma, Hh^Fp, Md
Mm, Ms, Ms^Xm, Ms^Xm, Ms^Xm, Ms^Xm, Xu, Xu, Uu, Uu, Uu, Ur, Xu, Ur, Uu^Uf, Uh, Xu, Xu, Xu, Ur, Ur, Ur, Uu, Xu, Xu, Xu, Xu, Ur, Uh, Xu, Wwf, Uu, Ur, Uu, Wwf, Uu, Xu, Ur, Ur, Cud, 4 Kud, Cud, Cud, Uu, Uu, Uh, Uu, Xu, Uu, Uu, Qxu, Qxu, Xu, Ms^Xm, Ms^Xm, Md, Ms^Xm, Ha^Fpa, Ha^Fpa, Ha^Fpa, Ha^Fpa, Hh^Fp, Md
Mm, Mm, Ms^Xm, Ms^Xm, Ms^Xm, Ms^Xm, Ms^Xm, Xu, Ur, Ur, Xu, Uu, Uu, Uu, Xu, Xu, Uu, Uu^Vud, Ur, Uu, Ur, Uu, Xu, Xu, Uh, Xu, Ur, Uu, Uh, Uh, Wwg, Xu, Wwg, Wwf, Xu, Wwg, Wwf, Wwf, Wwg, Cud, Wwg, Wwg, Cud, Ur, Ur, Uu, Uu, Uu, Uu, Uu, Uh, Xu, Ms^Xm, Ms^Xm, Ms^Xm, Mm, Mm, Ms^Xm, Md, Ha^Fpa, Md, Md, Mm
Ms^Xm, Ms^Xm, Xu, Xu, Xu, Ms^Xm, Ms^Xm, Xu, Ur, Uu, Xu, Qxu, Xu, Xu, Uh, Uh, Ur, Ur, Qxu, Ur, Uu, Uu, Xu, Uh, Ur, Ur, Uh, Uu, Uu^Vud, Uh, Xu, Wwg, Wog, Uh, Uu, Ur, Xu, Uu, Uu, Cud, Cud, Cud, Uu^Uf, Xu, Uu, Ur, Ur, Xu, Ur, Uh, Uh, Xu, Ms^Xm, Ms^Xm, Mm, Mm, Ms, Ms^Xm, Mm, Md, Mm, Mm, Mm
Ms^Xm, Ms^Xm, Xu, Wwg, Xu, Xu, Xu, Xu, Ur, Uu^Uf, Uu^Uf, Xu, Uu, Uu, Ur, Uu, Uu, Xu, Xu, Xu, Uu, Ur, Xu, Uh, Ur, Xu, Xu, Xu, Xu, Xu, Uu^Uf, Xu, Xu, Xu, Xu, Xu, Uu^Vud, Uu, Uu, Uu, Uu^Uf, Uu^Uf, Uu^Uf, Xu, Uu, Uu, Uu, Ur, Uu, Ur, Uu, Xu, Ms^Xm, Ms^Xm, Ms^Xm, Mm, Ms, Ms^Xm, Mm, Mm, Mm, Ms, Mm
Ms^Xm, Ms^Xm, Xu, Wwg, Wwg, Xu, Uh, Xu, Uu, Uu^Uf, Ur, Ur, Ur, Ur, Xu, Uu, Ur, Qxu, Qxu, Xu, Uu, Ur, Uh, Xu, Cud, Ur, Uu, Cud, Uu, Uu^Uf, Cud, Uh, Wog, Xu, Uu^Uf, Xu, Xu, Uu, Xu, Xu, Uh, Uu^Uf, Uh, Xu, Uu^Vud, Uu, Qxu, Xu, Uh, Ur, Uu, Xu, Ms^Xm, Ms^Xm, Ms^Xm, Mm, Ms, Ms^Xm, Mm, Ms, Mm, Ms, Mm
Ms^Xm, Ms^Xm, Xu, Uh, Xu, Wwg, Wwg, Uh, Uu, Uu, Ur, Uu, Xu, Xu, Uu, Uu, Uu, Ur, Uu^Vud, Xu, Uu, Ur, Uh, Xu, Xu, Uu, Uu, Uu, Cud, Uu^Vud, Cud, Wwg, Cud, Uh, Uu, Uu^Uf, Xu, Xu, Xu, Xu, Xu, Uh, Xu, Xu, Qxu, Uu, Qxu, Xu, Uh, Uu, Uu, Xu, Ms^Xm, Ms^Xm, Ms^Xm, Ms, Mm, Mm, Mm, Ms, Mm, Mm, Mm
Ms^Xm, Ms^Xm, Xu, Xu, Ms^Xm, Xu, Xu, Wwg, Wwf, Wwf, Wwf, Xu, Uh, Uu, Uu, Xu, Uh, Ur, Ur, Xu, Wwg, Wwf, Wwf, Uh, Uu^Uf, Xu, Xu, Uu, Uu^Vud, Cud, 2 Kud, Cud, Uu^Vud, Uu, Uu, Uu, Xu, Xu, Xu, Xu, Xu, Xu, Qxu, Qxu, Uu, Uu, Qxu, Xu, Uu^Vud, Ur, Uu^Uf, Xu, Xu, Ms^Xm, Ms^Xm, Mm, Mm, Mm, Ms^Xm, Ms, Mm, Mm, Ms
Ms^Xm, Ms^Xm, Ms^Xm, Ms^Xm, Ms^Xm, Ms^Xm, Xu, Uh, Uu, Uh, Ur, Wwg, Wwg, Wwf, Wwf, Xu, Xu, Uu, Wwf, Wwf, Uu^Uf, Xu, Wwg, Uu^Uf, Uu^Uf, Xu, Xu, Uu, Cud, Cud, Cud, Cud, Cud, Uu, Uu, Cud, Uu, Xu, Xu, Xu, Uh, Uh, Uu, Uu, Qxu, Uu, Xu, Xu, Uu, Ur, Uu, Xu, Xu, Ms^Xm, Ms^Xm, Mm, Mm, Ms^Xm, Mm, Mm, Mm, Mm, Ms
Mm, Ms^Xm, Ms^Xm, Ms^Xm, Ms^Xm, Xu, Xu, Uu, Uu, Uu, Ur, Xu, Xu, Uh, Uu, Wwg, Wwg, Wwg, Xu, Uu, Ur, Uu^Uf, Wwg, Uu, Uu, Xu, Xu, Uu^Uf, Uu^Uf, Wwg, Cud, Uu^Vud, Uu, Uu, Cud, Uu, Uu, Uu, Uu, Qxu, Qxu, Qxu, Uu, Qxu, Uh, Qxu, Xu, Qxu, Uu, Ur, Uu, Qxu, Xu, Ms^Xm, Ms^Xm, Ms^Xm, Mm, Ms^Xm, Ms^Xm, Mm, Ms, Ms, Mm
Mm, Ms, Ms, Ms^Xm, Ms^Xm, Ms^Xm, Ms^Xm, Xu, Uu^Uf, Uu, Uu, Ur, Uu, Xu, Xu, Uh, Uh, Uu, Uu, Xu, Ur, Uu, Wwf, Uu^Vud, Uu, Uh, Xu, Uh, Wog, Wwg, Uu^Uf, Uu, Xu, Uu, Xu, Uu, Uu, Uu, Uu, Uu, Uu, Uu, Uh, Uh, Xu, Xu, Qxu, Qxu, Uu, Ur, Uu, Qxu, Xu, Ms^Xm, Ms^Xm, Ms^Xm, Mm, Mm, Ms^Xm, Mm, Mm, Mm, Mm
Ms, Mm, Ms, Mm, Ms^Xm, Ms^Xm, Ms^Xm, Xu, Xu, Uu, Qxu, Qxu^Bh|, Qxu, Qxu, Uu^Uf, Xu, Xu, Uu, Uu, Uu, Cud, Uu, Uu, Wwf, Wwg, Uu, Wog, Xu, Xu, Uh, Xu, Xu, Xu, Xu, Xu, Xu, Xu, Qxu, Qxu, Uu, Qxu, Uh, Xu, Xu, Xu, Xu, Xu, Uh, Uu, Ur, Uu, Xu, Xu, Ms^Xm, Ms^Xm, Ms^Xm, Ms, Ms, Mm, Ms^Xm, Ms, Mm, Mm
Mm, Ms, Ms, Mm, Ms^Xm, Ms^Xm, Ms^Xm, Xu, Xu, Qxu, Uu^Vud, Ur, Qxu^Bh\, Qxu, Qxu, Qxu, Uu^Uf, Xu, Uu, Cud, Kud, Uu, Uu, Uh, Uh, Wwg, Uu, Uu, Uu, Xu, Uu, Uh, Ur, Uu^Uf, Uu^Vud, Uh, Uh, Xu, Xu, Qxu, Xu, Xu, Xu, Xu, Uh, Xu, Xu, Xu, Xu, Ur, Ur, Uh, Uh, Xu, Ms^Xm, Ms^Xm, Mm, Mm, Mm, Ms^Xm, Mm, Ms, Mm
Mm, Mm, Mm, Mm, Mm, Ms^Xm, Ms^Xm, Ms^Xm, Xu, Xu, Qxu, Qxu, Qxu, Qxu^Bh\, Ur, Qxu, Uu^Uf, Xu, Uu, Uu, Uu, Ur, Ur, Uh, Uh, Wwg, Ur, Ur, Ur, Ur, Ur, Ur, Xu, Ur, Ur, Ur, Ur, Uu, Uu, Xu, Uh, Uh, Uu, Uh, Uu, Uh, Uh, Xu, Xu, Uh, Ur, Uu, Uu, Xu, Ms^Xm, Ms^Xm, Ms^Xm, Mm, Mm, Ms^Xm, Mm, Mm, Mm
Ms^Xm, Mm, Ms^Xm, Mm, Mm, Ms^Xm, Ms^Xm, Ms^Xm, Ms^Xm, Xu, Qxu, Xu, Xu, Qxu, Ur, Qxu, Xu, Xu, Uu, Uu, Uh, Uu, Ur, Uu, Uu, Wwf, Uu, Xu, Xu, Uu, Ur, Xu, Xu, Uh, Xu, Uu, Uu, Ur, Ur, Uu, Ur, Uu, Ur, Ur, Ur, Ur, Ur, Uh, Xu, Uh, Uu, Ur, Uh, Xu, Xu, Ms^Xm, Ms^Xm, Ms^Xm, Mm, Mm, Mm, Ms, Mm
Ms^Xm, Mm, Ms^Xm, Mm, Mm, Mm, Mm, Ms^Xm, Ms^Xm, Xu, Xu, Qxu, Qxu, Qxu, Qxu^Bh|, Qxu, Xu, Uu^Vud, Uu, Uh, Uh, Uh, Ur, Xu, Uu, Wwf, Uu, Xu, Xu, Uu^Uf, Uu, Ur, Ur, Xu, Xu, Uu^Uf, Uu^Vud, Uu, Uh, Ur, Uu, Ur, Uh, Uh, Uh, Uu, Ur, Uh, Xu, Xu, Uh, Ur, Uh, Xu, Xu, Ms^Xm, Ms^Xm, Ms^Xm, Mm, Mm, Ms, Mm, Mm
Mm, Ms^Xm, Ms^Xm, Mm, Mm, Mm, Mm, Ms^Xm, Ms^Xm, Ms^Xm, Ms^Xm, Xu, Xu, Uu, Ur, Uu, Uh, Xu, Uu, Uu^Uf, Uu^Uf, Uu^Uf, Ur, Xu, Uu, Wwg, Wwg, Uu, Uu, Xu, Xu, Uu, Ur, Uh, Xu, Xu, Xu, Uh, Xu, Uh, Xu, Xu, Xu, Xu, Uh, Uu, Ur, Uh, Ms, Xu, Ms, Ha^Fpa, Aa^Fma, Xu, Ms, Ms^Xm, Ms^Xm, Ms^Xm, Mm, Ms, Mm, Mm, Mm
Mm, Mm, Ms^Xm, Mm, Mm, Mm, Mm, Mm, Mm, Ms^Xm, Ms^Xm, Ms^Xm, Xu, Uh, Ur, Uu, Uu^Uf, Xu, Xu, Uu, Uu, Uu, Uu, Xu, Xu, Uu, Uu, Wwg, Wwf, Uu, Wwf, Wwg, Wwf, Uu, Wwg, Wwg, Wwg, Xu, Wwg, Xu, Xu, Xu, Xu, Xu, Ha^Fpa, Aa, Aa^Fma, Ha^Fpa, Ms^Xm, Ms^Xm, Ms^Xm, Ha^Fpa, Gll^Fmw, Ha^Fpa, Mm, Ms, Ms^Xm, Mm, Ms, Ms, Md, Md, Md
Mm, Mm, Mm, Ms^Xm, Mm, Ms^Xm, Ms^Xm, Mm, Mm, Mm, Ms^Xm, Ms^Xm, Xu, Uu^Uf, Uu, Ur, Uu, Uu, Md, Xu, Uu, Uu, Ur, Uu, Uu^Uf, Xu, Xu, Ur, Ur, Wwf, Uu, Xu, Uu^Uf, Wwf, Uu, Xu, Xu, Wwg, Xu, Wog, Xu, Xu, Xu, Ms^Xm, Ha^Fpa, Aa^Fma, Aa^Fma, Ha^Fpa, Ha^Fpa, Ms^Xm, Hh^Fp, Hh^Fp, Gll^Fmw, Hh^Fp, Ms^Xm, Ms, Ms^Xm, Ms, Mm, Md, Ha^Fpa, Md, Md
Ms, Ms, Ms, Mm, Ms^Xm, Mm, Ms^Xm, Mm, Ms^Xm, Mm, Mm, Ms^Xm, Ms^Xm, Xu, Uu, Ur, Gll, Uu, Md, Xu, Xu, Uu, Uu, Ur, Ur, Uu, Uu, Xu, Xu, Ur, Ur, Xu, Ur, Ur, Ur, Xu, Qxu, Xu, Xu, Xu, Xu, Wog, Wwg, Ms^Xm, Hh^Fp, Gll^Fmw, Ai, Ai, Wwg, Ha^Fpa, Ai, Gll^Fmw, Ha^Fpa, Hh^Fp, Ms^Xm, Ms, Ms^Xm, Mm, Ms, Md, Md, Hh^Fp, Hh^Fp
Md, Md, Md, Ms, Md, Ms^Xm, Ms, Ms^Xm, Mm, Mm, Ms, Ms, Md, Md, Hh^Fp, Gll, Gll, Hh^Fp, Md, Ms^Xm, Ms^Xm, Xu, Uh, Uu, Uu, Ur, Ur, Qxu, Qxu, Qxu, Ur, Ur, Uu, Uu, Ur, Uu, Uu, Qxu, Xu, Xu, Xu, Xu, Xu, Ai, Wwg, Wwg, Ai, Wwg, Ai, Ai, Wwg, Ha^Fpa, Ms^Xm, Ms^Xm, Ms^Xm, Ms^Xm, Ms, Mm, Ms, Ms, Md, Hh^Fp, Hh^Fp
Hh^Fp, Hh^Fp, Hh^Fp, Ha^Fpa, Hh^Fp, Md, Md, Mm, Ms, Ms, Mm, Md, Md, Hh^Fp, Aa^Fma, Gll^Es, Gll, Hh^Fp, Ha^Fpa, Md, Ms^Xm, Xu, Xu, Uh, Xu, Xu, Xu, Ur, Ur, Ur, Qxu, Xu, Xu, Qxu, Uu, Ur, Ur, Uu, Uh, Xu, Xu, Xu, Ms^Xm, Ms^Xm, Hh^Fp, Hh^Fp, Aa, Ai, Aa^Fma, Wwg, Ha^Fpa, Ha^Fpa, Ms^Xm, Ms^Xm, Md, Ms^Xm, Md, Md, Md, Md, Hh^Fp, Hh^Fp, Gll^Fmw
Gll^Fmw, Aa^Fma, Aa^Fma, Hh^Fp, Hh^Fp, Hh^Fp, Ha^Fpa, Ms, Md, Mm, Ms^Xm, Mm, Ms, Ha^Fpa, Hh^Fp, Gll, Gll^Es, Aa^Fma, Ha^Fpa, Ms, Mm, Ms^Xm, Ms^Xm, Xu, Ms^Xm, Xu, Xu, Qxu, Qxu, Qxu, Xu, Xu, Xu, Xu, Xu, Uu, Uu, Ur, Uu^Uf, Xu, Xu, Ms^Xm, Ms^Xm, Ha^Fpa, Ha^Fpa, Ha^Fpa, Ha^Fpa, Ha^Fpa, Hh^Fp, Hh^Fp, Ms^Xm, Ms^Xm, Ms^Xm, Ms, Md, Ms, Md, Hh^Fp, Hh^Fp, Md, Hh^Fp, Gll^Fmw, Gs
Gll, Aa, Gll^Fmw, Gll^Fmw, Gll^Fmw, Hh^Fp, Ha^Fpa, Ms, Mm, Mm, Mm, Mm, Mm, Md, Ha^Fpa, Gll, Aa, Aa^Fma, Ha^Fpa, Ms, Mm, Ms^Xm, Ms^Xm, Ms^Xm, Ms^Xm, Ms^Xm, Ms^Xm, Xu, Xu, Xu, Xu, Ms^Xm, Ms^Xm, Xu, Xu, Xu, Uh, Ur, Ur, Uu^Uf, Xu, Ms^Xm, Mm, Ms^Xm, Ms^Xm, Ms^Xm, Ms^Xm, Ha^Fpa, Ms^Xm, Ms^Xm, Md, Ms^Xm, Md, Md, Ha^Fpa, Ha^Fpa, Hh^Fp, Hh^Fp, Gll^Fmw, Hh^Fp, Gll^Fmw, Gll^Fmw, Gll
Gll^Fmw, Aa^Fma, Gll^Em, Gll^Em, Gll^Fmw, Hh^Fp, Hh^Fp, Md, Ms^Xm, Ms^Xm, Ms^Xm, Ms^Xm, Ms, Ms, Ha^Fpa, Aa^Fma, Gll, Gll^Fmw, Hh^Fp, Ms, Ms, Ms^Xm, Ms^Xm, Ms^Xm, Ms^Xm, Ms^Xm, Mm, Ms^Xm, Ms^Xm, Ms^Xm, Ms^Xm, Ms^Xm, Ms^Xm, Ms^Xm, Ms^Xm, Xu, Xu, Uu, Ur, Uu^Uf, Xu, Ms^Xm, Mm, Mm, Ms, Ms, Mm, Ms^Xm, Ms^Xm, Ms^Xm, Md, Ms, Hh^Fp, Hh^Fp, Aa^Fma, Aa^Fma, Aa^Fma, Aa^Fma, Gd^Vo, Gll^Fmw, Gll^Em, Gll, Gll
Gll, Aa^Fma, Aa, Gll^Fmw, Hh^Fp, Hh^Fp, Md, Ms, Mm, Mm, Ms^Xm, Mm, Md, Md, Hh^Fp, Aa^Fma, Gll^Es, Gll^Fmw, Aa^Fma, Hh^Fp, Md, Mm, Ms^Xm, Mm, Ms^Xm, Ms, Md, Ms^Xm, Ms^Xm, Ms^Xm, Ms^Xm, Ms^Xm, Ms^Xm, Ms^Xm, Ms^Xm, Ms^Xm, Xu, Uu, Ur, Uu, Xu, Ms^Xm, Ms^Xm, Mm, Ms^Xm, Ms^Xm, Ms^Xm, Ms, Ms^Xm, Md, Ms, Ha^Fpa, Hh^Fp, Aa^Fma, Gll, Aa, Aa, Aa, Aa, Gll, Gll^Fmw, Aa^Fma, Gs
Aa, Aa, Aa^Fma, Aa^Fma, Hh^Fp, Md, Ms, Mm, Ms^Xm, Mm, Ms, Mm, Md, Hh^Fp, Hh^Fp, Gll^Fmw, Gll^Es, Gll, Aa^Fma, Ha^Fpa, Ms, Ms^Xm, Mm, Mm, Ms^Xm, Md, Hh^Fp, Ha^Fpa, Ha^Fpa, Md, Md, Mm, Ms, Ms^Xm, Ms^Xm, Xu, Uh, Uh, Ur, Uu^Vud, Xu, Ms^Xm, Ms^Xm, Mm, Mm, Mm, Mm, Ms^Xm, Mm, Md, Ms, Ha^Fpa, Hh^Fp, Gll^Fmw, Gll^Em, Gll^Fmw, Aa^Fma, Aa^Fma, Gll, Aa^Fma, Gll, Gll, Gll
Aa^Fma, Aa, Gll^Fmw, Hh^Fp, Hh^Fp, Md, Md, Mm, Ms^Xm, Ms^Xm, Mm, Ms, Ms, Md, Hh^Fp, Gll^Fmw, Gll^Fmw, Gll^Es, Aa^Fma, Ha^Fpa, Ms, Ms^Xm, Ms, Ms^Xm, Md, Ha^Fpa, Hh^Fp, Hh^Fp, Aa^Fma, Hh^Fp, Hh^Fp, Md, Md, Ms, Ha^Fpa, Ha^Fpa, Aa^Fma, Uu, Ur, Uh, Xu, Xu, Ms^Xm, Ms, Mm, Ms, Ms, Mm, Ms, Mm, Ms, Ha^Fpa, Hh^Fp, Gll^Fmw, Gll^Fmw, Aa^Fma, Aa, Aa, Aa, Gll^Fmw, Aa^Fma, Gs^Es, Gll
Aa^Fma, Gll, Gll^Fmw, Gll^Fmw, Gll^Fmw, Hh^Fp, Md, Mm, Mm, Ms^Xm, Ms^Xm, Mm, Mm, Md, Md, Hh^Fp, Gll^Fmw, Gll, Gll^Fmw, Ha^Fpa, Ms, Mm, Ms^Xm, Mm, Mm, Md, Ha^Fpa, Aa^Fma, Gll^Fmw, Gll^Fmw, Hh^Fp, Md, Hh^Fp, Ha^Fpa, Aa^Fma, Aa^Fma, Aa, Aa, Uu, Uh, Xu, Ms^Xm, Mm, Ms^Xm, Mm, Mm, Ms^Xm, Mm, Mm, Mm, Md, Md, Hh^Fp, Gll^Fmw, Gll^Fmw, Aa^Fma, Gll^Fmw, Gll^Es, Aa^Fma, Aa^Fma, Gll^Fmw, Gs, Gll
Gll^Fmw, Gll, Gll, Gll, Gll^Fmw, Hh^Fp, Ha^Fpa, Ms, Ms, Ms^Xm, Ms^Xm, Ms^Xm, Mm, Ms, Md, Hh^Fp, Aa^Fma, Gll, Aa^Fma, Hh^Fp, Mm, Ms^Xm, Mm, Mm, Mm, Ms, Md, Hh^Fp, Gll^Fmw, Gll^Fmw, Gll^Fmw, Hh^Fp, Gll^Fmw, Gll^Fmw, Gll, Gll, Gll^Es, Aa^Fma, Ha^Fpa, Ms^Xm, Ms^Xm, Ms^Xm, Mm, Ms^Xm, Mm, Ms^Xm, Mm, Mm, Ms, Mm, Mm, Md, Hh^Fp, Aa^Fma, Aa, Aa^Fma, Gll^Fmw, Gll^Fmw, Gll^Fmw, Gll, Gll^Es, Gll^Fmw, Gs
Gll, Gll^Fmw, Gll^Em, Gll^Es, Gll^Fmw, Hh^Fp, Hh^Fp, Md, Ms, Mm, Mm, Ms^Xm, Mm, Mm, Ms, Ha^Fpa, Aa^Fma, Aa, Aa^Fma, Ha^Fpa, Ms, Ms^Xm, Mm, Ms^Xm, Mm, Mm, Md, Hh^Fp, Gll^Fmw, Gll, Gll, Gll^Fmw, Gll, Gll, Gll^Es, Gll, Gll^Fmw, Aa^Fma, Ha^Fpa, Ms^Xm, Mm, Mm, Ms, Ms, Mm, Mm, Ms, Ms, Md, Mm, Md, Md, Ha^Fpa, Aa^Fma, Aa, Gll^Em, Aa^Fma, Aa^Fma, Aa^Fma, Gll^Fmw, Gll^Fmw, Gs, Gll
Aa, Aa^Fma, Gll^Fmw, Gll^Es, Gll, Gll^Fmw, Aa^Fma, Ha^Fpa, Md, Md, Md, Ms, Md, Ms, Md, Ha^Fpa, Gll^Fmw, Gll^Es, Aa^Fma, Ha^Fpa, Ha^Fpa, Mm, Ms^Xm, Ms^Xm, Mm, Ms, Ha^Fpa, Hh^Fp, Gll^Fmw, Gll^Es, Gll, Gll^Es, Gll^Fmw, Gll^Fmw, Gll^Fmw, Gll^Fmw, Gll^Fmw, Hh^Fp, Mm, Ms, Mm, Ms^Xm, Ms^Xm, Ms^Xm, Md, Md, Md, Md, Hh^Fp, Hh^Fp, Hh^Fp, Ha^Fpa, Aa^Fma, Aa^Fma, Gll^Fmw, Aa^Fma, Ha^Fpa, Aa^Fma, Ha^Fpa, Hh^Fp, Hh^Fp, Gll^Fmw, Gs
Aa, Gll^Em, Aa, Aa^Fma, Gs, Aa, Gll^Fmw, Hh^Fp, Hh^Fp, Hh^Fp, Hh^Fp, Md, Hh^Fp, Md, Hh^Fp, Hh^Fp, Gll^Fmw, Gll, Aa, Aa^Fma, Hh^Fp, Mm, Ms, Mm, Md, Ha^Fpa, Hh^Fp, Hh^Fp, Gll^Fmw, Gll, Gll^Fmw, Gll^Fmw, Hh^Fp, Hh^Fp, Ha^Fpa, Hh^Fp, Ha^Fpa, Hh^Fp, Mm, Mm, Mm, Ms^Xm, Mm, Md, Md, Hh^Fp, Hh^Fp, Ha^Fpa, Aa^Fma, Gll^Fmw, Gll^Fmw, Gll^Fmw, Gll^Fmw, Gll^Fmw, Hh^Fp, Ha^Fpa, Ms, Ha^Fpa, Ms, Md, Hh^Fp, Aa^Fma, Gs
Aa^Fma, Aa^Fma, Aa^Fma, Aa, Gs^Es, Gd^Vo, Aa, Gll^Fmw, Aa^Fma, Hh^Fp, Gll^Fmw, Hh^Fp, Hh^Fp, Hh^Fp, Gll^Fmw, Gll^Fmw, Gll, Gll^Es, Gll^Es, Gll^Fmw, Aa^Fma, Ha^Fpa, Ha^Fpa, Md, Md, Hh^Fp, Gll^Fmw, Gll^Fmw, Gll, Gll, Gll^Fmw, Hh^Fp, Md, Ha^Fpa, Ms, Md, Ms, Mm, Mm, Ms, Ms, Mm, Ms, Md, Ha^Fpa, Ha^Fpa, Aa^Fma, Aa^Fma, Aa, Gll, Gll^Es, Gll^Em, Gll^Fmw, Hh^Fp, Md, Md, Md, Ms, Md, Ha^Fpa, Gll^Fmw, Gll^Fmw, Gll
Hh^Fp, Ha^Fpa, Ha^Fpa, Aa^Fma, Gll, Gll^Fmw, Gll^Fmw, Aa, Aa, Aa^Fma, Gll, Gll^Fmw, Gll^Fmw, Gll^Fmw, Gll^Fmw, Gll, Gll^Fmw, Aa, Gll^Fmw, Re^Vct, Aa, Aa^Fma, Hh^Fp, Hh^Fp, Hh^Fp, Hh^Fp, Gll^Fmw, Gll, Gs, Gll^Es, Gll^Fmw, Hh^Fp, Md, Mm, Ms, Mm, Mm, Ms, Mm, Ms, Mm, Ms, Md, Md, Hh^Fp, Aa^Fma, Gll, Aa, Gs, Gs^Es, Aa^Fma, Gll^Fmw, Hh^Fp, Hh^Fp, Md, Md, Md, Ms, Ha^Fpa, Hh^Fp, Gll^Fmw, Gs, Gll^Es
Md, Ms, Ha^Fpa, Gll^Fmw, Gll^Fmw, Aa, Aa^Fma, Aa^Fma, Gs, Gs, Gs, Gll^Em, Gll^Fmw, Gll^Fmw, Hh^Fp, Gll^Fmw, Hh^Fp, Aa^Fma, Hh^Fp, Gll^Fmw, Aa, Gll^Fmw, Ce, Gll^Fmw, Gll^Fmw, Gll^Fmw, Gll, Gll^Es, Aa, Gs, Gll^Fmw, Hh^Fp, Md, Ms, Mm, Ms, Ms, Mm, Ms, Ms, Mm, Md, Hh^Fp, Hh^Fp, Gll^Fmw, Gll^Fmw, Gll, Gs, Aa, Aa^Fma, Aa, Aa^Fma, Ha^Fpa, Md, Ms, Ms, Md, Md, Hh^Fp, Gll^Fmw, Gll, Gll, Gs
Md, Ms, Md, Hh^Fp, Aa^Fma, Aa, Gll, Gs, Aa, Gs^Es, Gs, Aa, Aa^Fma, Hh^Fp, Md, Hh^Fp, Md, Ha^Fpa, Hh^Fp, Aa^Fma, Aa^Fma, Ce, 3 Ke, Ce, Gll, Gll, Gs, Gs, Gs, Re^Vct, Gll^Fmw, Hh^Fp, Hh^Fp, Md, Md, Mm, Ms, Mm, Mm, Mm, Ms, Md, Hh^Fp, Gll^Fmw, Gd^Vo, Gll, Gll, Gll^Fmw, Gs, Aa, Aa^Fma, Aa^Fma, Hh^Fp, Ms, Md, Md, Md, Hh^Fp, Gll^Fmw, Gll^Fmw, Gll^Es, Gll^Es, Gll^Fmw
Ms, Md, Md, Hh^Fp, Ha^Fpa, Aa^Fma, Aa, Gs, Aa, Gs^Es, Aa, Aa^Fma, Ha^Fpa, Ha^Fpa, Md, Md, Ms, Ms, Ms, Ha^Fpa, Aa^Fma, Ce, Ce, Ce, Gs, Aa, Gs^Cov, Gs^Cov, Ce, Gs^Es, Gll^Es, Gll^Fmw, Aa^Fma, Hh^Fp, Hh^Fp, Md, Ha^Fpa, Ms, Md, Ms, Ha^Fpa, Ha^Fpa, Gll^Fmw, Gll^Fmw, Gll, Gll^Em, Aa, Gll^Fmw, Gs^Em, Aa^Fma, Ha^Fpa, Ha^Fpa, Ms, Ms, Ha^Fpa, Md, Hh^Fp, Hh^Fp, Gll^Fmw, Gll, Gll^Fmw, Gll^Fmw, Hh^Fp
Ms, Ms, Ms, Ms, Ha^Fpa, Aa^Fma, Gll, Gs^Es, Gs, Gs, Aa, Aa^Fma, Ha^Fpa, Ms, Ms, Ms, Md, Md, Ms, Ha^Fpa, Aa^Fma, Aa, Gs, Gs, Gs^Es, Gs, Gs^Cov, Ce^Kov, 1 Ke, Ce, Gs, Gll, Aa^Fma, Ha^Fpa, Gll^Fmw, Hh^Fp, Aa^Fma, Ha^Fpa, Hh^Fp, Ha^Fpa, Aa^Fma, Aa^Fma, Gs, Gs^Es, Gll, Gll^Fmw, Aa^Fma, Gll^Fmw, Aa, Aa^Fma, Ha^Fpa, Ms, Md, Ha^Fpa, Aa^Fma, Hh^Fp, Aa^Fma, Gll^Fmw, Gll^Em, Aa, Gll^Fmw, Hh^Fp, Md
Mm, Mm, Ms, Md, Hh^Fp, Gll^Fmw, Aa, Gs, Gs^Es, Gs, Gs, Aa^Fma, Aa^Fma, Ha^Fpa, Ha^Fpa, Md, Md, Ms, Ms, Ha^Fpa, Aa^Fma, Aa, Gs, Gs, Gs, Gs, Gs, Ce, Ce, Ce, Aa, Aa, Aa^Fma, Aa^Fma, Aa^Fma, Aa^Fma, Aa, Aa^Fma, Gll^Fmw, Aa^Fma, Aa, Aa, Aa^Fma, Gll, Gll^Fmw, Gll, Gll^Es, Gll, Gs, Aa^Fma, Aa^Fma, Hh^Fp, Hh^Fp, Hh^Fp, Gll^Fmw, Aa^Fma, Aa, Aa, Aa, Aa^Fma, Ha^Fpa, Hh^Fp, Md
Ms, Ms, Mm, Md, Ha^Fpa, Aa^Fma, Aa^Fma, Aa, Gll, Aa, Gs^Es, Aa, Gll^Fmw, Hh^Fp, Hh^Fp, Hh^Fp, Ha^Fpa, Md, Hh^Fp, Ha^Fpa, Gll^Fmw, Re^Vct, Aa, Gs, Aa, Gs, Gs, Aa, Gll, Re^Vct, Aa^Fma, Aa^Fma, Ha^Fpa, Aa^Fma, Aa^Fma, Aa, Gll, Gll, Gll, Gll, Aa^Fma, Aa, Gll^Fmw, Gll^Es, Gll, Gll^Fmw, Gs, Gs, Gs, Aa, Gs^Es, Gll^Fmw, Gll^Fmw, Gll^Fmw, Gll^Es, Gll, Gll^Es, Gll, Aa^Fma, Aa^Fma, Ha^Fpa, Md, Md
Ms, Ms, Mm, Md, Ms, Ha^Fpa, Aa^Fma, Gll^Fmw, Gll^Fmw, Gll, Gs, Gs, Gll, Gll^Fmw, Gll^Fmw, Hh^Fp, Aa^Fma, Ha^Fpa, Aa^Fma, Gll^Fmw, Gs, Gs, Gs^Es, Gs, Gs, Re^Vct, Gs, Aa, Aa^Fma, Gll^Fmw, Hh^Fp, Ha^Fpa, Md, Ha^Fpa, Hh^Fp, Gll^Fmw, Gll^Fmw, Gll, Gs, Gs, Gll, Gll^Fmw, Gll, Gll^Fmw, Gll^Es, Gll, Gs, Aa^Fma, Gs, Gs, Gll, Gll^Es, Gll, Gll^Em, Aa, Gs, Gll^Fmw, Aa^Fma, Gll^Fmw, Ha^Fpa, Md, Md, Ms
Ms, Mm, Ms, Mm, Ms, Ha^Fpa, Hh^Fp, Hh^Fp, Hh^Fp, Gll^Fmw, Gll^Fmw, Gs, Gs, Gll, Gs, Gll^Fmw, Aa, Aa^Fma, Aa, Gs, Gs, Gs, Gs, Aa, Gs, Gs, Aa, Aa^Fma, Ha^Fpa, Hh^Fp, Md, Md, Mm, Md, Md, Hh^Fp, Gll^Fmw, Gll, Aa^Fma, Gs, Gll, Gll^Fmw, Gll, Aa^Fma, Aa, Gs, Aa, Aa, Aa^Fma, Gll, Gll^Fmw, Gll^Fmw, Gll^Fmw, Gll^Fmw, Aa^Fma, Gll^Fmw, Hh^Fp, Ha^Fpa, Ha^Fpa, Hh^Fp, Md, Ms, Mm
Ms, Mm, Ms, Mm, Mm, Md, Md, Md, Md, Hh^Fp, Aa^Fma, Gll, Gll, Gs^Es, Gs^Es, Gll, Gll^Es, Gs, Gs, Aa, Aa^Fma, Aa^Fma, Gs, Gs, Gll, Aa, Gll^Fmw, Aa^Fma, Ha^Fpa, Ha^Fpa, Mm, Ms, Ms, Ms, Ms, Ha^Fpa, Ha^Fpa, Gll^Fmw, Aa, Aa^Fma, Gll^Fmw, Gll^Fmw, Aa, Aa^Fma, Gll^Fmw, Aa^Fma, Aa^Fma, Gll, Gll^Fmw, Gll^Fmw, Hh^Fp, Hh^Fp, Ha^Fpa, Hh^Fp, Ha^Fpa, Ha^Fpa, Md, Md, Md, Md, Mm, Mm, Mm
Ms, Ms, Mm, Mm, Ms, Mm, Mm, Ms, Md, Hh^Fp, Ha^Fpa, Aa^Fma, Gll^Fmw, Gll, Gs, Gs, Aa, Gll, Gs, Gs, Gs, Aa, Gs, Gs, Aa, Aa^Fma, Aa^Fma, Hh^Fp, Md, Md, Mm, Mm, Ms, Mm, Mm, Md, Hh^Fp, Aa^Fma, Aa, Gll, Gs, Aa^Fma, Aa^Fma, Aa, Aa, Aa^Fma, Gll, Gll^Fmw, Hh^Fp, Hh^Fp, Md, Md, Ms, Md, Md, Md, Mm, Mm, Ms, Ms, Mm, Ms, Mm
Ms, Mm, Mm, Ms, Mm, Ms, Mm, Mm, Md, Ms, Md, Ha^Fpa, Hh^Fp, Gll^Fmw, Gll^Fmw, Gs, Gs, Gs, Gs, Gll^Fmw, Gs, Gs, Gll^Es, Gll, Aa^Fma, Aa^Fma, Ha^Fpa, Hh^Fp, Ms, Ms, Mm, Ms, Mm, Mm, Ms, Md, Hh^Fp, Aa^Fma, Aa^Fma, Gll, Gs, Aa, Aa^Fma, Gs, Gll, Gs^Es, Gll, Gll^Fmw, Aa^Fma, Ha^Fpa, Md, Ms, Mm, Ms, Ms, Ms, Ms, Ms, Mm, Mm, Mm, Ms, Mm
Mm, Ms, Mm, Mm, Mm, Ms, Mm, Ms, Ms, Md, Md, Ms, Md, Hh^Fp, Gll^Fmw, Gll, Gs, Gs^Es, Aa, Gll, Gs, Gs^Es, Gll, Gll^Fmw, Hh^Fp, Ha^Fpa, Md, Md, Mm, Mm, Mm, Ms, Mm, Mm, Ms, Md, Md, Ha^Fpa, Ha^Fpa, Gll^Fmw, Gll, Gs, Gs, Gll^Fmw, Gs, Gs, Aa, Aa^Fma, Ha^Fpa, Ha^Fpa, Md, Mm, Mm, Ms, Ms, Mm, Mm, Mm, Ms, Ms, Ms, Mm, Mm
Mm, Ms, Mm, Mm, Mm, Mm, Mm, Mm, Ms, Ms, Ms, Ms, Md, Hh^Fp, Gll^Fmw, Gll, Gs, Gs^Es, Gs, Aa^Fma, Gs, Gs, Gs, Gll^Fmw, Hh^Fp, Md, Ms, Ms, Mm, Mm, Mm, Ms, Ms, Mm, Mm, Ms, Ms, Md, Ha^Fpa, Gll^Fmw, Gll, Gs, Gs, Gll^Fmw, Gll^Es, Gs^Es, Gs, Aa^Fma, Hh^Fp, Md, Mm, Ms, Mm, Mm, Ms, Mm, Ms, Mm, Ms, Mm, Ms, Ms, Mm
