border_size=1
usage=map

Md^Xm, Md, Md^Xm, Md, Md, Md, Md, Md, Md, Md, Md, Md, Md^Xm, Md, Md, Md, Md, Md, Md, Md, Md, Md, Md, Md^Xm, Md^Xm, Md, Md^Xm, Md, Md, Md, Md, Md, Md, Md, Md, Md, Md, Hd, Hd, Hd, Dd, Dd, Rd, Rd, Dd, Rd, Dd, Dd, Dd, Rmo, Dd, Dd, Dd, Rd, Dd, Dd, Hd, Dd, Dd, Dd, Dd, Dd, Rd, Dd, Dd, Rmo, Rmo, Dd, Dd, Rd, Dd, Hd, Hd, Dd, Hd, Hd, Hd, Hd, Hd, Hd, Hd, Hd
Md^Xm, Md, Md, Md^Xm, Md, Md, Md, Md^Xm, Md, Md, Md, Md, Md, Md^Xm, Md^Xm, Md^Xm, Md, Md, Md, Md, Md, Md^Xm, Md, Md, Md, Md, Md, Md, Md, Md, Md, Md, Md, Md, Md, Md, Hd, Hd, Hd, Hd, Dd^Esd, Dd, Rd, Dd, Dd, Rd, Dd, Rd, Dd, Rmo, Dd, Dd, Dd, Dd^Esd, Dd, Dd, Hd, Dd, Hd, Dd, Hd, Dd, Dd, Dd, Dd, Rmo, Rmo, Dd, Dd, Dd, Rd, Dd, Dd, Hd, Hd, Hd, Hd, Hd, Hd, Hd, Hd, Hd
Md, Md, Md^Xm, Md, Md, Md, Md, Md, Md, Md, Md, Md, Md^Xm, Md^Xm, Md, Md, Md, Md^Xm, Md, Md, Md^Xm, Md, Md, Md, Md, Md, Md^Xm, Md, Md, Md, Md, Md, Md, Md, Md, Hd, Hd, Hd, Hd, Hd, Dd, Dd, Rd, Rd, Dd, Dd, Dd, Dd, Dd, Rmo, Dd, Rd, Rd, Rd, Dd, Hd, Hd, Hd, Hd, Hd, Hd, Dd, Rd, Dd, Dd, Rmo, Rmo, Dd^Esd, Dd, Dd, Dd^Esd, Dd, Dd, Dd, Dd, Hd, Hd, Hd, Hd, Hd, Hd, Hd
Md^Xm, Md^Xm, Md, Md, Md^Xm, Md, Md^Xm, Md, Md, Md, Md, Md^Xm, Md^Xm, Md, Md, Md, Md, Md, Md, Md^Xm, Md, Md, Md^Xm, Md, Md, Md, Md, Md, Md, Md, Md, Md, Md, Md, Hd, Hd, Hd, Hd, Hd, Hd, Dd, Rd, Dd, Dd, Dd, Rd, Dd, Rd, Dd^Esd, Rmo, Dd, Rd, Dd, Dd, Hd, Hd, Hd, Hd, Hd, Hd, Hd, Dd, Rd, Dd, Dd, Rmo, Rmo, Dd, Dd^Esd, Rd, Dd^Esd, Dd, Dd, Rd, Dd, Dd, Hd, Hd, Hd, Hd, Hd, Hd
Md, Md, Md^Xm, Md^Xm, Md^Xm, Md, Md, Md, Md^Xm, Md^Xm, Md, Md, Md^Xm, Md, Md, Md, Md^Xm, Md, Md^Xm, Md, Md^Xm, Md^Xm, Md, Md, Md, Md^Xm, Md, Md, Md, Md, Md, Md, Hd, Hd, Hd, Hd, Dd, Hd, Dd, Dd, Dd, Dd, Dd, Dd^Esd, Dd, Rd, Rd, Dd, Dd^Esd, Rmo, Rd, Dd, Hd, Hd, Dd, Hd, Hd, Hd, Hd, Hd, Dd, Hd, Rd, Dd, Dd, Rmo, Rmo, Dd, Dd^Esd, Dd^Esd, Rd, Rd, Rd, Dd, Dd, Rd, Dd, Hd, Hd, Hd, Hd, Hd
Md, Md, Md, Md, Md, Md, Md, Md, Md, Md, Md, Md, Md^Xm, Md^Xm, Md, Md, Md, Md, Md, Md, Md, Md, Md^Xm, Md, Md, Md, Md, Md, Md, Md, Md, Md, Hd, Hd, Hd, Dd, Dd, Dd^Esd, Dd, Dd, Dd, Dd, Hd, Dd, Qlf, Rd, Rd, Dd^Esd, Dd, Rmo, Dd, Dd^Esd, Hd, Dd, Dd, Hd, Hd, Hd, Dd^Dr, Dd, Dd, Dd, Rd, Dd, Dd, Rmo, Rmo, Dd, Dd, Dd, Rd, Dd, Rd, Dd, Dd, Rd, Dd, Hd, Hd, Hd, Hd, Hd
Md^Xm, Md, Md, Md, Md^Xm, Md^Xm, Md, Md, Md^Xm, Md, Md, Md^Xm, Md, Md, Md^Xm, Md, Md, Md, Md, Md, Md, Md^Xm, Md, Md, Kd, Md, Kd, Md, Md, Md, Md, Md, Hd, Hd, Hd, Dd, Dd, Rd, Dd, Hd, Hd, Hd, Hd, Qlf, Qlf, Qlf, Dd, Dd^Esd, Dd^Esd, Rmo, Dd, Dd, Dd^Esd, Hd, Hd, Hd, Hd, Dd^Dr, Dd^Dr, Dd^Dr, Rd, Rd, Dd, Dd, Dd, Rmo, Rmo, Rmo, Rmo, Dd, Dd, Dd, Dd, Dd, Dd, Rd, Dd, Dd, Dd, Hd, Hd, Hd
Md^Xm, Md, Md, Md, Md, Md, Md, Md, Md, Md, Md^Xm, Md, Md, Md, Md, Md^Xm, Md, Md^Xm, Md, Md, Md, Md, Md, Md, Cd, Cd, Cd, Md, Md, Md, Md, Md, Hd, Hd, Hd, Dd, Dd, Dd, Hd, Hd, Hd, Hd, Dd, Uu, Qlf, Qlf, Rd, Dd, Dd, Rmo, Dd, Rd, Rd, Dd, Dd^Esd, Dd, Dd, Dd^Dr, Rd^Dr, Dd^Dr, Rd, Rd, Dd^Dc, Rd, Dd, Dd, Dd, Rmo, Rmo, Rmo, Rmo, Dd, Dd^Esd, Rd, Rd, Dd, Dd, Dd, Dd, Hd, Hd, Hd
Md, Md, Md, Md, Md, Md, Md, Md, Md, Md, Md, Md, Md, Md, Md, Md, Md, Md, Md, Md, Md, Md, Md, Kd, Cd, Cd, Cd, Md, Md, Md, Hd, Hd, Hd, Hd, Dd^Esd, Rd, Rd^Dr, Dd^Dr, Dd^Dr, Hd, Dd, Dd, Rd, Rd, Dd, Dd, Dd, Dd, Dd, Rmo, Dd, Dd, Dd, Rd, Dd, Rd, Dd, Dd, Dd, Dd, Dd^Vda, Dd^Dc, Dd^Dc, Dd^Dc, Rd, Dd, Dd, Dd, Dd, Rmo, Rmo, Dd, Dd, Dd, Dd^Esd, Rd, Rd, Dd, Dd, Hd, Hd, Hd
Md^Xm, Md, Md, Md, Md, Md^Xm, Md, Md, Md^Xm, Md, Md, Md, Md, Md, Md, Md, Md, Md, Md, Md, Md, Md, Md, Md, Md, Cd, Md, Kd, Kd, Md, Dd, Hd, Dd, Dd, Rd, Dd, Rd^Dr, Dd^Dr, Rd^Dr, Dd, Rd, Dd, Dd, Rd, Dd, Rd, Cd^Ii, Dd, Dd, Rmo, Dd, Dd, Cd^Ii, Dd, Dd, Dd, Dd, Dd, Rd, Dd, Dd, Dd^Dc, Dd^Dc, Dd^Dc, Dd, Dd, Dd^Esd, Dd, Dd, Rmo, Rmo, Dd, Dd, Rd, Dd, Dd, Dd^Esd, Rd, Rd, Dd, Rd, Dd
Md^Xm, Md, Md^Xm, Md, Md, Md^Xm, Md, Md, Md, Md, Md, Md, Md, Md, Md, Md, Md, Md, Md, Md, Md, Md, Md, Md, Md, Kd, Kd, Md, Md, Kd, Dd, Dd, Dd, Rd, Rd, Dd, Dd, Rd^Dr, Dd, Dd, Dd, Dd, Cd^Ii, Cd^Ii, Cd^Ii, Cd^Ii, Gs, Kd^Ii, Rmo^Ii, Rmo^Ii, Rmo^Ii, Kd^Ii, Gs, Cd^Ii, Cd^Ii, Cd^Ii, Cd^Ii, Dd, Dd, Rd, Dd, Rd, Dd, Rd, Dd, Dd, Dd, Dd, Dd, Rmo, Rmo, Dd, Dd, Dd^Esd, Dd, Dd, Rd, Dd, Dd, Dd, Rd, Dd
Md, Md, Md, Md, Md, Md, Md, Md, Md, Md, Md, Md, Md, Md, Md, Md, Md, Md, Md, Md, Md, Md, Md, Md, Md, Md, Md, Kd, Rmo, Rmo, Rmo, Dd, Dd, Dd, Dd, Dd, Rd, Dd, Dd, Dd, Dd, Cd^Ii, Gs, Gs, Gs, Gs, Gs, Gs, Rmo^Ii, Rmo^Rs, Rmo^Ii, Gs, Gs, Gs, Gs, Gs, Gs, Cd^Ii, Dd, Dd, Dd, Dd, Dd, Dd, Dd, Dd, Dd, Dd, Rmo, Rmo, Rmo, Dd, Dd, Rd, Rd, Dd, Rd, Dd, Rd, Dd, Dd, Dd
Md, Md, Md, Md, Md, Md, Md, Md, Md, Md, Md, Md, Md, Md, Hd, Md, Md, Md, Md, Md, Md, Md, Hd, Hd, Hd, Hd, Hd, Hd, Rmo, Dd, Dd, Rmo, Kd^Ii, Dd, Dd, Dd, Dd, Rd, Dd, Dd, Cd^Ii, Cd^Ii, Gs, Gs, Gs, Rmo^Vdm, Rmo, Rmo, Rmo, Rmo^Ii, Rmo, Rmo, Rmo, Rmo^Vdm, Gs, Gs, Gs, Cd^Ii, Cd^Ii, Dd, Cd^Ii, Dd, Cd^Ii, Dd, Cd^Ii, Cd^Ii, Rmo, Rmo, Rmo, Rmo, Dd, Dd, Dd, Dd, Dd, Dd, Dd, Dd^Esd, Dd, Dd, Hd, Hd
Md, Md, Md, Md, Md, Md, Md, Md, Md, Md, Md, Md, Hd, Hd, Hd, Hd, Hd, Hd, Hd, Hd, Hd, Hd, Hd, Hd, Hd, Hd, Hd, Hd, Dd, Rmo, Rmo, Rmo, Rmo, Cd^Ii, Cd^Ii, Cd^Ii, Cd^Ii, Cd^Ii, Cd^Ii, Cd^Ii, Gs, Gs, Cd, Cd, Cd, Rmo, Rmo, Rmo, Rmo, Gll^Ftr, Rmo, Rmo, Rmo, Rmo, Cd, Cd, Cd, Gs, Gs, Cd^Ii, Gs, Cd^Ii, Gs, Cd^Ii, Rmo, Rmo, Rmo, Rmo, Cd^Ii, Dd, Dd, Dd, Dd^Vda, Dd, Dd, Rd, Rd, Dd, Dd, Dd, Hd, Hd
Md, Md, Md, Md, Md, Md, Hd, Hd, Hd, Hd, Hd, Hd, Hd, Hd, Hd, Hd, Hd, Hd, Hd, Hd, Hd, Hd, Hd, Hd, Dd, Hd, Dd, Dd, Dd, Kd^Ii, Cd^Ii, Rmo, Rmo, Rmo, Rmo^Ii, Gs, Gs, Gs, Gs, Gs, Rmo, Rmo, Cd, Kd, Cd, Rmo, Gs, Gs, Rmo, Gll^Ftr, Rmo, Gs, Gs, Rmo, Cd, Kd, Cd, Rmo, Rmo, Gs, Gs, Gs, Rmo^Ii, Rmo^Ii, Rmo^Ii, Rmo, Cd^Ii, Cd^Ii, Dd, Dd, Rd, Dd, Dd, Dd, Dd, Dd, Rd, Dd, Dd, Hd, Hd, Hd
Md, Md, Md, Md, Hd, Hd, Hd, Hd, Hd, Hd, Hd, Hd, Hd, Hd, Hd, Hd, Dd, Hd, Hd, Hd, Hd, Hd, Dd, Dd^Esd, Dd, Dd, Dd, Dd, Dd, Dd, Dd, Cd^Ii, Gs, Rmo^Ii, Rmo^Js, Rmo^Ii, Rmo, Gs, Cd, Rmo, Gll^Ftr, Gll^Ftr, Rmo, Cd, Gs, Gs, Gs, Gs, Cd, Rmo, Cd, Gs, Gs, Gs, Gs, Cd, Rmo, Gll^Ftr, Gll^Ftr, Rmo, Cd, Rmo, Rmo^Ii, Rmo^Ts, Rmo^Ii, Gs, Cd^Ii, Dd, Dd, Rd, Dd, Rd, Rd^Dr, Dd^Dr, Rd^Dr, Dd, Dd, Dd, Dd, Hd, Hd, Hd
Hd, Md, Hd, Hd, Hd, Hd, Hd, Hd, Hd, Hd, Hd, Hd, Dd, Dd, Dd, Dd, Dd^Esd, Dd, Dd, Dd^Esd, Dd, Dd, Dd, Dd, Dd, Dd, Rd, Rd, Dd, Dd, Cd^Ii, Cd^Ii, Gs, Rmo^Ii, Rmo^Ii, Rmo^Ii, Rmo, Cd, Kd, Cd, Rmo, Rmo, Gs, Gs, Gs, Gs, Gll^Ftr, Cd, Qxe, Rmo, Qxe, Cd, Gll^Ftr, Gll^Ftr, Gs, Gs, Gs, Rmo, Rmo, Cd, Kd, Cd, Rmo, Rmo^Ii, Rmo^Vdm, Gs, Gs, Cd^Ii, Dd, Dd^Esd, Rd, Dd, Rd^Dr, Rd^Dr, Dd^Dr, Rd, Dd, Dd, Dd, Hd, Hd, Hd
Hd, Hd, Hd, Hd, Hd, Hd, Hd, Hd, Hd, Hd, Dd, Dd, Dd^Esd, Dd, Dd^Esd, Dd^Esd, Dd, Dd, Dd, Rd, Dd, Dd, Rd, Rd, Dd, Dd, Rd, Dd, Dd, Dd, Cd^Ii, Gs, Gs, Gs, Rmo, Rmo, Gll^Ftr, Cd, Cd, Cd, Gs, Gs, Gll^Ftr, Gll^Ftr, Gll^Ftr, Gll^Ftr, Qxe, Qxe, Qxe, Qxu^Bsb|, Qxe, Qxe, Qxe, Gll^Ftr, Gll^Ftr, Gs, Rmo^Vdm, Gs, Gs, Cd, Cd, Cd, Gll^Ftr, Rmo, Gs, Gs, Gs, Cd^Ii, Dd, Dd, Rd, Dd, Dd, Dd^Dr, Dd, Dd, Dd, Rd, Dd, Hd, Hd, Hd
Hd, Hd, Hd, Hd, Hd, Hd, Hd, Hd, Dd, Dd, Dd, Dd, Dd^Esd, Dd, Rd, Dd, Dd, Dd, Rd, Dd, Dd, Dd, Qlf, Qlf, Qlf, Dd, Dd, Dd, Dd, Dd, Cd^Ii, Gs, Cd, Cd, Cd, Gll^Ftr, Rmo, Rmo, Gs, Gs, Gs, Gs, Gll^Ftr, Gll^Ftr, Qxe, Qxe, Qxe, Qxe, Qxe, Qxu^Bsb|, Qxe, Qxe, Qxe, Qxe, Qxe, Gll^Ftr, Gll^Ftr, Gs, Gs, Gs, Gs, Rmo, Gll^Ftr, Rmo, Cd, Gs, Gs, Cd^Ii, Cd^Ii, Dd, Rd, Dd, Dd, Dd, Hd, Dd, Dd, Rd, Dd, Dd, Hd, Hd
Dd, Hd, Dd, Hd, Dd, Hd, Dd, Dd, Dd, Dd, Rd, Rd, Dd^Esd, Rd, Dd, Dd, Dd, Rd, Rd, Dd, Dd, Dd, Qlf, Qlf, Qlf, Dd, Dd, Dd, Dd, Cd^Ii, Gs, Gs, Cd, Kd, Cd, Rmo, Gs, Gs, Gs, Gs, Gs, Gs, Qxe, Qxe, Qxe, Qxe, Qxe, Qxe, Cd, Cd, Cd, Qxe, Qxe, Qxe, Qxe, Qxe, Gll^Ftr, Gs, Gs, Gs, Gs, Rmo, Rmo, Cd, Kd, Cd, Gs, Gs, Cd^Ii, Dd, Dd, Dd, Dd, Hd, Hd, Dd, Dd, Rd, Dd, Dd, Dd, Hd
Dd^Esd, Dd, Dd, Dd, Rd, Rd, Dd, Dd, Dd, Rd, Dd^Esd, Dd, Dd, Dd, Dd, Dd, Dd, Dd, Rd, Dd, Dd, Dd, Dd, Uu, Dd, Dd, Dd, Dd, Dd, Cd^Ii, Gs, Gs, Rmo, Cd, Rmo, Gs, Rmo^Vdm, Gs, Gs, Gs, Cd, Cd, Qxe, Qxe, Qxe, Qxe, Qxe, Qxe, Cd, Kd, Cd, Qxe, Qxe, Qxe, Qxe, Qxe, Qxe, Cd, Cd, Gs, Gs, Gs, Gs, Cd, Cd, Cd, Gs, Gs, Cd^Ii, Dd, Dd^Esd, Rd, Rd, Dd, Dd, Hd, Dd, Dd, Dd, Rd, Dd, Dd
Dd, Dd, Rd, Dd^Esd, Dd, Dd, Hd, Dd, Hd, Dd^Esd, Dd, Dd, Dd, Rd, Rd, Dd, Dd, Rd, Dd, Dd, Rd, Rd, Dd, Rd, Dd, Dd, Dd, Dd, Dd, Cd^Ii, Gs, Rmo^Vdm, Rmo, Gll^Ftr, Rmo, Gs, Gs, Gs, Cd, Gs, Qxu^Bsb\, Qxe, Qxe, Qxe, Qxe, Qxe, Qxu^Bsb/, Qxu^Bsb/, Qxe, Cd, Qxe, Qxu^Bsb\, Qxu^Bsb\, Qxe, Qxe, Qxe, Qxe, Qxe, Gs, Gs, Cd, Gs, Gs, Rmo, Gll^Ftr, Rmo, Gs, Gs, Cd^Ii, Dd, Dd, Dd, Rd, Dd, Dd, Dd^Esd, Rd, Dd, Rd, Dd^Esd, Dd^Esd, Rd
Rd, Rd, Rd, Dd^Esd, Dd, Dd, Hd, Hd, Hd, Hd, Hd, Dd, Dd^Vdt, Dd, Rd, Dd, Dd, Dd, Dd, Rd, Dd, Dd, Rd, Rd, Dd, Dd, Dd, Dd, Cd^Ii, Cd^Ii, Gs, Gs, Rmo, Gll^Ftr, Rmo, Gs, Gs, Gs, Cd, Qxe, Qxe, Qxu^Bsb\, Cd, Cd, Cd, Qxu^Bsb/, Qxe, Qxe, Qxe, Qxu^Bsb|, Qxe, Qxe, Qxe, Qxu^Bsb\, Cd, Cd, Cd, Qxu^Bsb/, Qxe, Qxe, Cd, Gs, Gs, Rmo, Gll^Ftr, Rmo, Gs, Gs, Gs, Cd^Ii, Dd, Dd, Dd, Dd^Vda, Dd, Dd, Dd^Esd, Dd, Rd, Dd, Dd^Esd, Rd
Dd, Dd, Dd, Dd, Dd, Hd, Hd, Hd, Ce, Hd, Dd, Dd, Dd^Esd, Rd, Dd, Dd, Dd, Dd, Dd, Dd, Dd, Dd, Dd, Dd, Dd, Rd, Rd, Dd, Cd^Ii, Gs, Gs, Gs, Cd, Cd, Cd, Gs, Gll^Ftr, Gll^Ftr, Gll^Ftr, Qxe, Qxe, Qxe, Cd, Kd, Cd, Qxe, Qxe, Qxe, Kd, Rmp, Kd, Qxe, Qxe, Qxe, Cd, 3 Kd, Cd, Qxe, Qxe, Qxe, Gll^Ftr, Gs, Gs, Rmo, Cd, Rmo, Gs, Gs, Gs, Cd^Ii, Dd, Dd, Dd, Dd, Qlf, Rd, Dd, Dd, Dd, Dd, Rd, Dd
Dd, Dd, Dd, Rd, Dd^Vdt, Dd, Ce, Dd, Ce, Dd, Ce, Dd, Dd, Dd^Esd, Dd, Dd, Dd, Dd, Hd, Dd, Dd, Hd, Hd^Dr, Dd, Dd, Dd, Rd, Dd, Cd^Ii, Gll^Ftr, Gll^Ftr, Gs, Cd, Kd, Cd, Gs, Gs, Gll^Ftr, Qxe, Qxe, Qxe, Qxe, Qxe, Cd, Qxe, Qxu^Bsb\, Rmp, Kd, Cd, Rmp, Cd, Kd, Rmp, Qxu^Bsb/, Qxe, Cd, Qxe, Qxe, Qxe, Qxe, Gll^Ftr, Rmo^Vdm, Gs, Cd, Kd, Cd, Gs, Rmo^Vdm, Gs, Cd^Ii, Dd, Rd, Dd, Qlf, Qlf, Qlf, Rd, Rd, Dd, Dd, Dd, Dd
Rd, Rd, Rd, Dd, Rd, Dd, Dd, Ce, 1 Ke, Ce, Rd, Dd, Hd, Dd^Vdt, Dd, Dd, Rd, Dd, Hd, Hd, Hd, Hd^Dr, Hd^Dr, Hd^Dr, Dd, Dd, Dd^Esd, Dd, Cd^Ii, Gll^Ftr, Gs, Gs, Rmo, Cd, Rmo, Gs, Gs, Gll^Ftr, Qxe, Qxe, Qxe, Qxe, Qxe, Qxu^Bsb|, Qxe, Qxe, Kd, Rmp, Cd, Cd, Cd, Rmp, Kd, Qxe, Qxe, Qxu^Bsb|, Qxe, Qxe, Qxe, Qxe, Gll^Ftr, Gll^Ftr, Gs, Cd, Cd, Cd, Gs, Gs, Gs, Cd^Ii, Dd, Dd, Dd, Qlf, Uu, Qlf, Dd, Dd, Dd, Dd, Dd, Dd
Dd, Dd, Dd, Dd, Dd, Dd, Ce, Ce, Ce, Ce, Ce, Dd, Hd, Hd, Dd, Rd, Rd, Dd, Dd, Hd, Hd, Hd^Dr, Hd^Dr, Hd^Dr, Dd, Dd, Rd, Dd, Cd^Ii, Gs, Rmo^Vdm, Gs, Rmo, Gll^Ftr, Rmo, Gs, Gll^Ftr, Gll^Ftr, Qxe, Qxe, Qxe, Qxe, Qxe, Qxu^Bsb|, Qxe, Qxe, Kd, Cd, Cd, 2 Kd, Cd, Cd, Kd, Qxe, Qxe, Qxu^Bsb|, Qxe, Qxe, Qxe, Qxe, Gll^Ftr, Gll^Ftr, Gs, Rmo, Gll^Ftr, Rmo, Gs, Gs, Gs, Cd^Ii, Dd, Dd, Dd, Dd^Esd, Dd, Rd, Dd, Dd, Hd, Dd, Hd, Hd
Dd, Dd, Dd^Esd, Dd^Vdt, Dd, Dd, Dd, Dd, Ce, Dd, Dd, Dd, Dd, Hd, Dd, Dd, Rd, Dd, Dd, Hd, Hd, Hd, Dd, Dd, Dd, Rd, Dd, Dd, Cd^Ii, Gs, Gs, Gs, Rmo, Gll^Ftr, Rmo, Gs, Gs, Gll^Ftr, Gll^Ftr, Qxe, Qxe, Qxe, Qxe, Qxu^Bsb|, Qxe, Qxe, Rmp, Rmp, Cd, Cd, Cd, Rmp, Rmp, Qxe, Qxe, Qxu^Bsb|, Qxe, Qxe, Qxe, Qxe, Gll^Ftr, Gll^Ftr, Gs, Rmo, Gll^Ftr, Rmo, Gs, Rmo^Vdm, Gs, Cd^Ii, Dd, Dd, Rd, Rd, Rd, Dd, Hd, Hd, Hd, Hd, Md, Hd
Dd^Esd, Dd, Dd, Dd, Rmo, Rmo, Rmo, Dd, Dd, Dd, Dd, Dd, Dd, Dd, Dd^Esd, Rd, Dd, Dd, Rd, Dd, Hd, Hd, Dd, Dd, Rd, Dd, Dd^Esd, Dd, Cd^Ii, Gll^Ftr, Gll^Ftr, Gs, Cd, Cd, Cd, Gs, Gs, Gll^Ftr, Gll^Ftr, Gll^Ftr, Qxe, Qxe, Cd, Cd, Cd, Qxu^Bsb/, Qxe, Kd, Kd, Rmp, Kd, Kd, Qxe, Qxu^Bsb\, Cd, Cd, Cd, Qxe, Qxe, Qxe, Gll^Ftr, Gll^Ftr, Gs, Rmo, Cd, Rmo, Gs, Gs, Gs, Cd^Ii, Dd, Rd, Rd, Dd, Rd, Dd, Hd, Hd, Md, Md, Md^Xm, Md
Dd, Dd, Rmo, Rmo, Rmo, Rmo, Rmo, Rmo, Rmo, Dd, Dd^Vdt, Dd^Esd, Dd, Dd, Dd, Dd, Dd, Rd, Rd, Hd, Dd, Dd, Dd^Esd, Rd, Rd, Dd, Dd, Dd, Cd^Ii, Gll^Ftr, Gll^Ftr, Gs, Cd, Kd, Cd, Rmo, Rmo, Gs, Cd, Qxe, Qxe, Qxe, Cd, Kd, Cd, Qxe, Qxe, Qxe, Qxe, Rmp, Qxe, Qxe, Qxe, Qxe, Cd, Kd, Cd, Qxe, Qxe, Qxe, Cd, Gs, Gs, Cd, Kd, Cd, Gs, Gs, Cd^Ii, Cd^Ii, Dd, Rd, Rd, Dd, Dd, Hd, Hd, Hd, Md, Md, Md, Md^Xm
Rmo, Rmo, Rmo, Rmo, Dd, Dd, Dd, Rmo, Rmo, Rmo, Rmo, Dd, Dd, Dd^Esd, Dd, Rd, Dd, Rd, Dd, Dd, Dd^Esd, Dd, Dd, Rd, Dd, Dd, Dd^Esd, Dd, Dd, Cd^Ii, Gs, Gs, Gs, Cd, Rmo, Gs, Rmo, Gs, Cd, Qxe, Qxu^Bsb/, Qxu^Bsb/, Qxe, Cd, Qxe, Qxu^Bsb\, Qxu^Bsb\, Qxe, Qxe, Qxu^Bsb|, Qxe, Qxe, Qxu^Bsb/, Qxu^Bsb/, Qxe, Cd, Qxe, Qxu^Bsb\, Qxu^Bsb\, Cd, Gs, Gs, Rmo, Cd, Cd, Cd, Gs, Gs, Cd^Ii, Dd, Dd, Dd^Esd, Dd, Dd, Dd, Hd, Hd, Md, Md, Md^Xm, Md, Md
Rmo, Rmo, Dd, Dd, Dd, Rd, Dd, Dd, Dd, Rmo, Rmo, Rmo, Rmo, Dd, Dd, Dd, Dd, Dd, Dd, Rd, Dd, Dd, Rd, Dd, Dd, Dd, Rd, Dd, Dd, Cd^Ii, Cd^Ii, Gs, Gs, Gs, Gs^Ii, Rmo^Ii, Gll^Ftr, Rmo, Gs, Gs, Qxe, Qxe, Qxe, Qxe, Qxe, Qxe, Qxe, Qxu^Bsb\, Cd, Cd, Cd, Qxu^Bsb/, Qxe, Qxe, Qxe, Qxe, Qxe, Qxe, Cd, Rmo, Rmo, Gs, Rmo^Ii, Gs^Ii, Rmo^Ii, Gs, Cd^Ii, Cd^Ii, Dd, Rd, Dd, Rd, Dd, Dd^Vda, Dd, Hd, Hd, Md, Md, Md, Md^Xm, Md
Dd, Dd, Dd^Esd, Dd, Dd, Dd, Dd, Dd, Rd, Dd, Dd, Rmo, Rmo, Rmo, Rmo, Dd, Dd, Dd, Rd, Rd, Dd, Dd, Dd, Dd, Dd^Dc, Dd^Dc, Dd^Dc, Rd, Dd, Dd, Dd, Cd^Ii, Gs, Rmo^Vdm, Rmo^Ii, Rmo^Ma, Rmo^Ii, Rmo, Rmo, Cd, Cd, Qxe, Qxe, Qxe, Qxe, Qxe, Qxe, Qxe, Cd, Kd, Cd, Qxe, Qxe, Qxe, Qxe, Qxe, Qxe, Qxe, Cd, Gs, Rmo^Vdm, Rmo, Rmo^Ii, Rmo^Aks, Rmo^Ii, Gs, Cd^Ii, Dd, Dd, Rd, Dd^Dc, Rd, Dd, Dd, Hd, Hd, Hd, Hd, Md, Md, Md^Xm, Md
Rd, Rd, Dd^Esd, Dd, Hd, Hd, Hd, Dd, Rd, Rd, Rd, Dd, Dd, Rmo, Rmo, Rmo, Rmo, Dd, Dd, Dd, Dd, Dd, Dd, Rd, Dd^Dc, Dd^Dc, Dd^Dc, Rd, Dd, Dd^Esd, Kd^Ii, Cd^Ii, Rmo, Rmo, Rmo, Rmo^Ii, Rmo, Gll^Ftr, Rmo, Gs, Gs, Qxe, Gll^Ftr, Qxe, Qxe, Qxe, Qxe, Qxe, Qxe, Cd, Qxe, Qxe, Qxe, Qxe, Qxe, Qxe, Gll^Ftr, Gll^Ftr, Gs, Gs, Rmo, Rmo, Gs, Rmo^Ii, Rmo, Rmo, Rmo, Kd^Ii, Dd, Dd^Dc, Dd^Dc, Dd^Dc, Hd, Hd, Hd, Hd, Hd, Hd, Md, Md, Md^Xm, Md
Dd, Dd, Dd, Hd, Dd, Hd, Dd, Dd, Dd, Rd, Dd, Rd, Dd^Esd, Dd, Dd, Rmo, Rmo, Rmo, Rmo, Dd, Dd, Dd, Dd, Dd, Dd, Dd^Dc, Dd, Dd, Dd, Dd, Rmo, Rmo, Rmo, Rmo, Cd^Ii, Gs, Gs, Rmo, Cd, Cd, Cd, Gs, Gll^Ftr, Gll^Ftr, Gll^Ftr, Qxe, Qxe, Qxe, Qxe, Qxu^Bsb|, Qxe, Qxe, Qxe, Qxe, Qxe, Gll^Ftr, Gll^Ftr, Gs, Cd, Cd, Cd, Rmo, Gs, Gs, Cd^Ii, Rmo, Dd, Dd, Dd, Dd^Dc, Dd^Dc, Dd^Dc, Hd, Hd, Hd, Md, Md, Md, Md^Xm, Md, Md, Md
Dd, Rd, Rd, Dd, Dd^Esd, Dd, Dd, Dd, Hd, Dd, Dd, Dd, Dd, Rd, Dd^Esd, Dd, Dd, Rmo, Rmo, Rmo, Rmo, Dd, Rmo, Rmo, Rmo, Dd, Dd^Vda, Dd, Rmo, Rmo, Rmo, Rmo, Dd, Kd^Ii, Dd, Cd^Ii, Cd^Ii, Gs, Cd, Kd, Cd, Gs, Gs, Gll^Ftr, Gll^Ftr, Qxe, Qxe, Qxe, Qxe, Qxu^Bsb|, Qxe, Qxe, Qxe, Qxe, Qxe, Qxe, Rmo, Rmo, Cd, Kd, Cd, Gs, Cd^Ii, Cd^Ii, Dd, Kd^Ii, Dd, Dd, Hd, Dd, Hd, Hd, Hd, Md, Md, Md, Md^Xm, Md^Xm, Md, Md, Md, Hd
Dd, Dd, Dd, Dd, Dd, Rd, Rd, Dd, Hd, Hd, Hd, Dd, Dd, Dd, Dd, Dd^Esd, Dd, Dd, Dd, Rmo, Rmo, Rmo, Rmo, Rmo, Rmo, Rmo, Rmo, Rmo, Rmo, Rmo, Dd, Dd, Dd^Esd, Dd, Dd, Dd, Cd^Ii, Gs, Gs, Cd, Gll^Ftr, Rmo, Rmo, Rmo^Vdm, Gs, Qxe, Qxe, Qxe, Cd, Qxu^Bsb|, Cd, Gs^Ftp, Qxe, Qxe, Qxe, Gll^Ftr, Rmo, Gll^Ftr, Rmo, Cd, Gs, Gs, Cd^Ii, Dd, Dd, Dd^Esd, Hd, Hd, Hd, Hd, Hd, Hd, Md, Md, Md^Xm, Md^Xm, Md^Xm, Md, Md, Hd, Hd, Hd
Hd, Dd, Dd, Rd, Rd, Dd^Esd, Rd, Dd, Hd, Hd, Hd, Hd, Hd, Rd, Rd, Dd, Dd, Rd, Dd, Dd, Dd, Rmo, Dd, Dd, Dd, Rmo, Rmo, Rmo, Dd, Dd, Dd, Dd, Rd, Dd^Esd, Dd, Dd, Dd, Cd^Ii, Gs, Rmo, Rmo, Gll^Ftr, Gll^Ftr, Rmo, Rmo, Qxe, Qxe, Cd, Rmo, Rmo, Rmo, Cd, Gs, Qxe, Gs, Rmo, Gll^Ftr, Gll^Ftr, Rmo, Gs, Gs, Cd^Ii, Dd, Dd, Dd^Esd, Dd^Esd, Hd, Hd, Md, Md, Md, Md, Md, Md, Md, Md, Md, Md, Hd, Hd, Hd, Hd
Hd, Dd, Dd, Rd, Dd, Dd, Dd, Hd, Hd, Hd, Hd, Hd, Hd, Hd, Dd, Dd, Rd, Dd, Rd, Dd, Dd, Dd, Dd, Dd, Rd, Dd, Dd, Dd, Dd, Rd, Rd, Dd, Dd, Dd, Dd, Dd, Dd, Cd^Ii, Cd^Ii, Gs, Gs, Rmo, Rmo, Gll^Ftr, Cd, Gs, Gs, Gs, Rmo, Gll^Ftr, Rmo, Gs, Rmo^Vdm, Gs, Cd, Rmo, Gll^Ftr, Rmo, Gs, Gs, Cd^Ii, Cd^Ii, Dd, Dd, Dd, Hd, Hd, Hd, Md, Md, Md, Md, Md^Xm, Md, Md, Md, Md, Hd, Hd, Hd, Dd, Dd
Hd, Hd, Hd, Hd, Dd, Rd, Dd, Dd, Hd, Hd, Hd, Hd, Hd, Hd, Dd, Dd, Dd, Rd, Dd, Rd, Dd, Rd, Rd, Rd, Dd, Rd, Rd, Rd, Dd, Dd, Dd, Dd, Dd^Dr, Dd^Dr, Rd^Dr, Dd, Dd, Dd, Dd, Cd^Ii, Cd^Ii, Gs, Gs, Cd, Kd, Cd, Rmo, Gs, Rmo, Gll^Ftr, Rmo, Gs, Rmo, Cd, Kd, Cd, Rmo, Rmo, Cd^Ii, Cd^Ii, Dd, Dd, Dd^Esd, Dd^Esd, Hd, Hd, Md, Md, Md^Xm, Md, Md^Xm, Md^Xm, Md, Md, Md, Md, Hd, Hd, Hd, Hd, Dd, Dd
Hd, Hd, Hd, Rd, Dd^Esd, Dd, Dd, Rd, Dd, Hd, Dd, Dd, Dd, Hd, Dd, Rd, Rd, Dd, Dd, Rd, Dd, Dd, Rd, Rd, Rd, Dd, Dd, Rd, Rd, Dd, Rd, Dd, Rd^Dr, Dd^Dr, Dd^Dr, Dd, Dd, Dd, Dd, Dd, Cd^Ii, Gs, Gs, Cd, Cd, Cd, Gll^Ftr, Rmo, Rmo, Gll^Ftr, Rmo, Rmo, Gll^Ftr, Cd, Cd, Cd, Gs, Gs, Cd^Ii, Dd, Dd, Dd, Dd, Dd, Hd, Hd, Md, Md, Md^Xm, Md^Xm, Md, Md, Md, Md, Md, Md, Hd, Hd, Hd, Dd, Dd^Esd, Rd
Hd, Hd, Hd, Dd, Dd^Esd, Rd, Rd, Rd, Dd^Esd, Dd, Dd, Dd, Dd, Dd, Dd, Rd, Dd, Rd, Dd^Esd, Dd, Dd, Dd, Dd, Dd, Rd, Dd^Esd, Dd, Dd, Dd^Esd, Rd, Rd, Dd, Dd^Vda, Dd^Dr, Dd, Rd, Rd, Rd, Dd, Dd, Dd, Cd^Ii, Cd^Ii, Gs, Gs, Rmo, Rmo, Gll^Ftr, Rmo, Gll^Ftr, Rmo, Gll^Ftr, Rmo, Rmo, Gs, Gs, Cd^Ii, Cd^Ii, Dd, Dd, Dd, Dd, Hd, Hd, Hd, Hd, Md, Md^Xm, Md^Xm, Md, Md, Md, Md, Md, Hd, Md, Hd, Hd, Hd, Dd, Dd, Dd
Hd, Hd, Hd, Rd, Rd, Dd^Esd, Rd, Dd, Dd, Dd, Dd, Dd, Dd^Esd, Dd^Esd, Hd, Dd, Hd, Dd, Dd, Dd, Dd, Dd, Dd^Esd, Dd^Esd, Dd, Dd, Dd, Rd, Dd, Dd, Rd, Dd, Dd, Dd, Rd, Dd, Dd, Rd, Dd, Dd, Dd, Dd, Dd, Cd^Ii, Gs, Gs, Gs, Rmo, Rmo^Ii, Rmo^Ii, Rmo^Ii, Rmo, Gs, Gs, Gs, Cd^Ii, Dd, Dd, Dd, Dd^Esd, Dd, Hd, Hd, Hd, Md, Md, Md^Xm, Md^Xm, Md, Md, Md, Md, Hd, Hd, Hd, Hd, Hd, Hd, Dd, Dd, Dd, Dd
Hd, Hd, Dd, Dd, Dd, Rd, Dd^Esd, Dd, Dd, Dd, Hd, Hd, Hd, Hd, Hd, Hd, Hd, Hd, Hd, Hd, Hd, Hd, Hd, Hd, Hd, Hd, Hd, Dd, Dd, Dd, Rd, Dd, Rd, Dd, Dd, Dd, Rd, Rd, Dd, Dd, Dd, Dd^Esd, Dd, Cd^Ii, Cd^Ii, Cd^Ii, Cd^Ii, Gs, Rmo^Ii, Rmo^Ms, Rmo^Ii, Gs, Cd^Ii, Cd^Ii, Cd^Ii, Cd^Ii, Dd, Dd, Dd, Dd, Hd, Hd, Hd, Md, Md, Md, Md^Xm, Md^Xm, Md, Md, Md, Hd, Hd, Hd, Hd, Hd, Dd, Dd, Dd, Dd, Dd, Rd
Hd, Dd^Esd, Dd, Dd, Rd, Dd^Esd, Dd, Dd^Esd, Hd, Hd, Hd, Hd, Hd, Hd, Hd, Hd, Hd, Hd, Hd, Hd, Hd, Hd, Hd, Hd, Md, Hd, Hd, Hd, Hd, Dd, Rd, Rd, Rd, Rd, Dd, Dd, Dd, Dd, Uu, Qlf, Qlf, Dd^Esd, Dd, Dd, Dd, Dd, Dd, Cd^Ii, Rmo, Rmo^Ii, Rmo, Cd^Ii, Dd, Dd, Dd, Dd, Dd, Dd^Vda, Dd^Esd, Dd, Hd, Hd, Hd, Md, Md, Md^Xm, Md^Xm, Md, Md, Md, Md, Hd, Hd, Hd, Dd^Esd, Dd^Esd, Dd, Dd, Dd, Dd, Dd, Rd
Hd, Dd^Esd, Rd, Dd, Dd, Dd, Dd, Hd, Hd, Hd, Md, Hd, Md, Hd, Md, Md, Md, Hd, Md, Hd, Md, Md, Md, Md, Md, Md, Md, Hd, Dd, Dd, Dd, Rd, Dd^Esd, Rd, Dd, Dd, Dd, Dd, Qlf, Qlf, Qlf, Dd, Dd, Rd, Dd^Esd, Dd, Dd, Kd^Ii, Dd, Rmo, Dd, Kd^Ii, Dd, Dd, Dd, Dd, Dd^Esd, Dd, Dd, Dd, Hd, Hd, Hd, Md, Md, Md^Xm, Md, Md, Md, Md, Md, Hd, Hd, Hd, Dd, Dd, Dd, Rd, Rd, Dd, Dd, Dd
Dd, Rd, Dd, Rd, Dd, Dd, Hd, Hd, Hd, Hd, Md, Md, Md, Md, Md, Md, Md, Md, Md, Md, Md, Md, Md, Md, Md, Md, Md, Hd, Dd, Dd, Rd, Dd, Rd, Dd, Rd, Dd^Esd, Dd, Rd, Dd, Qlf, Dd, Dd, Rd, Dd, Rd, Dd, Dd, Dd, Dd, Rmo, Dd, Dd, Dd, Dd, Dd^Dr, Dd, Dd, Dd, Dd, Dd, Hd, Hd, Hd, Md, Md, Md, Md, Md, Md, Md, Hd, Hd, Hd, Hd, Dd, Dd, Rd, Dd, Rd, Dd, Dd, Dd
Dd, Dd, Dd, Dd, Dd, Hd, Hd, Hd, Hd, Md, Md, Md, Md, Md, Md, Md, Md, Md, Md, Md, Md, Md, Md, Md, Md, Md, Md, Hd, Rd, Rd, Dd, Dd, Dd, Dd, Dd, Dd, Dd^Esd, Rd, Dd, Dd, Dd, Rd, Dd, Dd, Rd, Rd, Rd, Dd, Dd, Rmo, Dd, Dd, Dd, Dd^Dr, Dd^Dr, Dd^Dr, Hd, Dd, Dd, Dd, Dd, Hd, Hd, Hd, Hd, Md, Md, Md, Md, Md, Md, Hd, Hd, Hd, Dd, Dd, Dd, Rd, Rd, Dd, Dd, Dd
Dd, Dd, Dd, Dd, Dd, Hd, Hd, Hd, Md, Md, Md, Md, Md, Md, Md, Md, Md, Md, Md, Md, Md, Md, Md, Md, Md, Md, Md, Hd, Rd, Dd, Hd, Hd, Hd, Hd, Hd, Dd, Dd, Dd, Rd, Rd, Rd, Rd, Rd, Dd, Dd^Dc, Dd^Dc, Dd^Dc, Dd, Dd, Rmo, Dd, Dd, Dd, Dd^Dr, Hd^Dr, Hd^Dr, Hd, Hd, Dd, Dd^Esd, Dd, Dd, Hd, Hd, Hd, Md, Md, Md, Md, Md, Hd, Hd, Hd, Dd, Rd, Dd, Rd, Dd, Dd, Dd, Dd, Rd
Dd, Dd, Dd, Dd, Hd, Hd, Md, Md, Md, Md, Md, Md, Md, Md, Md, Md, Md, Md, Md, Md, Md, Md, Md, Md, Md, Md, Hd, Hd, Rd, Hd, Md, Hd, Hd, Hd, Hd, Hd, Hd, Dd, Dd, Dd, Dd, Rd, Dd, Dd, Dd^Dc, Dd^Dc, Dd^Dc, Rd, Dd, Rmo, Dd^Vda, Dd, Dd, Dd, Dd, Hd, Hd, Hd, Hd, Dd, Dd, Dd^Esd, Dd, Hd, Hd, Md, Md, Md, Hd, Hd, Hd, Hd, Hd, Dd, Dd, Dd, Dd, Dd, Rd, Dd^Esd, Dd, Dd
Hd, Dd, Dd, Dd, Hd, Dd, Dd, Md, Md, Md, Md, Md, Md, Md, Md, Md, Md, Md, Md, Md, Md, Md, Md, Md, Md, Md, Dd, Rd, Md, Md, Md, Md, Md, Md, Hd, Hd, Hd, Dd, Dd, Dd, Rd, Dd, Dd, Dd, Dd^Vdt, Dd^Dc, Rd, Dd, Dd, Rmo, Dd, Dd, Dd, Dd, Dd, Dd, Hd, Hd, Dd, Dd, Dd, Dd, Dd^Esd, Hd, Hd, Hd, Hd, Hd, Hd, Hd, Hd, Hd, Dd, Dd, Dd, Dd, Dd, Dd^Esd, Dd, Dd, Dd, Dd
Dd, Hd, Hd, Hd, Dd, Dd, Md, Md, Md, Md, Md, Md, Md, Md, Md, Md, Hd, Md, Md, Md, Md, Md, Md, Md, Md, Md, Rd, Rd, Md, Md, Md, Md, Md, Md, Hd, Hd, Hd, Hd, Dd, Dd, Rd, Dd, Rd, Dd, Dd^Esd, Dd, Dd, Dd, Dd, Rmo, Dd, Dd, Dd, Dd, Dd, Dd, Dd, Dd, Dd, Dd, Dd, Dd, Dd^Esd, Dd, Dd, Hd, Hd, Hd, Hd, Hd, Dd, Dd^Esd, Dd, Rd, Rd, Rd, Dd, Dd, Dd^Esd, Dd^Esd, Rd, Dd
Md, Dd, Dd, Dd, Dd, Dd, Md, Md, Md, Md, Md, Md, Md, Md, Hd, Hd, Dd, Hd, Rd, Hd, Rd, Hd, Rd, Md, Rd, Hd, Rd, Md, Md, Md, Md, Md, Md, Md, Md, Hd, Hd, Hd, Dd, Dd, Rd, Dd, Rd, Dd, Rd, Dd, Dd^Esd, Dd, Dd, Rmo, Rmo, Dd, Dd, Dd^Esd, Dd, Dd, Dd^Esd, Dd, Rd, Dd, Rd, Rd, Rd, Dd^Esd, Dd, Dd, Dd, Dd, Dd, Dd, Dd, Dd, Rd, Dd, Dd, Dd, Rd, Dd, Dd^Esd, Dd, Rd, Dd
Md, Dd, Md, Dd, Md, Md, Md, Md, Md, Md, Md, Md, Md, Hd, Dd, Dd, Rd, Rd, Hd, Rd, Hd, Rd, Hd, Rd, Dd, Rd, Hd, Md, Md, Md, Md, Md, Md, Md, Md, Hd, Hd, Hd, Hd, Dd, Dd, Dd, Dd, Dd, Rd, Dd, Rd, Dd, Rd, Dd, Dd, Rmo, Rmo, Dd, Dd, Dd, Dd^Esd, Dd, Dd, Dd, Dd, Dd, Dd, Rd, Rd, Dd, Dd, Dd, Rd, Dd, Dd, Dd, Dd, Rd, Dd, Dd, Dd, Dd, Dd^Esd, Dd, Dd, Dd
Md, Md, Md, Md, Md, Md, Md, Md, Md, Md, Dd, Md, Dd, Dd, Rd, Rd, Md, Md, Md, Md, Md, Md, Md, Hd, Md, Hd, Md, Md, Md, Md, Md, Md, Md, Md, Md, Md, Hd, Hd, Hd, Dd, Dd, Dd^Esd, Dd^Esd, Rd, Dd^Esd, Rd, Dd, Rd, Rd, Dd, Dd, Dd, Dd, Rmo, Rmo, Dd, Dd, Rd, Dd, Dd, Dd, Dd, Dd, Rd, Dd, Dd, Dd, Rd, Dd, Rd, Dd, Dd, Dd, Dd, Dd, Dd, Dd, Dd^Esd, Rd, Dd, Dd, Dd
Md, Md, Md, Md, Md, Md, Md, Md, Hd, Hd, Hd, Hd, Rd, Rd, Md, Md, Md, Md, Md, Md, Md, Md, Md, Md, Md, Md, Md, Md, Md, Md, Md, Md, Md, Md, Md, Md, Hd, Hd, Hd, Hd, Dd, Dd^Esd, Dd, Rd, Dd, Dd, Dd^Esd, Dd, Dd, Dd, Rd, Rd, Dd^Esd, Dd^Esd, Rmo, Dd, Dd, Dd, Rd, Dd, Rd, Dd, Dd, Dd, Dd, Dd, Rd, Dd, Dd, Dd, Rd, Dd, Dd^Esd, Dd, Rd, Rd, Dd, Dd^Esd, Dd, Rd, Dd, Dd
Md, Md, Md, Md, Md, Md, Dd, Hd, Rd, Rd, Rd, Rd, Hd, Hd, Md, Md, Md, Md, Md, Md, Md, Md, Md, Md, Md, Md, Md, Md, Md, Md, Md, Md, Md, Md, Md, Md, Hd, Hd, Hd, Hd, Dd, Dd, Rd, Dd, Dd, Rd, Dd, Dd^Esd, Rd, Rd, Dd, Rd, Dd^Esd, Dd, Rmo, Dd, Dd, Dd, Rd, Dd, Dd, Dd, Rd, Dd, Rd, Rd, Dd, Dd^Esd, Dd, Rd, Dd, Dd, Dd, Dd, Dd, Dd, Dd, Dd, Dd, Dd, Dd, Dd
Md, Md, Md, Md, Rd, Hd, Rd, Rd, Hd, Dd, Hd, Dd, Md, Md, Md, Md, Md, Md, Md, Md, Md, Md, Md, Md, Md, Md, Md, Md, Md, Md, Md, Md, Md, Md, Md, Md, Hd, Hd, Hd, Hd, Dd^Esd, Dd, Dd, Dd, Rd, Dd, Rd, Dd, Rd, Dd, Rd, Dd, Rd, Dd^Esd, Rmo, Dd, Dd^Esd, Rd, Dd, Rd, Rd, Rd, Dd^Esd, Dd, Rd, Rd, Dd, Rd, Dd, Dd, Dd, Dd, Dd, Dd, Dd, Dd, Dd^Esd, Rd, Dd, Dd^Esd, Dd, Dd
Hd, Dd, Hd, Hd, Rd, Rd, Hd, Hd, Md, Md, Md, Md, Md, Md, Md, Md, Md, Md, Md, Md, Md, Md, Md, Md, Md, Md, Md, Md, Md, Md, Md, Md, Md, Md, Md, Md, Hd, Hd, Hd, Dd, Dd, Dd, Dd^Esd, Rd, Rd, Rd, Dd, Rd, Dd, Dd, Rd, Rd, Dd, Dd, Rmo, Rd, Dd, Rd, Dd, Dd, Rd, Dd, Dd, Rd, Rd, Rd, Dd, Rd, Dd, Dd, Rd, Dd, Dd, Dd, Dd^Esd, Dd, Dd, Dd, Dd, Dd, Dd, Dd
Hd, Dd, Rd, Rd, Rd, Hd, Md, Md, Md, Md, Md, Md, Md, Md, Md, Md, Md, Md, Md, Md, Md, Md, Md, Md, Md, Md, Md, Md, Md, Md, Md, Md, Md, Md, Hd, Hd, Hd, Hd, Dd, Dd, Dd, Rd, Dd^Esd, Dd, Dd, Dd, Rd, Dd^Esd, Dd, Rd, Dd, Dd, Dd, Dd, Rmo, Dd, Dd, Rd, Rd, Dd, Dd, Dd, Dd, Dd, Dd, Dd, Dd, Dd, Dd, Dd, Dd, Dd, Dd, Dd^Esd, Dd, Dd, Dd, Dd^Esd, Dd, Dd, Dd, Dd
Rd, Rd, Hd, Dd, Hd, Hd, Md, Md, Md, Md, Md, Md, Md, Md, Md, Md, Md, Md, Md, Md, Md, Md, Md, Md, Md, Md, Md, Md, Md, Md, Hd, Md, Hd, Hd, Hd, Hd, Hd, Hd, Dd, Dd, Rd, Dd, Dd, Dd^Esd, Dd, Rd, Rd, Dd^Esd, Dd, Dd, Dd, Dd, Rmo, Rmo, Dd, Dd, Dd, Dd, Rd, Dd, Rd, Dd, Dd, Dd, Rd, Dd, Rd, Dd, Dd, Rd, Dd, Rd, Dd, Dd, Dd^Esd, Dd, Dd, Dd, Dd, Dd, Hd, Hd
Hd, Hd, Md, Hd, Md, Md, Md, Md, Md, Md, Md, Md, Md, Md, Md, Md, Md, Md, Md, Md, Md, Md, Md, Md, Md, Md, Md, Md, Md, Md, Hd, Hd, Hd, Hd, Hd, Hd, Dd, Dd, Dd, Dd, Dd, Rd, Rd, Dd, Dd, Rd, Dd, Dd, Dd, Dd^Esd, Rmo, Rmo, Dd, Dd, Rd, Dd, Dd, Rd, Rd, Dd, Dd, Rd, Rd, Dd, Dd, Dd, Dd, Rd, Rd, Dd, Rd, Dd, Dd, Dd, Dd, Dd, Dd, Dd, Hd, Hd, Hd, Hd
Md, Md, Md, Md, Md, Md, Md, Md, Md, Md, Md, Md, Md, Md, Md, Md, Md, Md, Md, Md, Md, Md, Hd, Md, Md, Md, Md, Md, Hd, Hd, Hd, Hd, Hd, Hd, Dd, Dd, Dd^Esd, Dd, Dd, Dd, Rd, Rd, Dd, Dd, Rd, Rd, Dd, Dd, Dd, Rmo, Dd, Dd, Dd, Dd, Dd, Dd, Dd, Dd, Rd, Dd, Dd, Rd, Dd, Dd, Dd, Dd, Rd, Dd, Dd, Dd, Rd, Rd, Dd, Dd, Dd, Dd^Esd, Dd, Hd, Hd, Hd, Hd, Hd
Md, Md, Md, Md, Md, Md, Md, Md, Md, Md, Md, Md, Md, Md, Md, Md, Hd, Md, Hd, Hd, Hd, Hd, Hd, Hd, Hd, Md, Hd, Hd, Hd, Hd, Hd, Hd, Dd, Dd, Dd, Dd, Dd, Dd, Dd, Rd, Dd, Rd, Rd, Rd, Dd, Dd, Dd, Rd, Dd, Rmo, Dd, Dd, Dd, Rd, Rd, Dd, Rd, Dd, Dd, Rd, Dd, Dd, Dd, Dd, Dd, Dd, Dd, Dd, Dd, Dd, Dd, Dd, Dd, Dd^Esd, Dd, Dd, Dd, Hd, Hd, Hd, Hd, Hd
Md, Md, Md, Md, Md, Md, Md, Md, Md, Md, Md, Md, Md, Md, Hd, Hd, Hd, Hd, Hd, Hd, Hd, Hd, Hd, Hd, Hd, Hd, Hd, Hd, Hd, Hd, Dd, Dd, Dd, Dd, Dd, Dd, Dd, Dd, Hd, Dd, Hd, Dd, Dd, Dd, Rd, Dd, Dd, Rd, Dd, Rmo, Dd, Dd, Dd, Dd, Dd, Dd, Dd, Dd, Dd, Dd, Dd, Dd, Hd, Dd, Dd, Dd, Dd^Esd, Dd, Dd, Rd, Dd, Dd, Dd, Dd, Dd, Dd, Dd, Hd, Hd, Hd, Hd, Hd
Md, Md, Md, Md, Md, Md, Md, Md, Md, Md, Md, Md, Hd, Hd, Hd, Hd, Hd, Hd, Dd, Hd, Dd, Hd, Dd, Hd, Dd, Hd, Dd, Dd, Dd, Dd, Dd, Dd, Dd, Dd^Esd, Dd, Dd, Hd, Hd, Hd, Hd, Hd, Hd, Hd, Dd, Dd, Dd, Dd, Dd, Rmo, Rmo, Dd, Dd, Dd, Dd, Dd, Dd, Dd, Dd, Dd, Dd, Hd, Hd, Hd, Hd, Hd, Dd, Dd, Dd, Dd, Dd, Dd, Dd, Dd, Dd, Dd, Dd, Hd, Hd, Hd, Hd, Hd, Hd
Md, Md, Md, Md, Md, Md, Md, Md, Md, Md, Hd, Hd, Hd, Hd, Dd, Dd, Dd, Dd, Dd, Dd, Dd, Dd, Dd, Dd, Dd^Esd, Dd, Dd, Dd, Dd, Dd, Dd, Dd, Dd^Esd, Dd, Dd, Dd, Hd, Hd, Hd, Hd, Hd, Hd, Hd, Hd, Hd, Dd, Dd, Rmo, Dd, Dd, Dd, Dd, Dd, Dd, Dd, Dd, Dd, Dd, Hd, Hd, Hd, Hd, Md, Hd, Hd, Dd, Dd, Dd^Esd, Dd^Esd, Dd, Dd, Dd, Dd, Dd, Hd, Dd, Hd, Hd, Hd, Hd, Hd, Hd
Hd, Md, Hd, Md, Hd, Md, Hd, Md, Hd, Hd, Hd, Hd, Hd, Hd, Dd, Dd, Dd, Dd, Dd^Esd, Dd, Dd, Dd, Dd, Dd, Dd, Dd, Dd^Esd, Dd, Dd, Dd, Dd, Dd, Dd, Dd, Dd, Hd, Hd, Hd, Md, Md, Md, Md, Md, Hd, Hd, Hd, Dd, Rmo, Dd, Dd, Dd, Dd, Dd, Dd, Dd, Dd, Hd, Hd, Hd, Hd, Md, Md, Md, Hd, Hd, Dd, Dd, Dd, Dd, Dd, Hd, Hd, Hd, Hd, Hd, Hd, Hd, Hd, Hd, Hd, Hd, Hd
Hd, Hd, Hd, Hd, Hd, Hd, Hd, Hd, Hd, Hd, Hd, Hd, Dd, Dd, Dd, Dd, Dd^Esd, Dd, Dd, Dd, Dd^Esd, Dd, Dd^Esd, Dd, Hd, Hd, Dd, Dd, Dd, Dd, Dd, Dd, Dd, Dd, Dd, Hd, Hd, Hd, Md, Md, Md, Md, Md, Md, Hd, Hd, Dd, Rmo, Dd, Dd, Dd, Dd, Dd, Dd, Hd, Hd, Hd, Hd, Md, Md, Md, Md, Md, Hd, Hd, Dd, Dd, Dd, Hd, Hd, Hd, Hd, Hd, Hd, Hd, Hd, Hd, Hd, Hd, Hd, Hd, Hd
Hd, Hd, Hd, Hd, Dd, Hd, Dd, Hd, Hd, Hd, Dd, Dd, Dd, Dd, Dd, Dd, Dd, Dd^Esd, Dd, Dd, Dd, Dd, Dd, Hd, Hd, Hd, Hd, Dd, Dd, Dd, Dd, Dd, Dd^Esd, Dd, Hd, Hd, Hd, Md, Md, Md, Md, Md, Md, Md, Hd, Hd, Dd, Rmo, Dd, Dd, Dd, Dd, Hd, Hd, Hd, Hd, Hd, Md, Md, Md, Md, Md, Md, Md, Md, Hd, Hd, Hd, Hd, Hd, Hd, Hd, Hd, Hd, Hd, Hd, Hd, Hd, Hd, Hd, Hd, Hd
Hd, Hd, Dd, Dd, Dd, Dd, Dd, Dd, Dd, Dd, Dd, Dd, Dd, Dd, Dd, Dd, Dd^Esd, Dd, Dd, Dd, Dd, Hd, Dd^Esd, Hd, Hd, Hd, Hd, Hd, Dd, Dd, Dd, Dd, Dd, Dd, Hd, Hd, Hd, Md, Md, Md, Md, Md, Md, Md, Hd, Hd, Dd, Rmo, Dd, Dd, Hd, Hd, Hd, Hd, Hd, Hd, Md, Md, Md, Md, Md, Md, Md, Md, Md, Hd, Hd, Hd, Hd, Hd, Hd, Hd, Hd, Hd, Hd, Hd, Hd, Hd, Hd, Hd, Hd, Hd
Dd, Dd, Dd, Dd^Esd, Dd, Dd, Dd, Dd, Dd^Esd, Dd^Esd, Dd^Esd, Dd, Dd, Dd, Dd, Dd^Esd, Hd, Dd^Esd, Hd, Hd, Hd, Hd, Hd, Hd, Hd, Hd, Hd, Hd, Dd, Dd, Dd, Dd^Esd, Dd, Dd, Hd, Hd, Md, Md, Md, Md, Md, Md, Md, Md, Md, Hd, Dd, Rmo, Dd, Hd, Hd, Hd, Md, Hd, Md, Md, Md, Md, Md, Md, Md, Md, Md, Md, Md, Md, Hd, Hd, Hd, Hd, Hd, Hd, Hd, Hd, Hd, Hd, Hd, Hd, Hd, Hd, Hd, Hd
Md, Dd, Dd, Dd, Dd, Dd, Dd, Dd, Dd, Dd, Dd, Dd, Dd, Dd, Dd, Hd, Dd, Hd, Dd, Hd, Hd, Hd, Dd, Hd, Dd, Hd, Hd, Hd, Hd, Dd, Dd, Dd^Esd, Dd, Dd, Hd, Hd, Md, Md, Md, Md, Md, Md, Md, Md, Md, Hd, Dd, Rmo, Dd, Hd, Dd, Md, Md, Md, Md, Md, Md, Md, Md, Md, Md, Md, Md, Md, Md, Md, Hd, Hd, Hd, Hd, Hd, Hd, Hd, Hd, Hd, Hd, Hd, Hd, Hd, Hd, Hd, Hd
