border_size=1
usage=map

Wot, Wot, Wot, Wot, Wot, Wot, Wot, Wot, Wot, Wot, Wot, Wot, Wot, Wot, Wot, Wot, Wot, Wot, Wot, Wot, Wot, Wot, Wot, Wot, Wot, Wot, Wot, Wot, Wot, Wot, Wot, Wot, Wot, Wot, Wot, Wot, Wot, Wot, Wot, Wot, Wot, Wot, Wot, Wot, Wwt, Wot, Wot, Wot, Wot, Wot, Wot, Wot, Wot, Wot, Wot, Wot, Wot, Wot, Wot, Wot, Wot, Wot, Wot, Wot, Wot, Wot, Wot, Wot, Wot, Wot, Wot, Wot, Wot, Wot, Wot, Wot, Wot, Wot, Wwrt, Wot, Wwrt, Wot
Wot, Wot, Wot, Wot, Wot, Wot, Wot, Wot, Wot, Wot, Wot, Wot, Wot, Wot, Wot, Wot, Wot, Wot, Wot, Wot, Wot, Wot, Wot, Wot, Wot, Wot, Wot, Wot, Wot, Wot, Wot, Wot, Wot, Wot, Wot, Wot, Wot, Wot, Wot, Wot, Wot, Wot, Wwt, Wwt, Wot, Wwt, Wot, Wot, Wot, Wot, Wot, Wot, Wot, Wot, Wot, Wot, Wot, Wot, Wot, Wot, Wot, Wot, Wot, Wot, Wot, Wot, Wot, Wot, Wot, Wot, Wot, Wot, Wwrt, Wwrt, Wwrt, Wwrt, Wwrt, Wot, Wwt, Wwt, Wwt, Wwrt
Wot, Wot, Wot, Wot, Wot, Wot, Wot, Wot, Wot, Wot, Wot, Wot, Wot, Wot, Wot, Wot, Wot, Wot, Wot, Wot, Wot, Wot, Wot, Wot, Wot, Wot, Wot, Wot, Wot, Wot, Wot, Wot, Wot, Wot, Wot, Wot, Wot, Wot, Wwt, Wot, Wot, Wwt, Wot, Wot, Wwt, Wot, Wot, Wot, Wwt, Wwt, Wot, Wwt, Wot, Wot, Wot, Wot, Wot, Wot, Wot, Wot, Wot^Cov, Wot, Wot^Cov, Wot, Wot^Cov, Wot, Wot, Wot, Wot, Wot, Wwrt, Wot, Wwrt, Wwrt, Wot, Wot, Wwt, Wwt, Wwt, Wwrt, Wwt, Wwt
Wot, Wot, Wot, Wot, Wot, Wot, Wot, Wot, Wot, Wot, Wot, Wot, Wot, Wot, Wot, Wot, Wot, Wot, Wot, Wot, Wot, Wot, Wot, Wot, Wot, Wot, Wot, Wot, Wot, Wot, Wot, Wot, Wot, Wot, Wot, Wot, Wot, Wot, Wot, Wot, Wot, Wwt, Wot, Wot, Wwt, Wot, Wwt, Wot, Wot, Wot, Wot, Wot, Wot, Wot, Wwt, Wot, Ww^Vm, Wot, Wot, Wot, Wot, Wot^Cov, Wot^Kov, Wot^Cov, Wot, Wot, Wot, Wot, Wot, Wwrt, Wwrt, Wot, Wot, Wwt, Wwt, Wwt, Wwt, Wwt, Wwt, Wwt, Wwt, Wwt
Wot, Wot, Wot, Wot, Wot, Wot, Wot, Wot, Wot, Wot, Wot, Wot, Wot, Wot, Wot, Wot, Wot, Wot, Wot, Wot, Wot, Wot, Wot, Wot, Wot, Wot, Wot, Wot, Wot, Wot, Wot, Wot, Wot, Wot, Wot, Wot, Wwt, Wot, Wwt, Wot, Wwt, Wwt, Wot, Wot, Wot, Wwt, Wot, Wot, Wwt, Wwt, Wot, Wwt, Wot, Wwt, Wot, Wot, Wot, Wot, Wot, Wot, Wot^Cov, Wot^Cov, Wot^Cov, Wot^Cov, Wot^Cov, Wot, Wwrt, Wwrt, Wot, Wot, Wot, Wot, Wwt, Wwt, Wwt, Wwrt, Wwt, Wwt, Wwt, Wwt, Ds, Wwt
Wot, Wot, Wot, Wot, Wot, Wot, Wot, Wot, Wot, Wot, Wot, Wot, Wot, Wot, Wot, Wot, Wot, Wot, Wot, Wot, Wot, Wot, Wot, Wot, Wot, Wot, Wot, Wot, Wot, Wot, Wot, Ww^Vm, Wot, Wot, Wot, Wot, Wot, Wwt, Wot, Wot, Wot, Wwt, Wwt, Wwt, Wwrt, Wwt, Wwrt, Wwt, Wot, Wot, Wwt, Wwt, Wot, Wot, Wwt, Wot, Wot, Wot, Wot, Wot, Wot, Wot, Wot^Cov, Wot, Wot, Wot, Wot, Wot, Wwrt, Wwrt, Wot, Wwt, Wwt, Wwt, Wwt, Wwt, Wwt, Wwt, Ds, Ds, Ds, Ds
Wot, Wot, Wot, Wot, Wot, Wot, Wot, Wot, Wot, Wot, Wot, Wot, Wot, Wot, Wot, Wot, Wot, Wot, Wot, Wot, Wot, Wot, Wot, Wot, Wot, Wot, Wot, Wot, Wot, Wot, Wot, Wot, Wot, Wot, Wot, Wot, Wwt, Wot, Wot, Wot, Wot, Wot, Wwt, Wwt, Wwrt, Wwt, Wwt, Wwt, Wwt, Wwt, Wwt, Wot, Wot, Wwt, Wwt, Wot, Wot, Wot, Wot, Wot, Wot, Wot, Wot, Wot, Wot, Wot, Wwrt, Wwt, Wwrt, Wot, Wwrt, Wot, Wwt, Wwt, Wwt, Wwt, Ds, Ds, Dd^Ftd, Dd^Ftd, Dd^Ftd, Ds
Wot, Wot, Wot, Wot, Wot, Wot, Wot, Wot, Wot, Wot, Wot, Wot, Wot, Wot, Wot, Wot, Wot, Wot, Wot, Wot, Wot, Wot, Wot, Wot, Wot, Wot, Wot, Wot, Wot, Wot, Wot, Wot, Wot, Wot, Wot, Wot, Wot, Wwt, Wwt, Wwt, Wwt, Wwt, Wwt, Wwrt, Ww^Vm, Wwrt, Wwt, Wwrt, Wwt, Wwrt, Wwt, Wot, Wwt, Wot, Wot, Wwt, Wot, Wot, Ww^Vm, Wot, Wot, Wot, Wot, Wwt, Wwt, Wwt, Wwrt, Wwt, Wot, Wwt, Wot, Wot, Wwt, Wwt, Wwt, Wwt, Wwt, Ds, Dd^Ftd, Dd^Ftd, Gd^Fts, Dd^Ftd
Wwrt, Wot, Wwrt, Wot, Wot, Wwrt, Wot, Wot, Wot, Wot, Wot, Wot, Wot, Wot, Wot, Wot, Wot, Wot, Wot, Wot, Ww^Vm, Wot, Wot, Wot, Wot, Wot, Wot, Wot, Wot, Wot, Wot, Wot, Wot, Wot, Wot, Wot, Wwt, Wwt, Wwt, Wwt, Wwt, Wwt, Wwrt, Wwrt, Wwt, Wwt, Wwrt, Wwt, Wwt, Wwt, Wwt, Wot, Wot, Wwt, Wot, Wwt, Wwt, Wot, Wot, Wot, Wot, Wot, Wwt, Wot, Wot, Wot, Wwt, Wwrt, Wwt, Wwt, Wwt, Wwt, Wwt, Wwt, Wwt, Wwt, Ds, Ds, Dd^Ftd, Dd^Ftd, Gd^Fts, Gd^Fts
Wot, Wwrt, Wwrt, Wot, Wot, Wot, Wot, Wot, Wot, Wwrt, Wot, Wot, Wot, Wot, Wot, Wot, Wwrt, Wot, Wwrt, Wot, Wwrt, Wwrt, Wwrt, Wwrt, Wot, Wwrt, Wot, Wot, Wot, Wot, Wot, Wot, Wot, Wot, Wot, Wwt, Wot, Wwt, Wot, Wwrt, Wwrt, Wwt, Wwt, Wwt, Wwt, Wwt, Wwt, Wwt, Wwrt, Wwrt, Wwrt, Wwrt, Wwrt, Wot, Wot, Wwt, Wwt, Wot, Wwt, Wot, Wwt, Wot, Wot, Wwt, Wot, Wot, Wot, Wot, Wwt, Wot, Wwt, Wwt, Wwt, Wwt, Ds, Ds, Ds, Dd^Ftd, Dd^Ftd, Gd^Fts, Ds, Ds
Wwt, Wot, Wot, Wwrt, Wwrt, Wot, Wwrt, Wwt, Wwrt, Wot, Wwrt, Wot, Wwrt, Wot, Wwt, Wot, Wwt, Wot, Wwrt, Wwt, Wot, Wot, Wwt, Wwrt, Wot, Wot, Wot, Wot, Wot, Wot, Wwrt, Wwrt, Wwt, Wot, Wwt, Wwrt, Wot, Wwt, Wwrt, Wot, Wwrt, Wwt, Wwt, Wwt, Wwrt, Wwt, Wwt, Wwt, Wwt, Wwt, Wwt, Wwt, Wwrt, Wwt, Wot, Wwrt, Wwt, Wwrt, Wwt, Wot, Wwt, Wwt, Wwt, Wwrt, Wot, Wwt, Wwrt, Wot, Wwt, Wwt, Wwt, Wwt, Wwt, Wwt, Ds, Ds, Ds, Dd^Ftd, Gd^Fts, Gd^Fts, Gd^Fts, Gd^Fts
Wot, Wot, Wwt, Wot, Wot, Wot, Wwt, Wot, Wot, Wwt, Wot, Wwrt, Wot, Wot, Wwt, Wwt, Wot, Wot, Wwt, Wwrt, Wwt, Wwrt, Wot, Wot, Wwt, Wot, Wot, Wwt, Wwrt, Wot, Wot, Wot, Wwt, Wwrt, Wwt, Wot, Wwrt, Wwt, Wot, Wwt, Wwt, Wwrt, Wwt, Wwrt, Wwt, Wwt, Wwt, Wwt, Wwt, Wwt, Wwt, Wwt, Wwrt, Wot, Wot, Wwrt, Wwt, Wot, Wwrt, Wot, Wwt, Wot, Wwrt, Wot, Wwrt, Wot, Wwrt, Wwt, Wwt, Wwt, Wwt, Wwt, Wwt, Wwt, Ds, Ds, Gd, Gd^Fts, Gd^Fts, Ds, Gd^Fts, Gd
Wot, Wwt, Wot, Wot, Wot, Wwt, Ww^Vm, Wwt, Wwt, Wwt, Wot, Wwt, Wot, Wot, Wot, Wwt, Ww^Vm, Wot, Wot, Wwt, Wot, Wot, Wwt, Wot, Wot, Wwt, Wot, Wwt, Wwrt, Wwrt, Wwt, Wwrt, Wwt, Wwt, Wwt, Wot, Wwt, Wot, Wwt, Wwrt, Wwt, Wwt, Wwt, Wwt, Wwt, Wwt, Wwt, Wwt, Wwt, Wwt, Wwt, Wwt, Wwt, Wot, Wwrt, Wot, Wwt, Wwrt, Wwt, Wwt, Wwrt, Wot, Wot, Wwrt, Wot, Wwrt, Wot, Wwt, Wwt, Wwt, Wwt, Wwt, Wwt, Wwt, Ds, Ds, Gd, Gd, Gd, Gd, Gd, Gd
Wwt, Wwt, Wwt, Wwt, Wwt, Wwt, Wwt, Wwt, Wwt, Wwt, Wwt, Wot, Wot, Wwt, Wwt, Wwt, Wwt, Wot, Wwt, Wwt, Wot, Wot, Wwrt, Wwrt, Wot, Wot, Wwt, Wot, Wot, Wwt, Wot, Wwrt, Wwrt, Wwrt, Wot, Wwt, Wot, Wot, Wot, Wwt, Wwt, Wwt, Wwt, Wwt, Wwt, Wwt, Ds, Wwt, Ds, Wwt, Wwt, Wwt, Wwt, Wwrt, Wwt, Wwrt, Wwt, Wwt, Wwrt, Wwt, Wwt, Wwt, Wwt, Wwt, Wot, Wwt, Wot, Wwt, Wwt, Wwt, Wwt, Wwt, Ds, Ds, Dd^Ftd, Ds, Gd, Gs^Es, Gd^Es, Gs, Gs^Es, Gs
Wwt, Wwt, Wot, Wot, Wwt, Wot, Wot, Wwt, Wwt, Wwt, Wot, Wot, Wot, Wwt, Wwt, Wot, Wot, Wwt, Wwt, Wot, Wwt, Wot, Wwt, Wwt, Wot, Wwt, Wot, Wwt, Wot, Wwt, Wot, Wot, Wwt, Wot, Wwrt, Wwt, Wot, Wwrt, Wot, Wwt, Wwt, Wwt, Wwt, Wwt, Dd^Ftd, Dd^Ftd, Dd^Ftd, Ds, Dd^Ftd, Ds, Wwt, Wwt, Wwt, Wwt, Wwt, Wwt, Wwt, Wwt, Wwt, Wwt, Wwt, Wwt, Wwt, Wot, Wot, Wot, Wot, Wot, Wwt, Wwt, Ds, Ds, Dd^Ftd, Dd^Ftd, Dd^Ftd, Gd^Fts, Gd^Fts, Gd, Gd, Gd, Gd, Gs
Wwt, Wot, Wwt, Wwt, Wwt, Wot, Wwt, Wwt, Wwt, Wwt, Wwt, Wwt, Wot, Wwt, Wwt, Wwt, Wwt, Wwt, Wwt, Wwt, Wwt, Wot, Wot, Wot, Wwt, Wwt, Wwt, Wot, Wwt, Wwt, Wwt, Wot, Wwt, Wot, Wwt, Wot, Wwt, Wwt, Wwt, Wwt, Wwt, Wwt, Wwt, Ds, Dd^Ftd, Hd^Ftd, Hd^Ftd, Hd^Ftd, Hd^Ftd, Dd^Ftd, Wwt, Wwt, Wwt, Wwt, Wwt, Wwt, Wwt, Wwt, Wwt, Wwt, Wwt, Wwt, Wwt, Wot, Wwt, Wot, Wwt, Wwt, Wwt, Wwt, Ds, Ds, Dd^Ftd, Dd^Ftd, Dd^Ftd, Dd^Ftd, Gd, Gd^Fts, Gd, Gs, Gs^Var, Gs
Wwt, Wwt, Wwt, Wwt, Wwt, Wwt, Wwt, Wwt, Wwt, Wwt, Wwt^Bab|, Wwt, Wwt^Bab|, Wwt, Wwt^Bab|, Wwt, Wwt, Wwt, Wwt, Wwt, Wwt, Wwt, Wwt, Wot, Wwt, Wwt, Wwt, Wwt, Wwt, Wwt, Wwt, Wwt, Wwt, Wwt, Wwt, Wwt, Wwt, Wwt, Wwt, Wwt, Wwt, Wwt, Wwt, Ds, Ds, Hd^Ftd, Hd^Ftd, Hd^Ftd, Hd^Ftd, Dd^Ftd, Wwt, Wwt, Wwt, Wwt, Wwt, Wwt, Wwt, Wwt, Wwt, Wwt, Wwt, Wwt, Wwt, Wwt, Wwt, Wwt, Wwt, Wwt, Wwt, Wwt, Wwt, Ds, Ds, Dd^Ftd, Dd^Ftd, Dd^Ftd, Gd^Fts, Gd^Fts, Gd, Gs, Gd, Gs
Wwt, Wwt, Wwt, Wwt, Wwt, Wwt, Wwt, Wwt, Wwt, Wwt, Wwt^Bab|, Wwt, Wwt^Bab|, Wwt, Wwt^Bab|, Wwt, Wwt, Wwt, Wwt, Wwt, Wwt, Wwt, Wwt, Wwt, Wwt, Wwt, Wwt, Wwt, Wwt, Wwt, Wwt, Wwt, Wwt, Wwt, Wwt, Wwt, Wwt, Wwt, Wwt, Wwt, Wwt, Wwt, Wwt, Wwt, Ds, Dd^Ftd, Dd^Ftd, Hd^Ftd, Hd^Ftd, Ds, Wwt, Wwt, Wwt, Wwt, Wwt, Wwt, Wwt, Wwt, Ds, Wwt, Wwt, Wwt, Wwt, Wwt, Wwt, Wwt, Wwt, Wwt, Wwt, Wwt, Wwt, Wwt, Ds, Ds, Ds, Gd^Fts, Gd, Gd^Fts, Gd, Gs, Gs^Es, Gs
Ds, Wwt, Wwt, Wwt, Wwt, Wwt, Ds, Ds, Ds, Wwt, Kar, Wwt, 1 Kar, Wwt, Kar, Ds, Ds, Wwt, Wwt, Wwt, Wwt, Wwt, Wwt, Wwt, Wwt, Wwt, Wwt, Wwt, Wwt, Wwt, Wwt, Wwt, Wwt, Wwt, Wwt, Wwt, Wwt, Wwt, Wwt, Wwt, Wwt, Wwt, Wwt, Wwt, Wwt, Dd^Ftd, Hd^Ftd, Hd^Ftd, Hd^Ftd, Dd^Ftd, Dd^Ftd, Wwt, Wwt, Wwt, Wwt, Wwt, Ds, Ds, Ds, Ds, Ds, Wwt, Wwt, Wwt, Wwt, Wwt, Wwt, Wwt, Wwt, Wwt, Wwt, Wwt, Ds, Ds, Ds, Gd, Gs, Gd, Gs, Gs, Gd, Gs
Ds, Ds, Ds, Ds, Ds, Ds, Dd^Ftd, Ds, Ds, Ds, Car, Ds, Kar, Ds, Car, Ds, Ds, Ds, Ds, Wwt, Ds, Wwt, Wwt, Wwt, Wwt, Wwt, Wwt, Wwt, Ds, Ds, Ds, Wwt, Ds, Wwt, Wwt, Wwt, Wwt, Wwt, Ds, Ds, Wwt, Wwt, Wwt, Wwt, Wwt, Dd^Ftd, Hd^Ftd, Hd^Ftd, Hd^Ftd, Hd^Ftd, Dd^Ftd, Wwt, Ds, Wwt, Ds, Ds, Ds, Ds, Dd^Ftd, Ds, Ds, Ds, Ds, Wwt, Wwt, Wwt, Wwt, Wwt, Ds, Wwt, Ds, Ds, Ds, Ds, Gd, Gd, Gd^Es, Gs^Es, Gd, Gs, Gs^Es, Gs
Gd, Ds, Ds, Ds, Dd^Ftd, Dd^Ftd, Dd^Ftd, Dd^Ftd, Dd^Ftd, Ds, Ds, Car, Car, Car, Gd, Gd, Gd, Dd^Ftd, Ds, Ds, Ds, Ds, Ds, Wwt, Wwt, Wwt, Ds, Ds, Ds, Ds, Dd^Ftd, Ds, Ds, Ds, Ds, Ds, Ds, Ds, Ds, Ds, Ds, Wwt, Ds, Wwt, Dd^Ftd, Dd^Ftd, Hd^Ftd, Hd^Ftd, Hd^Ftd, Hd^Ftd, Ds, Ds, Ds, Ds, Ds, Ds, Dd^Ftd, Dd^Ftd, Dd^Ftd, Dd^Ftd, Dd^Ftd, Ds, Ds, Wwt, Wwt, Wwt, Wwt, Ds, Ds, Ds, Dd^Ftd, Ds, Gd, Gd, Gs, Gs^Es, Gs, Gs^Var, Gs^Es, Gs, Gd, Gd
Gd^Es, Gd, Gd, Gd^Fts, Gd, Dd^Ftd, Gd^Fts, Dd^Ftd, Gd^Fts, Dd^Ftd, Gd, Ds, Rmo, Gd, Gs^Es, Gd^Es, Dd^Ftd, Dd^Ftd, Dd^Ftd, Ds, Dd^Ftd, Ds, Ds, Wwt, Wwt, Wwt, Ds, Ds, Gd^Fts, Gd^Fts, Gd^Fts, Dd^Ftd, Gd, Ds, Dd^Ftd, Dd^Ftd, Dd^Ftd, Ds, Gd, Ds, Ds, Ds, Ds, Dd^Ftd, Ds, Dd^Ftd, Ds, Gd^Fts, Gd^Fts, Gd^Fts, Gd^Fts, Dd^Ftd, Gd, Ds, Gd, Gd^Fts, Gd^Fts, Dd^Ftd, Gd^Fts, Dd^Ftd, Gd^Fts, Ds, Ds, Ds, Wwt, Wwt, Wwt, Ds, Dd^Ftd, Dd^Ftd, Dd^Ftd, Gd^Fts, Gd, Gs, Gs^Es, Gd, Gd^Es, Gs, Gd, Gd, Gd, Gd^Fts
Gs^Es, Gd, Gd^Fts, Gd, Gd, Gd^Fts, Gd, Gd^Fts, Gd, Gd^Fts, Gd^Fts, Gd, Rmo, Gs, Gd^Es, Gd^Es, Dd^Ftd, Dd^Ftd, Gd^Fts, Dd^Ftd, Dd^Ftd, Ds, Ds, Wwt, Wwt, Wwt, Ds, Ds, Gd, Gd^Fts, Gd, Gd, Gd^Fts, Gd^Fts, Gd, Gd^Fts, Gd^Fts, Gd^Fts, Gd, Gd, Gd, Ds, Gd, Ds, Gd^Fts, Ds, Gd^Fts, Gd^Fts, Gd, Gd^Fts, Gd, Gd, Gs^Es, Gd, Gd, Gd^Fts, Gd, Gd^Fts, Gd, Gd^Fts, Gd, Gd^Fts, Ds, Ds, Wwt, Wwt, Wwt, Dd^Ftd, Gd^Fts, Dd^Ftd, Gd^Fts, Gd^Fts, Gd^Fts, Gd, Gs, Gs^Es, Gs, Gd, Gd^Fts, Gd^Fts, Gll, Gd^Fts
Gs, Gd, Gd, Gd, Gd^Fts, Gd^Fts, Gd, Gd^Fts, Gd^Fts, Gd^Fts, Gd, Gd, Rmo, Gs, Gd, Gd^Fts, Gd^Fts, Gd^Fts, Gd^Fts, Dd^Ftd, Gd^Fts, Gd^Fts, Ds, Wwt, Wwt, Wwt, Ds, Gd^Fts, Gd^Fts, Gd^Es, Gs, Gs, Gs, Gd, Gd, Gd, Gd, Gd^Es, Gs^Es, Gs^Es, Gs, Gd, Gs^Es, Gd, Gd, Gd^Fts, Gd, Gd, Gs^Es, Gd, Gd^Es, Gs^Es, Gs, Gs^Es, Gs, Gd, Gd, Gd, Gs^Ft, Gd, Gs, Gd, Gd, Ds, Wwt, Wwt, Wwt, Ds, Gd^Fts, Gd^Fts, Gd, Gd^Fts, Gd, Gd, Gs^Es, Gs, Gd, Gd, Gll, Gd^Fts, Gd^Fts, Gd^Fts
Gd^Es, Gs, Gs^Es, Gs, Gd^Es, Gd, Gs, Gd^Fts, Gd, Gd, Gs^Var, Gs, Gs^Es, Rmo, Rmo, Gd, Kar, Gd, Gd^Fts, Gd, Gd^Fts, Gd^Fts, Ds, Wwt, Wwt, Wwt, Wwt, Ds, Gd^Fts, Gs, Gs, Gs^Es, Gs^Es, Gs, Gs, Gs^Es, Gs, Gs, Gs, Gs, Gs, Gs, Gs, Gs^Es, Gd, Gd^Es, Gs, Gs, Gs, Gs, Xar, Gd, Gs, Gs, Gs, Gs^Es, Gd^Es, Gs, Gs^Es, Gd^Es, Gs^Es, Gs, Gd, Ds, Wwt, Wwt, Wwt, Ds, Gd, Gd^Fts, Gd, Gd, Gs, Gd, Gs, Gd^Es, Gd, Gd^Fts, Gll, Gs^Ft, Gs^Ft, Gll
Gs, Gs^Es, Gs, Gs, Gd^Fts, Gd^Es, Gs, Gs^Es, Gs, Gs, Gs, Gd, Gs, Gs, Gs^Es, Rmo, Rmo, Car, Car, Car, Car, Car, Car, Kar, Wwt, Wwt, Wwt, Kar, Car, Car, Car, Car, Car, Car, Car, Car, Car, Gd^Fts, Gs, Gd^Fts, Gd, Gs, Gs, Gs^Es, Gd, Xar, Gd, Gs, Gs, Xar, Gd, Gs, Gs^Es, Gs, Gs^Es, Gs^Es, Gs, Gs^Es, Gs, Gs, Gs^Es, Gs, Gd, Ds, Wwt, Wwt, Wwt, Ds, Gd, Gd, Xar, Gs, Xar, Gd, Gd, Gs^Es, Gs, Gs^Ft, Gd^Fts, Gd^Fts, Gs^Ft, Gd^Fts
Gd, Gd, Gs^Ft, Gll, Gd^Fts, Xar, Xar, Gd, Gs, Gs^Es, Gd, Gd^Es, Gs, Gs, Kar, Rmo, Rmo, Re, Gs^Es, Gs^Ft, Gs^Ft, Gs^Ft, Gs^Ft, Gs^Ft, Wwt, Wwt, Wwt, Wwt, Gs^Ft, Gs^Ft, Gs, Rmo, Gs, Gs^Ft, Gs^Ft, Rmo, Car, Gs, Gd^Fts, Gd^Fts, Gd^Fts, Gd, Gs^Es, Gs^Es, Gs, Xar, Xar, Gs^Var, Xar, Xar, Gd^Fts, Gd, Gd^Es, Gd^Es, Gs, Gs, Gd, Xar, Gd, Xar, Gs, Gs^Es, Gd^Es, Ds, Wwt, Wwt, Wwt, Ds, Gd^Es, Gs, Gs, Xar, Xar, Xar, Xar, Gs, Gs^Es, Gd, Gd, Gll, Gd, Gd
Gd^Fts, Gll, Gd^Fts, Gd^Fts, Xar, Xar, Xar, Xar, Gs, Gs, Gs^Ft, Gd^Fts, Gs, Gs, Car, Re, Rmo, Rmo, Rmo, Gs^Var, Kar, Kar, Rmo, Rmo, Wwt, Wwt, Wwt, Wwt, Ds, Gd, Re, Rmo, Re, Gs^Ft, Rmo, Rmo, Car, Gd, Gd^Fts, Gd^Fts, Gd^Fts, Gd, Gs, Gs, Gd, Gd^Fts, Gs, Xar, Gs, Gd^Fts, Gs, Gs, Gs^Es, Gs^Es, Gs, Xar, Gs, Gs, Gs, Gd, Gd^Es, Gs^Es, Gd, Ds, Ds, Wwt, Wwt, Ds, Ds, Gd, Gs^Es, Gd, Gs^Var, Xar, Xar, Gs, Gs^Es, Gs^Es, Gs, Gs^Es, Gs^Es, Gs
Gd^Fts, Gll, Gll, Gll, Xar, Xar, Xar, Xar, Gs^Es, Gd, Gd, Gd^Fts, Gs, Car, Rmo, Gs^Ft, Rmo, Rmo, Re^Es, Rmo, Rmo, Rmo, Rmo, Kar, Ds, Wwt, Wwt, Wwt, Ds, Gs^Ft, Gs^Ft, Rmo, Rmo, Rmo, Gs^Var, Gs^Ft, Gs^Ft, Car, Gd^Fts, Gs, Gd^Fts, Gs, Gs^Es, Gs^Es, Gd^Es, Gs, Gd^Fts, Gd^Fts, Gd^Fts, Gs, Gs, Gd^Fts, Gd, Gs, Gs, Gs^Es, Gs^Es, Gd, Gs^Es, Gs, Gs, Gs^Es, Gs, Gd, Ds, Wwt, Wwt, Wwt, Ds, Gd, Gs^Es, Gs, Gs^Ft, Xar, Xar, Gs, Gs, Gs, Gs^Var, Gs, Gd, Gs^Es
Gs^Ft, Gs^Ft, Gll, Gd^Fts, Xar, Xar, Gd^Fts, Gd, Gs^Es, Gs^Es, Gs^Es, Gs, Gs, Car, Car, Rmo, Rmo, Rmo, Gs^Ft, Kar, Rmo, Kar, Car, Car, Car, Kar, Wwt, Wwt, Ds, Car, Rmo, Rmo, Rmo, Re^Es, Hhd, Gs^Ft, Hhd, Car, Gd, Gs, Gd^Fts, Gd, Gs, Gs, Gd^Es, Gd^Fts, Gs, Gs^Ft, Gd^Fts, Gd^Fts, Gd^Fts, Gd, Hhd^Fts, Hhd, Gs, Gs, Gs, Gd, Gd, Gs, Xar, Gs, Gs^Es, Gd, Ds, Wwf, Wwf, Wwf, Ds, Gd, Gd^Es, Gd^Fts, Xar, Xar, Xar, Gd^Es, Re^Vct, Gs, Gs, Gs, Gd, Gs
Gd, Gd, Gd, Gd^Fts, Gd^Fts, Gd^Fts, Gs^Ft, Gd, Gs, Gs^Es, Gs, Gs^Es, Gs, Gd, Car, Gs^Ft, Rmo, Rmo, Gs^Ft, Kar, Rmo, Rmo, Car, 2 Kar, Car, Ds, Wwt, Wwt, Car, Kar, Car, Gs^Ft, Re, Rmo, Re, Hhd, Re^Es, Car, Kar, Gs, Gd, Gd, Gs, Gs, Gd, Gs, Gd^Fts, Gs^Ft, Gs, Gs, Gs, Gd, Gs, Hhd, Gs, Gs, Xar, Gd^Fts, Gd, Gs, Gs, Gs, Gd^Es, Gd, Ds, Ds, Wwf, Wwf, Wwt, Ds, Gd, Gs^Ft, Gd^Fts, Xar, Gd^Fts, Gd, Re, Gs^Es, Gs, Gd, Gs, Gs
Gs^Es, Gs, Gs^Es, Gs, Gd, Gs^Ft, Gd, Gs, Gd, Gd^Es, Gs^Ft, Gs^Es, Gs^Es, Car, Rmo, Gs^Ft, Rmo, Rmo, Re, Kar, Rmo, Kar, Rmo, Car, Rmo, Kar, Ds, Wwt, Wwt, Ds, Ds, Gd, Rmo, Rmo, Rmo, Re^Es, Rmo, Rmo, Rmo, Rmo, Rmo, Gs, Gs, Gs^Es, Gs^Es, Gd^Fts, Gd^Fts, Gs, Gd^Fts, Gd^Fts, Gd, Gs^Es, Gs^Es, Gs, Gs, Gd^Fts, Gs^Ft, Gd^Fts, Gs, Gs, Gd, Gd^Es, Ds, Ds, Wwt, Wwt, Wwt, Wwt, Wwt, Ds, Gd, Gs^Es, Ce, Gs, Ce, Re, Gs, Re, Re, Gs^Es, Gs^Es, Gs
Gd, Gs^Es, Gs, Gs^Es, Gs, Gd, Gs^Es, Gs^Es, Gs, Gd^Fts, Gs, Gs, Gs^Es, Car, Car, Rmo, Rmo, Rmo, Rmo, Rmo, Kar, Rmo, Rmo, Kar, Rmo, Rmo, Kar, Wwt, Wwt, Wwt, Rmo, Rmo, Car, Car, Car, Rmo, Rmo, Rmo, Rmo, Rmo, Rmo, Rmo, Rmo, Gs, Gs, Gd, Gd, Gs, Gs, Gd, Gs, Gs^Es, Gs, Gs^Es, Gd, Gd, Gd, Gs, Gs, Gs^Var, Gd, Ds, Wwt, Wwt, Wwt, Wwt, Wwt, Wwt, Ds, Ds, Gd^Es, Gs^Es, Gs, Ce, 4 Ke, Ce, Re, Gd, Re^Vct, Re, Gd, Gs
Gs, Gd, Gd, Gd^Es, Gs, Gs^Es, Gd, Gs^Es, Gs, Gs, Gs, Gs, Gs^Es, Gs, Car, Gs^Ft, Rmo, Rmo, Gd, Re, Hhd, Kar, Kar, Rmo, Kar, Kar, Ds, Wwt, Wwt^Bab/, Wwt^Bab/, Wwt^Bab/, Rmo, Car, Kar, Car, Rmo, Gs^Es, Re, Kar, Gs, Gs, Rmo, Rmo, Rmo, Rmo, Gs, Rmo, Rmo, Rmo, Rmo, Rmo, Rmo, Rmo, Rmo, Rmo, Rmo, Rmo, Rmo, Rmo, Car, Kar, Ds, Wwt, Wwt, Wwt, Wwt, Ds, Ds, Gd, Gd^Es, Re^Vct, Gs, Ce, Ce, Ce, Ce, Gs^Es, Re, Gs, Re, Gs, Gs
Gd, Gs^Es, Gs, Gs, Gd, Gs^Es, Gs, Gd, Gs^Var, Gs, Gs^Ft, Gs, Gs^Es, Car, Rmo, Gs^Ft, Rmo, Rmo, Rmo, Hhd, Hhd, Gs^Var, Gs^Es, Rmo, Gs, Gd, Rmo, Wwt^Bab/, Wwt^Bab/, Wwt^Bab/, Wwt, Rmo, Rmo, Car, Rmo, Rmo, Gs^Ft, Car, Gs^Ft, Gs, Gs^Es, Gs, Gs, Rmo, Rmo, Rmo, Rmo, Rmo, Rmo, Rmo, Rmo, Rmo, Rmo, Rmo, Rmo, Rmo, Rmo, Rmo, Rmo, Rmo, Rmo, Wwt, Wwt, Wwt, Ds, Ds, Gd, Gd, Gs^Es, Gs, Gd^Es, Gs, Gs^Es, Gd, Re, Re, Rmo, Ce, Re, Re, Re^Vct, Gs
Gs^Ft, Gd^Es, Gd, Gs, Gd^Fts, Gd, Gd^Es, Gs, Gs, Gd, Gs, Gs^Es, Gs, Car, Car, Rmo, Gs^Var, Rmo, Rmo, Rmo, Rmo, Gd, Re^Es, Rmo, Rmo, Rmo, Rmo, Wwt^Bab/, Wwt, Wwt, Wwt, Gs^Ft, Re, Rmo, Re, Gs^Ft, Car, Car, Gs^Ft, Gd^Fts, Gd, Gs, Gs^Es, Gs, Gs, Rmo, Gs, Gd, Gd, Gs, Gd, Gs, Gs^Es, Gs, Gs, Gs, Gs, Gs, Gs, Rmo, Rmo, Wwt^Bab\, Wwt^Bab\, Wwt, Kar, Gd, Gs, Gs^Es, Gs, Gd, Gd, Gs, Gs, Gd, Rmo, Rmo, Ce, Ce, Ce, Gs, Gd, Gs
Gs^Ft, Gll, Gll, Gd^Fts, Gll, Gd^Fts, Gd, Gs^Es, Gs^Es, Gs, Gs, Gs, Gs, Gs, Car, Gs^Ft, Gs^Ft, Gd, Rmo, Rmo, Rmo, Rmo, Rmo, Rmo, Rmo, Rmo, Gs^Ft, Wwt, Wwt, Wwt, Wwt, Ds, Gs^Var, Rmo, Rmo, Gs^Es, Car, Gs^Ft, Gll, Gd^Fts, Gd, Gs, Gs, Gs^Es, Gs, Gs, Gd, Gs, Xar, Gd, Xar, Gd, Gs, Gs^Es, Gs^Es, Gd^Fts, Gs, Gs, Gs^Es, Car, Kar, Wwt^Bab\, Wwt^Bab\, Wwt^Bab\, Rmo, Rmo, Rmo, Rmo, Rmo, Rmo, Rmo, Rmo, Rmo, Rmo, Rmo, Rmo, Ce, 3 Ke, Ce, Rmo, Rmo, Gs
Gll, Gll, Gll, Gll^Es, Gll, Gs^Ft, Gd^Fts, Gs, Gs, Gs^Ft, Gs, Gs, Gs, Car, Rmo, Gs^Ft, Rmo, Rmo, Gs^Var, Re, Re, Rmo, Rmo, Rmo, Rmo, Gs^Ft, Gs^Ft, Wwt, Wwt, Wwt, Wwt, Ds, Ds, Gs^Ft, Gs^Ft, Rmo, Gs^Ft, Car, Gs^Ft, Gs^Ft, Gs^Ft, Gd, Gs, Gs^Es, Gd, Xar, Xar, Xar, Xar, Xar, Xar, Gs, Gd, Gd^Es, Gs, Gs^Es, Gs^Es, Gd^Es, Gs, Gd, Ds, Wwt, Wwt, Wwt^Bab\, Rmo, Rmo, Rmo, Rmo, Rmo, Rmo, Rmo, Rmo, Rmo, Rmo, Re, Re, Gs^Es, Ce, Re, Rmo, Rmo, Rmo
Gd^Fts, Gll, Gd^Fts, Gll^Es, Gll, Gs^Ft, Gd, Gs, Gs^Es, Gs^Es, Gs, Gs, Gd, Car, Car, Rmo, Gs^Ft, Rmo, Gd, Hhd, Re, Rmo, Re, Re, Gs^Var, Rmo, Gs^Ft, Ds, Ds, Wwt, Wwt, Wwt, Wwt, Kar, Car, Rmo, Car, Car, Gll, Gll, Gd^Fts, Gs, Gs, Gs, Gs, Gd, Gd^Fts, Gd^Fts, Gd^Fts, Xar, Xar, Xar, Gs, Gs, Gs^Es, Gs, Gs, Xar, Xar, Gd, Ds, Wwt, Wwt, Wwt, Kar, Gd, Gd, Gs, Gd^Fts, Gd^Fts, Xar, Gd, Re, Gs^Es, Ce, Re, Gs, Ce, Gs, Re, Gd, Rmo
Gd^Fts, Gs^Ft, Gll, Gll, Gd^Fts, Gd^Fts, Gd, Gs, Gs^Es, Gs, Gd, Gs^Es, Gd^Es, Gd, Gs, Car, Car, Rmo, Gs^Ft, Gd, Re, Rmo, Re, Hhd^Fts, Gs^Ft, Rmo, Car, Kar, Ds, Wwt, Wwt, Wwt, Wwt, Wwt, Car, Rmo, Car, Gd^Fts, Gs^Ft, Gs^Ft, Gs^Ft, Gs^Ft, Gs, Gs^Es, Gs, Gs, Gs, Gs^Es, Gs^Es, Xar, Xar, Xar, Gs, Gs, Gs, Gd, Gs^Es, Xar, Gs, Gd, Ds, Wwt, Wwt, Wwt, Wwt, Ds, Ds, Gs^Ft, Gs^Ft, Xar, Xar, Xar, Gd^Fts, Ce, 5 Ke, Ce, Re, Re, Re, Re, Gs^Es, Gs
Gs, Gs^Ft, Gs^Ft, Gll, Gd^Fts, Gll, Gd, Gd, Gs, Gd, Gs^Ft, Gs, Gs, Gd^Es, Gs^Es, Gs, Car, Rmo, Car, Gs^Ft, Re, Rmo, Re, Gs^Ft, Car, Rmo, Car, Gd, Gd, Ds, Ds, Wwt, Wwt, Wwt, Wwt, Car, Ds, Gll, Gll, Gll, Gs^Ft, Gd^Fts, Gs, Gs^Es, Gs, Gd, Gd^Fts, Gs, Gs^Es, Gs^Var, Xar, Xar, Xar, Gd^Fts, Gs, Gd, Gs, Gs, Gs, Gd, Ds, Wwt, Wwt, Wwt, Wwt, Wwt, Ds, Gd^Fts, Gs^Ft, Xar, Xar, Xar, Gs^Ft, Ce, Ce, Ce, Ce, Re, Re, Re^Vct, Gs, Gs^Es
Gd^Fts, Gd^Fts, Gll, Gd^Fts, Gll, Gs^Ft, Gs^Es, Gs^Es, Gs^Ft, Gd^Fts, Gll, Gs^Ft, Xar, Gs, Gs, Gs^Es, Gs^Es, Car, Gs, Car, Rmo, Rmo, Rmo, Car, Gs, Car, Gs, Gs, Gs^Es, Gd, Ds, Wwt, Wwt, Wwt, Wwt, Wwt, Ds, Gs^Ft, Gd^Fts, Gs, Gd, Gd, Gs^Es, Gs^Es, Gs^Es, Gs, Gd^Fts, Gd^Fts, Gs, Gd^Fts, Xar, Xar, Xar, Gll, Gs^Ft, Gd, Gs, Gs^Es, Gs^Es, Gd, Gd, Ds, Ds, Wwt, Wwt, Wwt, Ds, Gd, Gd^Es, Gs, Gd, Xar, Gd, Gd^Fts, Ce, Gd, Hhd, Gs, Hhd, Gs^Es, Gd, Gd
Gd^Fts, Gd^Fts, Gll, Gd^Fts, Gd^Es, Gd, Gs^Es, Gs, Gs^Ft, Gd, Xar, Xar, Xar, Xar, Gs^Ft, Gs^Es, Gd, Gs^Es, Gs, Kar, Rmo, Rmo, Rmo, Kar, Gs, Gs^Es, Gs^Es, Gs, Gs, Gd, Gd, Ds, Ds, Wwt, Wwt, Wwt, Ds, Gd, Gd, Gs, Gs^Es, Gs^Es, Gs, Gs, Gs^Es, Gd, Gd, Gs, Gd^Fts, Gd^Fts, Xar, Xar, Gs^Ft, Gd, Gll, Gd^Fts, Gs, Gs, Gs, Gs, Gs, Gd, Ds, Wwt, Wwt, Wwt, Wwt, Ds, Ds, Gd^Es, Gs^Es, Gs, Re^Vct, Gs^Es, Gs, Gd, Hhd, Hhd, Hhd, Gs, Gd^Es, Gd^Fts
Gs^Ft, Gs^Ft, Gd, Gd, Gs^Es, Gs, Gs, Gd, Gd^Fts, Gll, Xar, Xar, Xar, Xar, Gll, Gd^Fts, Gd, Gs^Es, Gs^Es, Gs^Es, Rmo, Rmo, Rmo, Gs, Gd, Gs, Gd, Gd, Gd^Fts, Gll^Es, Gs^Es, Gd, Ds, Wwt, Wwt, Wwt, Wwt, Ds, Ds, Gd, Gs, Gs, Gd, Gd, Gd, Gs^Es, Gs^Es, Gd, Xar, Xar, Xar, Xar, Gll, Gs^Es, Gd^Fts, Gd^Fts, Gd, Gs, Gd^Es, Gs, Gs, Gd, Ds, Wwt, Wwt, Wwt, Wwt, Wwt, Ds, Gd, Gd, Gs, Gs, Gs, Gs, Hhd, Hhd, Hhd, Hhd, Gd, Gs, Gs
Ds, Gd, Gd, Gs^Es, Gs, Gs^Var, Gs, Gd, Gd, Gd^Fts, Gd, Gd^Fts, Xar, Xar, Gd^Es, Gd^Fts, Gs, Gs, Rmo, Rmo, Rmo, Rmo, Gd, Gd, Gd^Fts, Gd, Gll, Gll, Gll, Gd^Fts, Gd^Fts, Gd, Ds, Wwt, Wwt, Wwt, Wwt, Wwt, Ds, Gd, Gll, Gs^Ft, Gd^Fts, Gs^Ft, Gs^Ft, Gs, Gs^Es, Gd, Gd, Xar, Gs^Ft, Gd^Fts, Gd^Fts, Gll^Es, Gd^Fts, Gs^Ft, Gd, Gs, Gs, Gs, Gs, Gd^Es, Gd, Ds, Ds, Wwt, Wwf, Wwf, Wwt, Ds, Gd, Gs, Gs^Ft, Gs, Gd, Gs^Es, Gs, Hhd, Hhd, Gs, Gs^Ft, Gd^Fts
Wwt, Ds, Ds, Gd, Gd, Gs, Gs^Es, Gs, Gs, Gs, Gs, Gd^Fts, Gll, Gd^Fts, Gll, Gs^Ft, Gd, Gs, Rmo, Rmo, Gd, Gd, Gd^Fts, Gll, Gll^Es, Gs^Var, Gll, Gll, Gs, Gll, Gd^Fts, Gd, Ds, Wwt, Wwt, Wwt, Wwt, Wwt, Wwt, Ds, Gd^Fts, Gs^Ft, Gll, Gd^Fts, Gll, Gd, Gd, Gs^Es, Gs, Gd^Fts, Gs^Ft, Gs, Gll, Gs^Es, Gd^Fts, Gs^Ft, Gd, Gd, Gs, Hhd, Hhd, Gs, Gd^Fts, Gd, Gd, Ds, Wwt, Wwt, Wwt, Ds, Gd, Gd^Fts, Xar, Xar, Xar, Gd, Gd^Es, Gs, Gd, Gs, Gd, Gd^Fts
Wwt, Wwt, Wwt, Ds, Ds, Gd, Gd, Gd^Es, Gd^Es, Gs, Gs^Es, Gd^Fts, Gs^Ft, Gd^Fts, Gd^Fts, Gs^Ft, Rmo, Rmo, Rmo, Rmo, Gd^Fts, Gd^Fts, Gll, Gll, Gs, Gll, Gd^Fts, Gd^Fts, Gd^Fts, Gd^Fts, Gll, Gd, Ds, Wwt, Wwt, Wwt, Wwt, Wwt, Wwt, Ds, Gd, Gs^Ft, Gd^Fts, Gll, Gd^Fts, Gs^Ft, Gs, Gs, Gs, Gd, Gs, Gd^Fts, Gs, Gs, Gd^Fts, Gs, Gd, Gs^Es, Hhd, Hhd, Hhd^Fts, Hhd^Fts, Gd^Fts, Gd^Fts, Gd, Ds, Wwt, Wwt, Wwt, Ds, Gd^Es, Gd^Fts, Xar, Xar, Xar, Xar, Gs^Var, Gs^Es, Gs^Es, Gs^Es, Gs, Gd
Wwt, Wwt, Wwt, Wwt, Wwt, Ds, Ds, Ds, Ds, Gd, Gd, Gd, Gd, Gs^Ft, Rmo, Rmo, Rmo, Rmo, Gs, Gs, Gd^Fts, Gll, Gd^Fts, Gd^Fts, Gll, Gd^Fts, Gll, Gll, Gd^Fts, Gll, Gd^Es, Gd, Ds, Wwt, Wwt, Wwt, Wwt, Wwt, Wwt, Ds, Ds, Gd, Gs^Ft, Gd^Fts, Gll, Gll, Gd^Fts, Gs^Var, Gd, Gs, Gs^Es, Gd, Gd, Gs^Ft, Gs, Gd, Gs^Es, Gs, Hhd, Hhd^Fts, Hhd, Hhd^Fts, Gd^Fts, Gd, Ds, Ds, Wwt, Wwt, Wwt, Ds, Gd^Es, Gs^Ft, Gs^Ft, Xar, Xar, Xar, Xar, Gs, Gs, Gd^Es, Gd^Es, Gs
Wwt, Wwt, Wwt, Wwt, Wwt, Wwt, Wwt, Wwt, Wwt, Ds, Ds, Gd^Es, Rmo, Rmo, Rmo, Rmo, Gd, Gd, Gd^Fts, Gd^Fts, Gll, Gll, Gll, Gll^Es, Gs, Gll^Es, Gd^Fts, Gs, Gll, Gll, Gd^Es, Ds, Wwt, Wwt, Wwt, Wwt, Wwt, Wwt, Wwt, Wwt, Wwt, Ds, Gd, Gd, Ds, Gs^Ft, Gd^Fts, Gs^Ft, Gd, Gs, Gs, Gs^Es, Gs^Es, Gs, Gs, Gs^Es, Gs, Gs, Gs, Hhd, Gs, Gs, Gd, Gd, Ds, Wwt, Wwt, Wwt, Wwt, Ds, Gd, Gs, Gd, Gd^Fts, Xar, Xar, Xar, Gd^Fts, Gs, Gs^Es, Gs, Gs
Ds, Wwt, Wwt, Wwt, Wwt, Wwt, Wwt, Wwt, Wwt, Wwt, Rmo, Rmo, Rmo, Rmo, Gs, Gs, Gd^Fts, Gd^Fts, Gll, Gll, Gd^Fts, Gd^Fts, Gd^Fts, Gll, Gd^Fts, Gll, Gll, Gll, Gd, Gd^Es, Ds, Ds, Wwt, Wwt, Wwt, Wwt, Ds, Wwt, Wwt, Wwt, Wwt, Ds, Ds, Ds, Wwt, Ds, Ds, Gd, Ds, Gd, Gd, Gd, Gd, Gs^Es, Gs^Es, Gs, Gd^Fts, Gd^Fts, Gd^Fts, Gs^Es, Gs^Es, Gd^Es, Ds, Ds, Wwt, Wwt, Wwt, Wwt, Ds, Ds, Gd, Gs^Es, Gd^Fts, Gd^Fts, Xar, Xar, Xar, Gd^Fts, Gs^Ft, Gs, Gs, Gd^Es
Rb, Ds, Ds, Wwt, Wwt, Wwt, Wwt, Wwt, Wwt^Bab/, Wwt^Bab/, Wwf^Bab/, Rmo, Rb, Gd, Gs, Gd^Es, Gs^Es, Gd^Fts, Gs, Gll, Gd^Fts, Gll, Gd^Fts, Gd^Fts, Gll, Gll, Gg, Gd, Ds, Ds, Wwt, Wwt, Wwt, Wwt, Wwt, Ds, Ds, Ds, Ds, Wwt, Wwt, Wwt, Wwt, Wwt, Wwt, Wwt, Wwt, Ds, Wwt, Ds, Ds, Ds, Gd, Gs, Gs, Gs, Gs, Gd^Fts, Gs, Gs, Gs, Gd, Ds, Wwt, Wwt, Wwt, Wwt, Wwt, Ds, Gd, Gs^Es, Gs, Gd^Fts, Xar, Xar, Xar, Gd^Fts, Gd^Fts, Gd^Fts, Gs^Ft, Gs, Gs
