border_size=1
usage=map

Xar, Xar, Xar, Xar, Xar, Xar, Xar, Xar, Xar, Xar, Gd^Fts, Gd, Gd^Fts, Gd, Gs, Gs, Gs^Es, Gd^Fts, Gs, Gd^Fts, Gd^Fts, Gd, Gd^Fts, Gd^Fts, Gd, Gd^Fts, Gd, Gd^Fts, Gd^Fts, Gs, Gd^Fts, Hhd, Md, Md, Md, Md, Md^Xm, Md, Md, Md, Md, Md, Md, Md^Xm, Md^Xm, Md^Xm, Md, Md, Md, Md, Hhd^Fts, Gd^Fts, Gd^Fts, Gs, Gd^Fts, Gd^Fts, Gd^Fts, Hhd^Fts, Md, Md, Md, Md, Md, Md, Md^Xm, Md, Md^Xm, Md^Xm
Gd^Fts, Gd^Fts, Gd^Fts, Gd^Fts, Gd^Fts, Xar, Gd^Fts, Gd^Fts, Gd^Fts, Gd^Fts, Gd, Gd, Gs, Gs, Wwt, Wwt, Wwt, Gs, Gs, Gs, Gs^Es, Gd, Gs, Gs, Gd^Fts, Gd, Gs, Gd, Gll, Gs, Gd, Hhd^Fts, Hhd, Md, Md, Md, Md, Md, Md^Xm, Md^Xm, Md^Xm, Md, Md, Md, Md, Md, Md, Md, Md, Md, Hhd, Gll, Gd^Fts, Gd, Gd, Gd, Gs, Hhd^Fts, Hhd, Hhd, Hhd^Fts, Md, Md, Md, Md, Md, Md, Md^Xm
Gd, Gd, Gd, Gd^Fts, Gd, Gd^Fts, Gd, Gd, Gd, Gd, Gs, Gs^Es, Gs, Wwt, Wwt, Wwt, Wwt, Wwt, Wwt, Gs^Es, Gs, Gs, Gs, Gs, Gd, Gd, Gs, Gd^Fts, Gd^Fts, Gd^Fts, Gs^Es, Gs, Gs, Hhd, Md, Md, Md, Md, Md, Md, Md, Md, Md, Md, Md, Md, Md, Md, Md, Hhd^Fts, Gd^Fts, Gd, Gs, Gs, Gd, Gs, Gd, Gs, Gs, Gs, Gd^Fts, Hhd^Fts, Hhd, Md, Md, Md, Md, Md^Xm
Wwt, Gs, Gs, Gd, Gs^Es, Gd, Gs, Gs, Wwt, Wwt, Wwt, Wwt, Wwt, Wwt, Wwt, Gd^Fts, Gd^Fts, Wwt, Wwt, Wwt, Wwt, Gs, Gs, Gs, Gs^Es, Gs, Kar, Gd, Gd, Gs, Gd, Gs, Gd, Hhd, Hhd^Fts, Md, Md, Md, Md, Md, Md, Md, Hhd, Hhd^Fts, Hhd^Fts, Hhd^Fts, Hhd, Md, Hhd, Hhd^Fts, Gll, Gll, Gd, Gd, Gs, Gs^Es, Gd, Gs, Gs, Gs, Gd^Fts, Gd, Gll, Hhd, Md, Md, Md, Md^Xm
Wwt, Wwt, Wwt, Gs, Wwt, Gs, Wwt, Wwt, Wwt, Wwt, Wwt, Wwt, Wwt, Wwt, Gd, Gd^Fts, Gs, Gd, Gs, Wwt, Wwt, Wwt, Re, Gs, Re^Es, Gd, Gs^Es, Gs, Gs, Gs^Var, Gd, Gs, Gd, Gd, Gs, Hhd^Fts, Hhd, Md, Md, Md, Hhd, Hhd^Fts, Gd, Gd^Fts, Gd, Gll, Gs, Hhd, Gs, Gs, Gd, Gs, Gs^Var, Gs^Es, Gs, Gd, Gd, Gs, Gs^Var, Gd, Gs, Gd, Gd^Fts, Hhd^Fts, Hhd^Fts, Md, Md, Md
Gs, Wwt, Wwt, Wwt, Wwt, Wwt, Wwt, Wwt, Ce, Ce, Ce, Gs, Gs, Gs, Gs, Gd, Gd, Gs, Gs, Gs, Wwt^Bab/, Wwt^Bab/, Wwt, Re, Gs, Re, Re^Es, Re, Re, Gs, Re, Gs^Es, Re^Es, Gs, Re, Gd, Gd, Hhd, Hhd, Hhd^Fts, Gs, Gd^Fts, Gd, Gs, Gd^Fts, Gd^Fts, Gd^Es, Gs^Es, Gs, Gs, Gs, Gd, Gs, Gs, Hhd, Gs, Hhd, Gd, Gs, Gs, Gs^Es, Gll, Gd, Gs, Hhd^Fts, Md, Md, Md
Gs^Es, Gs, Gd, Wwt, Re, Wwt, Gd, Gd, Gd, Ke, Gd, Gs^Es, Gs, Gd^Es, Gs^Es, Gs^Es, Re, Re, Re, Re, Gs, Wwt, Wwt, Wwt, Wwt, Gs, Gs, Gs, Gd, Re, Gs^Es, Re, Gs, Re, Gs, Re, Re, Gs, Gs, Gs, Gd, Gd^Fts, Gs, Gd^Fts, Hhd^Fts, Gd^Fts, Gd^Es, Gs, Gd, Gs, Gs^Es, Gs, Gs, Hhd, Hhd, Hhd, Hhd, Hhd, Gd, Gs, Gs, Gd, Gd^Fts, Gd^Fts, Gll, Hhd, Md, Md
Gs^Es, Gd^Es, Re, Re, Gd^Fts, Re, Gs^Es, Gs, Ce, Ke, Ce, Gd, Gd, Gs, Re, Re, Gs, Gd^Es, Gs, Gd, Gs, Gd, Gs^Es, Wwt, Wwt, Wwt, Wwt, Gs, Gs, Gs, Gd, Gs, Gs, Gd, Hhd, Gs, Gd^Es, Re^Es, Gs, Gs^Es, Gd, Gd, Gs, Hhd^Fts, Md, Hhd, Hhd^Fts, Gs^Es, Gs, Gd, Kar, Car, Car, Hhd, Hhd, Hhd, Hhd, Hhd, Gs, Gs, Gd, Gd^Fts, Gd^Fts, Gll, Gd, Hhd, Hhd^Fts, Hhd^Fts
Re, Re, Gs, Gd^Fts, Xar, Re, Re, Gd, Gs, Ce, Gs, Gs, Gd, Re, Gd, Gs, Hhd, Gs, Gs, Gd^Es, Gd^Es, Gs, Gd^Es, Gs, Gs, Wwt, Wwt, Wwt, Gs, Gs, Gd^Es, Gs, Gd, Hhd, Hhd, Gs, Gs, Re, Gd^Fts, Gs, Gs^Var, Gs, Gs, Hhd, Md, Md, Md, Hhd, Gs, Gs, Gs, Car, Kar, Car, Hhd, Hhd, Hhd, Gs, Gs, Gs, Gs, Gd, Gs, Gd, Gd^Fts, Gll, Gd^Fts, Gd^Fts
Gd, Gs, Xar, Xar, Gd^Fts, Gd, Re, Gd, Gd, Gs, Gs^Es, Gs^Es, Re, Re^Es, Gd, Gd^Fts, Hhd^Fts, Hhd, Gs, Gs, Gs^Es, Gs, Gs, Gs, Gs, Xar, Wwt, Wwt, Gd, Gs, Gs, Gs, Gd, Hhd, Hhd, Hhd, Gs, Re, Gd, Gd, Gs^Es, Gs^Es, Gs, Hhd, Md, Md, Md, Hhd, Gs, Gd, Kar, Car, Car, Car, Hhd, Hhd, Gs, Gs, Gd, Gs^Es, Gs, Gs, Wwt, Gs, Gll, Gd^Fts, Gd, Gd
Gd, Gd^Fts, Xar, Gd^Fts, Gd^Fts, Gs, Ce, Ce, Ce, Re, Re, Re, Gs, Gd^Es, Gs, Gd^Fts, Hhd, Hhd^Fts, Hhd, Gd, Gs, Gd, Gd, Gd, Gs, Wwt, Wwt, Wwt, Gd^Fts, Gs, Gd, Gs^Es, Gs^Var, Hhd, Hhd, Hhd, Gs, Re, Re, Gs, Gs, Gd, Gd^Fts, Hhd^Fts, Hhd, Hhd, Hhd^Fts, Hhd^Fts, Gs, Gs, Re, Car, Gs, Gs, Hhd, Hhd, Gs, Gs^Var, Gs, Gs, Wwt, Wwt, Wwt, Wwt, Wwt, Gll, Gs, Gs
Gd, Gd^Fts, Gd^Fts, Xar, Gs, Gd, Ce, 1 Ke, Ce, Gs, Gd, Xar, Gs, Gs, Gs, Gs, Gs, Hhd^Fts, Gd^Fts, Gd, Gs, Gs^Es, Gs, Gd, Gs, Wwt, Wwt, Xar, Gd^Fts, Gd^Fts, Gs, Gs^Es, Gs, Gs, Gs, Gs, Gd^Es, Gd, Gs, Re, Re, Gs, Gd, Gd^Fts, Gs, Gs, Gs, Gd^Fts, Gll, Re, Gs^Var, Gd, Gs, Gs^Es, Gs, Gs, Gd^Es, Gd^Es, Wwt, Wwt, Wwt, Wwt, Gs, Wwt, Wwt, Wwt, Wwt, Wwt
Gd, Gd^Es, Gd, Xar, Gs, Ce, Ke, Ce, Gs, Gd, Gd^Fts, Gd^Fts, Gd, Gd, Gd^Es, Gd, Gs, Gd^Fts, Gs, Gd, Gs, Gs^Es, Gs, Gs, Gs, Wwt, Wwt, Xar, Xar, Gd^Fts, Gs, Gs, Gd^Fts, Gs, Gs, Gs, Gs, Gs, Gd, Gd^Fts, Gd^Fts, Re, Re^Es, Gd^Es, Re, Re, Re, Gd^Es, Re^Es, Re, Gs^Es, Gd, Re, Gs^Es, Re, Gs, Kar, Gs, Wwt, Wwt, Gs, Gd, Gs, Gd, Gs, Wwt, Wwt, Wwt
Hhd, Gs, Gd^Es, Gd^Fts, Gd, Ce, Ce, Ce, Gs^Es, Gd, Gd^Fts, Xar, Gd^Fts, Gd^Fts, Gs, Gs, Gs^Es, Gd, Gs, Gs^Var, Gs^Es, Gs, Gd, Gs, Gs, Wwt, Wwt, Wwt, Wwt, Gd, Gd^Fts, Gd, Gd^Fts, Gd, Gs, Gs^Es, Gd, Gd, Gll, Gd, Gd^Fts, Gs, Gs, Re, Gd^Fts, Gd, Gd, Re^Es, Gs, Re, Re^Es, Re^Es, Gs, Re, Kar, Re, Wwt^Bab\, Wwt, Wwt, Wwt, Gs, Gs, Gd, Gs, Hhd, Gd, Gd^Fts, Gd^Fts
Hhd^Fts, Hhd, Gll, Gd^Fts, Hhd^Fts, Gd, Gs, Re, Gd, Gs, Gs, Gs, Gd, Xar, Gs, Gs, Gd^Es, Gs, Gs^Es, Gd, Gd^Es, Gd, Gs^Es, Gs^Es, Gd, Gd^Fts, Gd^Fts, Wwt, Wwt, Gs, Xar, Gd^Fts, Gs, Gd, Gs^Es, Gs, Gs, Gd^Fts, Hhd^Fts, Hhd, Hhd^Fts, Hhd^Fts, Hhd, Hhd^Fts, Hhd^Fts, Gd^Fts, Gd, Gs, Wwt, Gs, Wwt, Gs, Gs, Gs, Wwt, Wwt, Wwt, Wwt^Bab\, Re, Gs, Gd, Gd^Fts, Hhd^Fts, Hhd, Md, Hhd, Hhd^Fts, Hhd^Fts
Gd^Fts, Hhd, Hhd, Hhd^Fts, Gs, Gs, Gs, Re, Gs^Es, Gd, Gd, Gs, Gs^Es, Gs, Gs, Gd, Gs, Gs^Es, Gs, Gs, Gd, Gs, Gs, Gs^Es, Hhd^Fts, Hhd^Fts, Hhd^Fts, Wwt, Wwt, Xar, Wwt, Xar, Wwt, Wwt, Wwt, Gs, Gd^Fts, Hhd, Md, Md, Md, Md, Md, Md, Hhd^Fts, Gd^Fts, Wwt, Wwt, Wwt, Wwt, Wwt, Wwt, Wwt, Wwt, Wwt, Wwt, Gs^Es, Gs, Gs, Re, Gd, Gd^Fts, Hhd^Fts, Md, Md, Md, Md, Hhd^Fts
Gd, Gd, Gd, Hhd, Gs, Gs, Gs^Es, Re, Re, Gs, Gd, Gs, Gd, Gd, Gs, Gd, Gs, Gs, Gs^Es, Gd, Gd^Fts, Gd^Fts, Hhd, Hhd, Md, Md, Md, Wwt, Wwt, Wwt, Wwt, Wwt, Wwt, Wwt, Wwt, Wwt, Hhd^Fts, Hhd^Fts, Md, Md, Md^Xm, Md, Md, Md, Wwt, Wwt, Wwt, Wwt, Gd^Fts, Wwt, Gd^Fts, Wwt, Wwt, Wwt, Gs, Gs, Gd, Gs, Gs^Var, Re^Es, Gs, Hhd^Fts, Md, Md, Md, Md, Md, Md
Gs^Es, Gs, Gd, Gd^Es, Gs, Gd^Es, Gs, Gs, Gs, Re, Gd, Gd^Fts, Gd^Fts, Gd^Fts, Gs, Gd^Es, Gs^Es, Gs, Gs, Gs, Gs, Hhd^Fts, Md, Md, Md, Md, Md, Md, Md, Wwt, Hhd^Fts, Wwt, Hhd^Fts, Hhd, Wot, Wwt, Md, Md, Md^Xm, Md, Md, Md^Xm, Md^Xm, Md, Wwt, Wwt, Gd, Gd^Fts, Hhd^Fts, Hhd^Fts, Hhd, Gd^Fts, Hhd^Fts, Gd^Fts, Gd^Fts, Gd^Fts, Gd, Gs, Gd, Re, Gs^Es, Hhd, Hhd, Md, Md, Md, Md, Md
Gs, Gs, Gs, Gs, Wwt, Gs, Gs, Gs, Gs, Re, Re, Gs, Gs, Gll, Gs, Gs, Gd, Gd, Gd, Gd, Hhd^Fts, Hhd^Fts, Md, Md, Md, Md, Md, Md, Md, Md, Md, Hhd^Fts, Md, Wot, Wot, Md, Md, Md, Md^Xm, Md, Md^Xm, Md^Xm, Md, Md^Xm, Wwt, Wwt, Wwt, Gd^Fts, Hhd^Fts, Md, Md, Hhd^Fts, Md, Hhd^Fts, Hhd^Fts, Hhd^Fts, Hhd, Gd^Fts, Gs, Re^Es, Gs^Es, Gs, Hhd^Fts, Md, Md, Md, Md, Md
Wwt, Gs, Wwt, Wwt, Wwt, Wwt, Wwt, Wwt, Wwt, Gs, Gs, Re, Gd, Gd^Fts, Gs, Gd^Fts, Gd^Fts, Gd^Fts, Hhd^Fts, Hhd, Md, Md, Md, Md, Md, Md^Xm, Md, Md^Xm, Md^Xm, Md, Md^Xm, Md, Md, Md, Md, Md, Md^Xm, Md^Xm, Md^Xm, Md^Xm, Md^Xm, Md, Md, Md^Xm, Md, Wwt, Wwt, Gd^Fts, Hhd^Fts, Md, Md, Md, Md, Hhd^Fts, Md, Md, Md, Hhd^Fts, Gd^Fts, Re, Gd, Gs, Gd^Fts, Hhd^Fts, Md, Md, Md, Md
Wwt, Wwt, Wwt, Wwt, Gd^Fts, Wwt, Wwt, Wwt, Wwt, Wwt, Gs^Var, Re, Re, Gd, Gd^Fts, Gd^Fts, Gd, Hhd^Fts, Md, Md, Md, Md, Md, Md^Xm, Md, Md, Md, Md^Xm, Md^Xm, Md^Xm, Md^Xm, Md, Md^Xm, Md^Xm, Md, Md^Xm, Md, Md, Md, Md, Md, Md, Md, Md, Hhd^Fts, Wwt, Wwt, Wwt, Gd^Fts, Hhd, Md, Md, Md, Md, Md, Md, Hhd, Hhd^Fts, Gs, Re, Gs, Gd, Gd^Fts, Hhd^Fts, Hhd, Md, Md, Md
Wwt, Wwt, Wwt, Wwt, Gd^Fts, Gd^Fts, Gd, Gs^Es, Wwt, Wwt, Wwt, Gd, Re, Gs, Gd^Fts, Gd, Gll, Hhd, Md, Md, Md, Md, Md^Xm, Md^Xm, Md, Md, Md^Xm, Md^Xm, Md, Md, Md, Md^Xm, Md, Md^Xm, Md^Xm, Md^Xm, Md, Md, Md, Md, Md, Md, Md, Md, Hhd, Gd^Fts, Wwt, Wwt, Gd^Fts, Hhd^Fts, Hhd^Fts, Md, Hhd^Fts, Md, Md, Md, Hhd^Fts, Gd^Fts, Re, Re^Es, Re^Es, Gd^Es, Gd, Gd^Fts, Hhd, Md, Md, Md
Gs, Gs, Gs, Gd, Hhd, Hhd^Fts, Hhd, Gd, Gs, Wwt, Wwt, Gs, Gs^Es, Re, Gd, Gd^Fts, Gd^Fts, Hhd^Fts, Hhd^Fts, Md^Xm, Md^Xm, Md^Xm, Md, Md^Xm, Md^Xm, Md^Xm, Md, Md, Md, Md, Md, Md^Xm, Md, Md, Md, Wot, Wwt, Wwt, Wwt, Hhd^Fts, Hhd^Fts, Md, Hhd^Fts, Hhd^Fts, Gd^Fts, Gd, Wwt, Wwt, Gd^Fts, Gd, Gd^Fts, Hhd, Gd^Fts, Hhd^Fts, Hhd^Fts, Hhd, Gs, Re, Gd, Gs, Gs, Re, Re^Es, Gs, Gd^Fts, Hhd^Fts, Hhd^Fts, Md
Gd^Es, Gs, Gs, Hhd, Hhd^Fts, Hhd^Fts, Hhd^Fts, Hhd, Hhd, Wwt, Wwt, Wwt, Gs, Re, Gs^Es, Gll, Wwt, Wwt, Wwt, Hhd^Fts, Md, Md, Md^Xm, Md^Xm, Md, Md, Md, Md, Md, Md, Md, Md, Md, Md, Md, Wot, Wwt, Wwt, Wwt, Gd^Fts, Gd^Fts, Hhd, Gd^Fts, Gd^Fts, Gs, Wwt, Wwt, Wwt, Gd, Gs, Gd^Fts, Gll, Gd^Fts, Gd^Fts, Gd^Fts, Gs, Gs, Re, Gd, Gd^Fts, Gs, Gs, Re, Gs, Gs^Var, Gd, Gd^Fts, Hhd
Gs^Es, Gd, Gs, Hhd, Gd^Fts, Gd^Fts, Hhd^Fts, Hhd, Gs, Gs, Wwt, Wwt, Wwt, Re, Wwt, Wwt, Wwt, Wwt, Wwt, Wwt, Md, Md, Md^Xm, Md, Md, Md, Md, Md, Hhd, Md, Hhd, Md, Hhd^Fts, Hhd^Fts, Hhd^Fts, Wwt, Gd, Wwt, Wwt, Wwt, Gd, Gs, Gd, Gd, Wwt, Wwt, Wwt, Gs, Gs, Gd, Gs, Gd, Gd, Gs, Gs^Es, Gd^Es, Gs^Var, Re, Gd, Gs^Es, Gs, Gd, Re, Gd, Gd, Gd, Gs, Gd^Fts
Gs, Gs, Gs, Gd, Gd, Gd^Fts, Gd, Gs, Gd, Gs, Gs, Wwt, Wwt, Wwt^Bab|, Wwt, Wwt, Gs, Gs, Wwt, Wwt, Wot, Md^Xm, Md, Md, Md, Md, Hhd^Fts, Hhd^Fts, Gd^Fts, Hhd^Fts, Gd, Hhd, Gs, Gd^Fts, Gd, Gd^Fts, Gd^Es, Gd, Wwt, Wwt, Wwt, Gd^Fts, Xar, Wwt, Wwt, Wwt, Gd^Fts, Gs, Gs, Gs, Gs, Gs^Es, Gs, Gs, Gs, Gs, Gd^Fts, Gs, Gs, Gd, Re^Es, Re, Gs, Gd^Es, Gs, Gs, Gs, Gd^Fts
Hhd, Gs, Gd, Gs^Var, Gs, Gd^Es, Gs, Gs^Es, Gs, Gd^Es, Gd, Gs, Car, Wwt^Bab|, Car, Gs, Gd, Gs^Es, Gs^Es, Wwt, Wwt, Hhd^Fts, Md, Md, Hhd^Fts, Hhd, Gd, Kar, Car, Gd^Fts, Gd^Es, Gs, Gs, Gs, Gs, Gd, Gs^Var, Gs^Es, Gd^Fts, Wwt, Wwt, Wwt, Wwt, Wwt, Wwt, Xar, Gd^Fts, Gd, Gs, Gs, Gd, Gs, Hhd, Hhd, Hhd^Fts, Gd^Fts, Gd, Gd, Gd^Fts, Gd, Re^Es, Gs, Gs^Es, Gs^Es, Gd, Gd, Gd^Fts, Gd
Hhd, Hhd, Gd^Fts, Gd, Gd, Gs^Es, Gs, Gs, Gd, Gs, Gs^Es, Gs, Gs^Es, Re, Gd, Gd, Hhd, Gd^Fts, Gd, Wwt, Wwt, Wwt, Wwt, Hhd^Fts, Gd^Fts, Gd, Re, Car, Gs, Gd, Gs, Gs, Gd, Gs^Es, Gd^Es, Gs^Es, Gs, Gd, Gd, Gd^Fts, Xar, Wwt, Wwt, Wot, Wot, Wwt, Gs^Var, Gd^Es, Gs^Es, Gs, Gd, Gd^Fts, Hhd^Fts, Hhd, Hhd^Fts, Gd^Fts, Gs, Gs, Gd^Fts, Gs, Re, Gs^Es, Gs, Gd, Gd^Fts, Gd^Fts, Gd^Fts, Gd
Hhd^Fts, Hhd^Fts, Gd, Gs, Gd^Fts, Gd^Fts, Gd, Kar, Gs, Gs, Gd, Gs, Re, Re, Gd^Fts, Hhd^Fts, Mm, Hhd^Fts, Hhd^Fts, Gd^Fts, Gd^Fts, Wwt, Wwt, Wwt, Wwt, Gd, Re, Gs, Gs, Gs, Gs, Gs, Gd, Gs, Gs^Es, Gd, Gd, Gs, Gd^Fts, Gll, Xar, Wwt, Wwt, Wot, Wot, Wwt, Wwt, Gs, Gs, Gs, Gs^Es, Gd^Fts, Gd, Gd, Hhd, Hhd, Gs, Gs, Re, Re, Gs, Gd, Gd, Gs, Gd^Fts, Gd^Fts, Hhd, Hhd^Fts
Hhd^Fts, Gd^Fts, Gd, Gs, Gd^Fts, Kar, Car, Car, Car, Kar, Re, Re, Gs^Var, Gd, Gd^Fts, Hhd^Fts, Mm, Mm, Hhd, Gll, Gd^Fts, Gd, Gs, Wwt, Wwt, Gs, Re, Gs, Gd^Fts, Gll, Gd^Fts, Gs, Gd, Gs, Gs^Es, Gs, Gd, Gd^Fts, Gd^Fts, Gd^Fts, Gs, Xar, Wwt, Wwt, Wot, Wot, Wwt, Gs, Gs, Gs, Gs^Es, Gs^Es, Gd^Fts, Hhd^Fts, Hhd, Hhd, Gs^Es, Re, Gd^Es, Gs, Gd^Fts, Gd, Gd^Fts, Gd^Fts, Gd, Gll, Hhd^Fts, Md
Gd^Fts, Gd^Fts, Gs, Gs, Gd, Gd^Fts, Car, Kar, Car, Re, Gs^Es, Gd^Es, Gd^Fts, Gd^Fts, Hhd^Fts, Hhd, Mm, Mm, Mm, Hhd, Gll, Gd^Fts, Wwt, Wwt, Wwt, Gs, Re, Gs, Gd^Es, Gd, Gd^Fts, Gs, Gd, Gs, Gs, Gd, Gs, Gd, Gs, Gd^Fts, Gs, Gs^Es, Gs, Wwt, Wwt, Wwt, Wwt, Wwt, Gs, Gs, Gs, Gs, Gd, Gd^Fts, Gs, Gs^Es, Gs, Re, Gs^Es, Gd, Gd^Fts, Gd^Fts, Gll, Gd^Fts, Hhd^Fts, Hhd^Fts, Md, Md
Gd, Gd, Gs^Var, Gs^Es, Gs, Kar, Gs, Car, Re, Kar, Gs, Gd, Gd^Fts, Hhd^Fts, Mm, Mm, Mm, Mm, Mm, Hhd^Fts, Gd^Fts, Gd, Wwt, Wwt, Wwt, Gs, Re, Gd, Gd, Gs, Gd, Gll, Gd^Fts, Gs, Gs, Gs, Gs, Gs, Gs, Gd^Es, Gs, Gs, Gs, Gd, Gs, Wwt, Wwt, Wwf, Wwt, Xar, Xar, Gs, Gs, Gd, Gs, Gs^Es, Re, Re, Gs, Gd, Gd^Fts, Gd, Hhd, Hhd, Md, Md, Md, Md
Gs^Es, Gs, Gs, Gd, Gd, Gs^Es, Gs, Kar, Re, Gs, Gs, Gs, Gd, Hhd^Fts, Mm, Mm, Mm, Mm, Hhd, Hhd^Fts, Gd, Gd^Es, Gs, Wwt, Wwt^Bab/, Re, Gs, Gs, Gs, Gs, Gs^Es, Gd, Gs, Gs, Gs^Es, Gd, Gs, Gs, Gs, Gs, Gd, Gd^Fts, Gd^Fts, Gd, Gd, Gs, Gs, Wwf, Wwt, Wwt, Xar, Gs, Gs, Gs, Re, Gs^Var, Gs, Gd, Gd, Gd^Fts, Gd^Fts, Hhd^Fts, Md, Md, Md, Md, Md, Md
Gd^Es, Gs, Gs, Gd^Fts, Gs, Gs, Gd, Gs, Re, Gs^Es, Gd, Gd^Fts, Gll, Hhd, Mm, Mm, Mm, Mm, Hhd^Fts, Gll, Gd^Fts, Gd^Fts, Re, Wwt^Bab/, Wwt, Wwt, Wwt, Wwt, Wwt, Gs, Gs, Gs, Gs^Es, Gs^Es, Gd, Gs, Gs, Gd, Gs, Gs, Gd, Gd^Fts, Gs, Gs, Gd^Es, Gs, Gs, Gs, Xar, Wwt, Wwt, Gs, Gs^Es, Re, Gs^Es, Gd, Gd, Gd, Gd^Fts, Gd^Fts, Hhd, Hhd^Fts, Md, Md, Md, Md, Md^Xm, Md^Xm
Gd^Fts, Gd, Wwt, Gd^Fts, Wwt, Gd, Gd^Fts, Gd, Gs, Re, Re, Gd^Fts, Gd^Fts, Hhd^Fts, Hhd^Fts, Hhd, Hhd, Hhd^Fts, Gd^Fts, Gll, Gd, Gd, Re, Gs^Es, Gd, Wwt, Wwt, Wwt, Wwt, Wwt, Gs, Gs, Gs, Gd, Gs, Gs, Gs, Gs, Gd, Gs^Es, Gd, Gs, Gs, Gs, Gs, Gd, Gs, Gs, Gs, Wwt, Wwt, Gd, Gd, Re, Gs^Es, Gd, Gd^Fts, Gd^Fts, Gll, Gd^Fts, Hhd, Md, Md, Md, Md, Md^Xm, Md, Md
Wwt, Wwt, Wwt, Wwt, Wwt, Wwt, Wwt, Gd^Fts, Rr^Vd, Gd, Re, Re, Re, Gd^Fts, Re, Gs, Gd, Gd^Fts, Gd, Gd^Fts, Re, Re, Gd, Gd, Gd^Fts, Gd^Fts, Xar, Xar, Wwt, Wwt, Gs, Gs, Gd, Gd, Gs, Gd^Fts, Gs, Gs, Gs, Gd^Es, Gd^Es, Gs, Gd^Es, Re^Vct, Gs, Gs, Gs, Re^Vct, Gs, Wwt, Wwt, Gs, Gs, Re, Gs, Gd, Gd^Fts, Gd, Hhd^Fts, Hhd^Fts, Md, Md, Md, Md, Md^Xm, Md^Xm, Md^Xm, Md^Xm
Wwt, Wwt, Gll, Wwt, Gd^Fts, Wwt, Wwt, Gd^Fts, Wwt, Gd^Fts, Wwt^Bab|, Gs, Wwt, Re, Gs^Es, Re, Re, Gd, Gs^Es, Re, Gs^Es, Gs, Gs, Gd, Xar, Gd^Fts, Xar, Xar, Wwt, Wwt, Gd, Gd^Fts, Gd, Gd, Gs^Es, Gs, Gs, Gs, Gs, Gd, Gd, Gd, Gs, Gd, Gd, Gs, Ce, Gd^Es, Gs, Wwt, Wwt, Wwt, Gs, Gs, Gs, Gs, Gd, Gd^Fts, Hhd^Fts, Md, Md, Md, Md, Md, Md^Xm, Md^Xm, Md, Md^Xm
Gd, Gd^Fts, Gd^Fts, Gd^Fts, Gd^Fts, Wwt, Wwt, Wwt, Wwt, Wwt, Wwt^Bab|, Wwt, Wwt, Wwt, Wwt, Gs, Gd, Re, Re, Re, Gd^Es, Rr^Vd, Gs^Es, Gs^Es, Gs, Xar, Wwt, Xar, Wwt, Wwt, Gd^Fts, Gd^Fts, Gd^Fts, Gs, Gs, Gs, Gs^Es, Gs, Gs, Gs, Gs^Es, Gs, Gs, Gs, Ce, Gs, Ce, Gs, Ce, Gd^Fts, Wwf, Wwf, Wwt, Gs^Es, Gs, Gd, Gd^Fts, Gd^Fts, Hhd^Fts, Md, Md, Md, Md^Xm, Md, Md^Xm, Md, Md, Md
Gd, Xar, Xar, Xar, Xar, Gs, Gd, Wwt, Gs, Wwt, Wwt^Bab|, Wwt, Gd^Fts, Wwt, Wwt, Gd^Fts, Gd, Gs, Gs, Gs, Gs, Gs, Gs, Gs, Wwt, Wwt, Wwt, Wwt, Wwt, Wwt, Wwt, Gd, Wwt, Gs, Wwt, Gs, Wwt, Wwt, Wwt, Gd, Gd, Gs, Gs^Es, Gd, Gs^Es, Ce, Ke, Ce, Gd, Gs, Gs, Wwt, Wwt, Gs, Gs, Gs, Gd, Gll, Hhd, Hhd^Fts, Md, Md, Md^Xm, Md, Md, Md^Xm, Md^Xm, Md
Gd^Fts, Xar, Gd^Fts, Xar, Xar, Xar, Gd^Fts, Gd^Fts, Gd, Car, Re, Car, Gd, Wwt, Wwt, Wwt, Wwt, Gd, Gs, Gs^Es, Gd, Gd, Xar, Wwt, Wwt, Wwt, Gs, Gs, Gs, Wwt, Wwt, Wwt, Wwt, Wwt, Wwt, Wwt, Wwt, Wwt, Wwt, Wwt, Gs, Gs, Re^Vct, Gd, Ce, Ce, Ce, Ce, Gd^Fts, Gd, Gs, Wwt, Wwt, Wwt, Wwt, Gs, Gd^Es, Gd^Fts, Gd^Fts, Hhd^Fts, Hhd^Fts, Md, Md, Md^Xm, Md, Md, Md^Xm, Md
Gll, Gd^Fts, Gd, Xar, Xar, Xar, Xar, Gd^Fts, Gd, Gs, Re, Gs, Gd^Es, Gs, Gs, Wwt, Wwt, Wwt, Wwt, Gs, Wwt, Gd^Fts, Wwt, Wwt, Wwt, Xar, Gs, Gs^Es, Gd, Gs, Gs, Wwt, Wwt, Wwt, Gs, Wwt, Gs, Xar, Wwt, Wwt, Wwt, Gs, Gd, Gd, Gs, Gs, Gd^Fts, Gs, Gd^Fts, Gd, Re^Vct, Gd^Fts, Gs, Wwt, Wwt, Gs, Gs^Es, Gd^Fts, Gd, Gd^Fts, Hhd^Fts, Md, Md, Md, Md, Md^Xm, Md^Xm, Md
Gd^Fts, Gd, Gll, Gd^Fts, Gs, Xar, Gs, Gs, Gs^Es, Gs^Es, Re, Gs, Gs, Gs, Gd^Es, Gs, Re, Wwt, Wwt, Wwt, Wot, Wwt, Wwt, Wwt, Gd, Gd, Gd^Fts, Gd, Gs, Gs^Es, Gs^Es, Gs, Gs, Gs, Gd, Gs^Es, Gs, Xar, Xar, Wwt, Wwt, Gs, Gs, Gs^Es, Gs, Gd^Fts, Gd^Fts, Gd, Gs, Gd, Gs, Gd, Gd^Fts, Wwt, Wwt, Wwt, Wwt, Gd, Wwt, Gd^Fts, Hhd^Fts, Md, Md, Md, Md, Md, Md, Md^Xm
Hhd^Fts, Gd^Fts, Gd^Fts, Gd, Gd, Gs^Es, Gd, Gs^Es, Gd, Gd^Fts, Re, Re, Re, Re, Gs, Re, Gd, Gs, Wwt, Wwt, Wot, Wwt, Wwt, Xar, Gs, Gd^Fts, Xar, Xar, Gs, Gd, Gs^Es, Gs, Gd^Fts, Gs, Gs, Gs^Es, Gs, Gs, Gs, Wwt, Wwt, Wwt, Wwf, Wwt, Wwt, Wwt, Wwt, Wwf, Wwt, Gd^Fts, Gs, Gd^Fts, Gd^Fts, Hhd^Fts, Hhd^Fts, Wwt, Wwt, Wwt, Wwt, Wwt, Wwt, Hhd^Fts, Hhd^Fts, Md, Md, Md, Md, Md
Md, Hhd^Fts, Hhd, Gs, Gs, Gd, Gs^Es, Gs^Es, Gd, Gs^Es, Re, Gs, Gd^Fts, Gll, Xar, Gs, Gd, Gs^Es, Wwt, Wot, Wot, Wot, Wwt, Gs, Gs, Gd^Fts, Gs, Xar, Gs, Gd, Gs, Gs, Gd, Gs, Gd, Gs, Gs, Gd^Es, Re^Vct, Gs, Gs, Wwt, Wwf, Wwt, Wwt, Wwt, Wwt, Wwf, Wwt, Wwt, Wwt, Wwt, Wwt, Hhd^Fts, Hhd^Fts, Hhd^Fts, Gd^Fts, Wwt, Gd^Fts, Wwt, Wwt, Wwt, Wwt, Md, Md, Md, Md, Md^Xm
Md, Md, Hhd^Fts, Gll, Gd^Fts, Gd, Gs, Gd, Gs, Re, Gs, Gd, Gd^Fts, Gd^Fts, Xar, Gd^Fts, Gd, Gs^Es, Wwt, Wwt, Wwt, Wwt, Xar, Gd, Gs^Es, Gd, Gd^Fts, Gs, Gd, Gd, Gs^Es, Gs, Gs^Es, Gs, Gd, Gd, Gd^Fts, Gs, Gd, Gs^Es, Gs, Gs, Gs, Gs, Gs^Es, Wwt, Gs, Gs, Gs^Es, Wwt, Wwt, Wwt, Wwt, Wwt, Wwt, Gd^Fts, Gd^Fts, Gd^Fts, Hhd^Fts, Hhd^Fts, Hhd^Fts, Hhd^Fts, Md, Wwt, Wwt, Md, Md, Md^Xm
Md, Md, Hhd^Fts, Gd^Fts, Gll, Gd^Fts, Gs, Gd, Gs^Es, Gs, Gd, Gd, Gs, Gll, Xar, Gd^Fts, Gd^Fts, Gd, Gs, Wwt, Wwt, Wwt, Wwt, Gs, Gd^Es, Xar, Xar, Xar, Gs, Gs^Es, Gd, Gs, Gd, Gs, Gs, Gs, Re^Vct, Gs, Gd, Gs, Gd^Fts, Re^Vct, Gd, Gd, Gd, Gs, Gd, Gd^Es, Gs, Gd, Gs, Gd, Gd^Es, Wwt, Wwt, Gd^Fts, Gd^Fts, Hhd, Hhd^Fts, Md, Md, Md, Md, Md, Md, Md, Md, Md
Md, Hhd^Fts, Hhd^Fts, Gll, Gd^Fts, Gll, Gd, Gs, Re, Re, Gs^Es, Gs, Gs, Gs, Xar, Xar, Xar, Gs^Es, Gs, Gs, Gs, Wwt, Wwt, Gs, Gs^Es, Gd^Fts, Gd^Fts, Gd^Fts, Gs^Es, Gs, Gd, Gd^Fts, Gd^Fts, Gd, Gd^Es, Gd^Es, Gs, Gd^Es, Gs, Gs, Gd, Gs, Gd, Gs^Es, Gs, Gd^Fts, Gd^Fts, Gd^Fts, Gd^Fts, Gs, Gd^Fts, Gs, Gd^Fts, Wwt, Wwt, Wwt, Wwt, Gd^Fts, Hhd^Fts, Md, Md, Md, Md, Md, Md^Xm, Md, Md^Xm, Md
Md, Hhd^Fts, Md, Hhd, Gd^Fts, Gs, Gs^Es, Gs^Es, Gs, Gs, Gd, Gs, Gs, Gs, Gd^Fts, Xar, Xar, Gd, Gd, Gs, Gd, Wwt, Wwt, Gd, Gd, Gd^Es, Gs, Gs, Gd^Es, Gs, Gd^Fts, Gll, Gd^Fts, Gd, Gs, Gs, Re^Vct, Gs, Gd^Fts, Ce, Ce, Ce, Gs^Es, Gs, Gd^Fts, Gd^Fts, Gd, Gll, Hhd^Fts, Hhd^Fts, Hhd^Fts, Hhd^Fts, Hhd^Fts, Gd^Fts, Gd^Fts, Wwt, Wwt, Wwt, Wwt, Md, Md, Md, Md, Md^Xm, Md, Md^Xm, Md^Xm, Md
Md^Xm, Md, Md^Cov, Hhd^Cov, Hhd^Cov, Gs, Hhd^Fts, Gd^Fts, Gd^Fts, Gd, Gs, Gs^Es, Gs, Gd, Gs, Gd^Fts, Xar, Gs, Gs, Gs, Gs^Es, Wwt, Wwt, Gd^Fts, Gll, Gs, Gs, Gs, Gs, Gs, Gd^Fts, Gd^Fts, Gll, Gs, Gd, Gd, Gd^Es, Gs^Es, Ce, Ce, Ke, Ce, Ce, Gs, Gd^Fts, Gd^Fts, Hhd^Fts, Hhd, Md, Md, Md, Md, Md, Hhd^Fts, Hhd^Fts, Gd^Fts, Gd^Fts, Wwt, Hhd^Fts, Wwt, Wwt, Md, Md, Md^Xm, Md, Md, Md^Xm, Md
Md, Md, Md^Cov, Md^Kov, Md^Cov, Hhd^Fts, Md^Xm, Hhd^Fts, Hhd^Fts, Gll, Gll, Gs, Gs, Gs^Es, Gd, Gs, Gs, Gs, Gd, Gd, Gs^Es, Wwt, Wwf, Wwf, Gd^Fts, Gd^Fts, Gd, Gd, Gs, Gs, Hhd^Fts, Hhd^Fts, Hhd, Gd, Gd^Fts, Gd^Fts, Gd^Fts, Gs, Gs, Ce, Ce, Ce, Gd^Fts, Gd^Fts, Hhd, Hhd^Fts, Md, Md, Md, Md, Md, Md, Md, Md, Md, Hhd^Fts, Hhd^Fts, Hhd^Fts, Md, Md, Md, Wwt, Wwt, Md, Md, Md, Md^Xm, Md^Xm
Md, Md^Xm, Md^Xm, Md^Cov, Md, Md, Md, Md, Md, Hhd^Fts, Hhd, Gd^Fts, Gd^Fts, Gs, Gd, Gs^Es, Gs, Gs, Gd^Es, Gs, Gs^Es, Gs, Wwt, Wwt, Gs, Gs, Gll, Gd^Fts, Hhd, Hhd, Md, Md, Md, Hhd^Fts, Hhd^Fts, Gll, Gd^Fts, Gd^Fts, Gd, Ce, Gs, Ce, Gd^Fts, Gll, Hhd^Fts, Hhd^Fts, Md, Md, Md, Md, Md^Xm, Md, Md^Xm, Md, Md, Md, Md, Md, Md, Md, Md, Md, Md, Md, Md, Md, Md^Xm, Md^Xm
Md^Xm, Md, Md, Md^Xm, Md^Xm, Md, Md, Md, Md, Md, Md, Hhd^Fts, Gd^Fts, Gs, Gs, Gs^Es, Gs, Gs^Es, Gs, Gs, Wwt, Wwt, Wwt, Wwt, Gs, Gd^Fts, Hhd^Fts, Hhd^Fts, Md, Md, Md, Md, Md, Md, Md, Hhd^Fts, Gll, Gd^Fts, Gs, Gs^Es, Gd, Gs, Gs, Gd, Hhd^Fts, Md, Md, Md, Md^Xm, Md^Xm, Md, Md^Xm, Md, Md^Xm, Md^Xm, Md, Md, Md, Md, Md, Md, Md, Md, Md, Md, Md^Xm, Md^Xm, Md
Md^Xm, Md, Md^Xm, Md, Md, Md^Xm, Md^Xm, Md^Xm, Md, Md, Md, Hhd^Fts, Gs, Gd, Gd^Es, Gs, Gd, Gd, Gs, Gs, Wwt, Wwt, Gs, Gs, Gs, Gd^Fts, Hhd^Fts, Md, Md, Md, Md, Md, Md, Md, Md, Hhd^Fts, Gd^Fts, Gd^Fts, Gd, Gs^Es, Gs^Es, Gd, Gs, Gd^Fts, Hhd^Fts, Md, Md, Md, Md^Xm, Md^Xm, Md^Xm, Md, Md, Md^Xm, Md, Md^Xm, Md^Xm, Md^Xm, Md, Md, Md, Md, Md, Md^Xm, Md^Xm, Md^Xm, Md^Xm, Md
