Qxua, Qxua, Qxua, Qxua, Qxua, Qxua, Qxua, Qxua, Qxua, Qxua, Qxua, Qxua, Qxua, Qxua, Qxua, Qxua, Qxua, Qxua, Qxua, Qxua, Qxua, Qxua, Qxua, Qxua, Qxua, Qxua, Qxua, Qxua, Qxua, Qxua, Qxua, Qxua, Qxua, Qxua, Qxua, Qxua, Qxua, Qxua, Qxua, Qxua, Qxua, Qxua, Qxua, Qxua, Qxua, Qxua, Qxua, Qxua, Qxua, Qxua, Qxua, Qxua, Qxua
Qxua^Xel, Qxua, Qxua^Xel, Qxua, Qxua^Xel, Qxua, Qxua^Xel, Qxua, Qxua^Xel, Qxua, Qxua^Xel, Qxua, Qxua^Xel, Qxua, Qxua^Xel, Qxua, Qxua^Xel, Qxua, Qxua^Xel, Qxua, Qxua^Xel, Qxua, Qxua^Xel, Qxua, Qxua^Xel, Qxua, Qxua, Qxua, Qxua, Qxua, Qxua, Qxua, Qxua^Xel, Qxua, Qxua^Xel, Qxua, Qxua^Xel, Qxua, Qxua^Xel, Qxua, Qxua, Qxua, Qxua, Qxua, Qxua, Qxua, Qxua, Qxua, Qxua, Qxua, Qxua, Qxua, Qxua
Gsm, Qxua, Gsm, Qxua, Gsm, Qxua, Gsm, Qxua, Gsm, Qxua, Gsm, Qxua, Gsm, Qxua, Gsm, Qxua, Gsm, Qxua, Gsm, Qxua, Gsm, Qxua, Gsm, Qxua, Gsm, Qxua, Qxua^Xel, Qxua, Qxua^Xel, Qxua, Qxua^Xel, Qxua, Gsm, Qxua, Gsm^Esf, Gsm, Gsm^Esf, Gsm^Esf, Gsm^Esf, Qxua, Qxua^Xel, Qxua, Qxua^Xel, Qxua, Qxua^Xel, Qxua, Qxua^Xel, Qxua, Qxua^Xel, Qxua, Qxua^Xel, Qxua, Qxua^Xel
Gsm^Esf, Gsm^Esf, Gsm^Esf, Gsm, Gsm^Esf, Gsm, Gsm^Cov, Gsm^Cov, Gsm^Cov, Gsm^Esf, Gsm, Gsm^Esf, Gsm^Esf, Gsm, Gsm^Esf, Gsm^Esf, Gsm^Esf, Gsm^Esf, Gsm^Esf, Gsm, Gsm^Esf, Gsm, Gsm^Esf, Gsm^Esf, Gsm^Esf, Gsm^Esf, Gsm, Qxua, Gsm^Esf, Gsm^Esf, Gsm^Esf, Gsm, Gsm^Esf, Gsm^Esf, Gsm^Esf, Gsm^Esf, Gsm, Gsm^Esf, Gsm^Esf, Gsm, Gsm, Qxua, Gsm^Esf, Gsm^Esf, Gsm^Esf, Qxua, Gsm^Esf, Gsm^Esf, Gsm^Esf, Gsm^Esf, Gsm^Esf, Gsm^Esf, Gsm^Esf
Gsm^Fst, Gsm^Esf, Gsm, Gsm, Gsm, Gsm, Gsm^Cov, Gsm^Kov, Gsm^Cov, Gsm, Gsm^Esf, Gsm^Esf, Gsm^Esf, Gsm^Esf, Gsm^Esf, Gsm^Esf, Gsm^Esf, Gsm^Esf, Gsm^Esf, Gsm^Esf, Gsm, Gsm^Esf, Gsm, Gsm, Gsm^Esf, Gsm^Esf, Gsm^Esf, Gsm, Gsm, Gsm, Gsm, Gsm^Esf, Gsm^Esf, Gsm^Esf, Gsm^Esf, Gsm, Gsm^Esf, Gsm, Gsm^Esf, Gsm^Esf, Gsm^Esf, Gsm^Esf, Gsm^Esf, Gsm^Esf, Gsm, Gsm^Esf, Gsm, Gsm^Esf, Gsm^Esf, Gsm^Esf, Gsm, Gsm, Gsm^Fst
Gsm^Fst, Gsm^Fst, Gsm^Fst, Gsm, Gsm, Gsm^Esf, Gsm^Esf, Gsm^Cov, Gsm, Gsm^Esf, Gsm, Gsm^Esf, Gsm^Esf, Gsm, Gsm, Gsm, Gsm, Gsm, Gsm, Gsm^Esf, Gsm^Esf, Gsm^Esf, Gsm, Gsm^Esf, Gsm, Gsm, Gsm^Esf, Gsm^Esf, Gsm^Esf, Gsm^Esf, Gsm^Esf, Gsm, Gsm, Gsm^Esf, Gsm, Gsm^Esf, Gsm, Gsm^Esf, Gsm, Gsm^Esf, Gsm, Gsm, Gsm^Fst, Gsm^Fst, Gsm^Fst, Gsm, Gsm^Fst, Gsm, Gsm^Fst, Gsm^Fst, Gsm^Fst, Gsm^Fst, Gsm
Qsr, Qsr, Qsr, Gsm^Fst, Gsm^Fst, Gsm^Esf, Gsm, Gsm^Esf, Gsm, Gsm^Fst, Gsm^Fst, Gsm, Gsm^Fst, Gsm^Fst, Gsm, Gsm^Fst, Gsm^Fst, Gsm, Gsm, Gsm, Gsm, Gsm, Gsm, Gsm, Gsm, Gsm, Xur, Gsm^Esf, Gsm, Gsm, Xur, Xur, Xur, Xur, Xur, Gsm, Xur, Gsm, Xur, Gsm, Gsm, Gsm, Gsm^Fst, Gsm^Fst, Gsm^Fst, Gsm^Fst, Gsm, Gsm^Fst, Gsm^Fst, Gsm^Fst, Gsm^Fst, Gsm^Fst, Gsm^Fst
Qsr, Qsr, Qsr, Gsm, Gsm^Fst, Gsm^Fst, Gsm^Fst, Gsm^Fst, Gsm^Fst, Gsm^Fst, Qsr, Gsm, Gsm^Fst, Gsm^Fst, Gsm^Fst, Gsm^Fst, Xur, Xur, Xur, Gsm, Xur, Gsm, Gsm, Gsm, Gsm, Xur, Xur, Xur, Xur, Xur, Xur, Xur, Xur, Xur, Xur, Xur, Xur, Xur, Xur, Xur, Xur, Xur, Xu^Fst, Gsm^Fst, Qsr, Qsr, Qsr, Qsr, Qsr, Qsr, Qsr, Gsm^Fst, Qsr
Xur, Qsr, Qsr, Qsr, Qsr, Gsm, Qsr, Gsm, Qsr, Qsr, Qsr, Qsr, Qsr, Qsr, Qsr, Qsr, Qsr, Xur, Xur, Xur, Xur, Gsm, Gsm, Gsm, Gsm, Xur, Xur, Xur, Xur, Xur, Xur, Xur, Xur, Xur, Xur, Xur, Xur, Xur, Xur, Xur, Xur, Xur, Xur, Qsr, Qsr, Qsr, Qsr, Qsr, Qsr, Qsr, Qsr, Qsr, Qsr
Xur, Qsr, Xur, Qsr, Qsr, Qsr, Qsr, Qsr, Qsr, Qsr, Xur, Qsr, Xur, Qsr, Xur, Qsr, Qsr, Qsr, Xur, Xur, Xur, Xur, Gsm, Gsm, Xur, Xur, Xur, Xur, Xur, Xur, Xur, Xur, Xur, Xur, Xur, Xur, Xur, Xur, Xur, Xur, Xur, Xur, Xur, Qsr, Qsr, Qsr, Xur, Xur, Xur, Xur, Xur, Xur, Xur
Xur, Xur, Xur, Xur, Xur, Xur, Xur, Xur, Xur, Xur, Xur, Xur, Xur, Xur, Xur, Xur, Qsr, Qsr, Xur, Xur, Xur, Gsm, Uu, Uu, Uu, Xur, Xur, Xur, Uu, Uu, Gsm, Uu, Uu, Uu, Uu, Xur, Xur, Xur, Xur, Xur, Xur, Xur, Xur, Qsr, Qsr, Xur, Qsr, Xur, Xur, Xur, Xur, Xur, Xur
Xur, Xur, Xur, Xur, Xur, Xur, Xur, Xur, Xur, Xur, Xur, Xur, Qsr, Xur, Qsr, Qsr, Qsr, Qsr, Xur, Xur, Xur, Uu, Uu, Gsm, Uu, Uu, Gsm, Uu, Gsm^Fst, Uu, Gsm^Fst, Uu, Gsm, Uu, Uu, Xur, Xur, Xur, Xur, Xur, Xur, Xur, Xur, Qsr, Qsr, Qsr, Qsr, Qsr, Xur, Xur, Xur, Xur, Xur
Xur, Xur, Xur, Xur, Xur, Xur, Xur, Xur, Xur, Xur, Qsr, Qsr, Qsr, Qsr, Qsr, Qsr, Xur, Xur, Xur, Xur, Xur, Xur, Xur, Uu, Uu, Gsm^Fst, Uu, Uu, Xur, Uu, Uu, Uu, Uu, Gsm^Fst, Xur, Xur, Xur, Xur, Xur, Xur, Xur, Xur, Xur, Xur, Xur, Qsr, Qsr, Qsr, Xur, Xur, Xur, Xur, Xur
Qsr, Xur, Xur, Xur, Qsr, Xur, Xur, Xur, Qsr, Qsr, Qsr, Qsr, Qsr, Qsr, Xur, Xur, Xur, Xur, Xur, Xur, Xur, Xur, Xur, Xur, Xur, Xur, Xur, Xur, Xur, Xur, Cdc, Gsm^Fst, Uu, Uu, Xur, Xur, Xur, Xur, Xur, Xur, Xur, Xur, Xur, Xur, Xur, Xur, Qsr, Qsr, Xur, Xur, Xur, Xur, Xur
Qsr, Qsr, Qsr, Qsr, Qsr, Qsr, Qsr, Qsr, Qsr, Qsr, Xur, Xur, Xur, Xur, Xur, Xur, Xur, Xur, Xur, Xur, Xur, Xur, Xur, Xur, Xur, Xur, Xur, Xur, Gsm^Fst, Cdc, Kdc, Cdc, Gsm, Xur, Xur, Xur, Xur, Xur, Xur, Xur, Xur, Xur, Xur, Xur, Xur, Xur, Qsr, Qsr, Xur, Xur, Xur, Xur, Xur
Qsr, Qsr, Qsr, Qsr, Qsr, Qsr, Qsr, Qsr, Xur, Xur, Xur, Xur, Xur, Xur, Xur, Xur, Xur, Xur, Xur, Xur, Xur, Xur, Xur, Xur, Xur, Xur, Qsr, Uu, Cdc, Cdc, Cdc, Cdc, Cdc, Xur, Xur, Xur, Xur, Xur, Xur, Xur, Xur, Xur, Xur, Xur, Xur, Qsr, Qsr, Qsr, Qsr, Xur, Xur, Xur, Xur
Xur, Xur, Xur, Xur, Xur, Xur, Xur, Xur, Xur, Xur, Xur, Xur, Xur, Xur, Xur, Xur, Xur, Xur, Xur, Xur, Xur, Xur, Xur, Xur, Qsr, Qsr, Qsr, Gsm^Fst, Gsm, Gsm^Fst, Uu, Uu^Fst, Gsm, Uu, Gsm^Fst, Xur, Xur, Xur, Xur, Xur, Xur, Xur, Xur, Xur, Xur, Xur, Qsr, Qsr, Qsr, Qsr, Qsr, Xur, Xur
Xur, Xur, Xur, Xur, Xur, Xur, Xur, Xur, Xur, Xur, Xur, Xur, Xur, Xur, Xur, Xur, Xur, Xur, Xur, Xur, Xur, Xur, Xur, Xur, Xur, Qsr, Qsr, Gsm^Fst, Gsm^Fst, Gsm, Gsm, Gsm, Gsm^Fst, Gsm, Gsm^Fst, Xur, Xur, Xur, Xur, Xur, Xur, Xur, Xur, Xur, Xur, Xur, Xur, Qsr, Qsr, Qsr, Qsr, Qsr, Qsr
Xur, Xur, Xur, Xur, Xur, Xur, Xur, Xur, Xur, Xur, Xur, Xur, Xur, Xur, Xur, Xur, Xur, Xur, Xur, Xur, Xur, Xur, Xur, Xur, Xur, Qsr, Uu, Uu, Uu, Gsm, Uu, Uu, Uu, Uu, Xur, Xur, Xur, Xur, Xur, Xur, Xur, Xur, Xur, Xur, Xur, Xur, Xur, Xur, Xur, Xur, Xur, Qsr, Qsr
Xur, Xur, Xur, Xur, Xur, Xur, Xur, Xur, Xur, Xur, Qsr, Qsr, Qsr, Xur, Xur, Xur, Xur, Xur, Xur, Xur, Xur, Xur, Xur, Xur, Xur, Xur, Uu, Uu^Xsf, Uu, Gsm, Uu, Uu^Xsf, Uu, Uu, Xur, Xur, Xur, Xur, Xur, Xur, Xur, Xur, Xur, Xur, Xur, Xur, Xur, Xur, Xur, Xur, Xur, Xur, Qsr
Xur, Xur, Xur, Xur, Xur, Xur, Xur, Xur, Xur, Qsr, Cdc, Cdc, Cdc, Qsr, Qsr, Qsr, Qsr, Qsr, Gsm^Fst, Xur, Uu, Xur, Xur, Xur, Uu, Uu, Uu, Uu, Uu, Gsm, Gsm, Uu, Uu, Xur, Xur, Xur, Xur, Xur, Xur, Xur, Xur, Xur, Xur, Xur, Xur, Xur, Xur, Xur, Xur, Xur, Xur, Xur, Xur
Xur, Xur, Xur, Xur, Xur, Xur, Xur, Xur, Xur, Qsr, Cdc, Kdc, Cdc, Cdc, Uu, Qsr, Qsr, Qsr, Uu, Gsm, Gsm, Gsm, Gsm, Uu, Uu, Gsm^Fst, Gsm^Fst, Qxua^Qhux, Uu, Uu, Gsm, Gsm, Gsm, Xur, Xur, Xur, Xur, Xur, Xur, Xur, Xur, Xur, Xur, Xur, Xur, Xur, Xur, Xur, Xur, Xur, Xur, Xur, Xur
Xur, Xur, Xur, Xur, Xur, Xur, Qsr, Xur, Qsr, Qsr, Cdc, Cdc, Uu, Uu, Gsm^Fst, Gsm, Gsm^Fst, Gsm^Fst, Gsm, Gsm, Uu, Uu^Xsf, Uu, Gsm^Fst, Uu, Qxua^Qhux, Gsm, Gsm, Uu, Gsm, Qxua^Qhux, Gsm, Gsm, Uu, Xur, Xur, Xur, Xur, Xur, Xur, Xur, Xur, Xur, Xur, Xur, Xur, Xur, Xur, Xur, Xur, Xur, Xur, Xur
Xur, Xur, Xur, Xur, Xur, Qsr, Uu, Qsr, Uu, Uu, Uu, Uu, Uu, Uu, Uu, Uu, Gsm, Gsm, Gsm, Gsm, Uu, Uu, Gsm^Fst, Gsm, Qxua^Qhux, Uu, Gsm, Uu, Uu, Qxua^Qhux, Qxua^Qhux, Uu, Gsm, Uu, Xur, Xur, Xur, Xur, Xur, Xur, Xur, Xur, Xur, Xur, Xur, Xur, Xur, Xur, Xur, Xur, Xur, Xur, Xur
Xur, Xur, Xur, Xur, Xur, Qsr, Uu, Gsm, Gsm^Fst, Gsm^Fst, Gsm, Uu, Uu, Uu, Gsm, Gsm^Fst, Qxua^Qhux, Uu, Uu, Gsm^Fst, Uu, Gsm, Uu, Uu, Uu, Uu, Gsm, Uu, Uu, Qxua^Qhux, Qxua^Qhux, Qxua^Qhux, Gsm, Gsm, Qsr, Qsr, Qsr, Xur, Xur, Xur, Xur, Xur, Xur, Xur, Xur, Xur, Xur, Xur, Xur, Xur, Xur, Xur, Xur
Xur, Xur, Xur, Xur, Qsr, Qsr, Gsm, Uu, Uu, Uu, Gsm, Gsm, Gsm^Fst, Uu, Gsm, Qxua^Qhux, Qxua^Qhux, Uu^Xsf, Uu, Gsm, Gsm^Fst, Gsm, Qxua^Qhux, Uu, Gsm, Gsm, Uu, Uu^Xsf, Uu, Uu, Uu, Gsm, Gsm, Uu^Xsf, Qsr, Qsr, Qsr, Qsr, Xur, Xur, Xur, Xur, Xur, Xur, Xur, Xur, Xur, Xur, Xur, Xur, Xur, Xur, Xur
Xur, Xur, Xur, Xur, Qsr, Qsr, Qsr, Uu^Xsf, Uu, Uu, Gsm, Uu, Gsm, Gsm^Fst, Gsm, Uu, Uu, Uu, Gsm, Gsm, Uu, Uu, Uu, Qxua^Qhux, Qxua^Qhux, Gsm, Uu, Uu, Gsm, Gsm^Fst, Gsm, Gsm^Fst, Uu, Gsm^Fst, Gsm^Fst, Qsr, Qsr, Qsr, Uu, Xur, Xur, Xur, Xur, Xur, Xur, Xur, Xur, Xur, Xur, Xur, Xur, Xur, Xur
Xur, Xur, Xur, Qsr, Qsr, Qsr, Qsr, Uu, Gsm^Fst, Gsm, Uu, Uu, Uu^Xsf, Uu, Uu, Gsm, Gsm, Gsm, Gsm, Uu, Qxua^Qhux, Uu, Qxua^Qhux, Qxua^Qhux, Qxua^Qhux, Qxua^Qhux, Uu, Gsm^Fst, Gsm, Uu, Qxua^Qhux, Uu, Uu, Gsm, Gsm, Uu, Uu, Uu^Xsf, Uu, Xur, Xur, Xur, Xur, Xur, Xur, Xur, Xur, Xur, Xur, Xur, Xur, Xur, Xur
Xur, Xur, Xur, Xur, Xur, Qsr, Uu, Gsm^Fst, Gsm^Fst, Uu, Gsm^Fst, Gsm, Uu, Uu, Qxua^Qhux, Uu, Qxua^Qhux, Uu, Uu, Qxua^Qhux, Qxua^Qhux, Qxua^Qhux, Qxua^Qhux, Qxua^Qhux, Qxua^Qhux, Qxua^Qhux, Gsm^Fst, Gsm, Uu, Uu, Uu, Qxua^Qhux, Uu, Uu, Uu, Gsm, Uu, Gsm^Fst, Gsm, Xur, Xur, Xur, Xur, Xur, Xur, Xur, Xur, Xur, Xur, Xur, Xur, Xur, Xur
Xur, Xur, Xur, Xur, Xur, Xur, Xur, Uu, Uu, Uu, Uu, Gsm, Uu, Gsm^Fst, Qxua^Qhux, Qxua^Qhux, Qxua^Qhux, Qxua^Qhux, Qxua^Qhux, Qxua^Qhux, Qxua^Qhux, Qxua^Qhux, Qxua^Qhux, Qxua^Qhux, Qxua^Qhux, Uu, Uu, Uu, Qxua^Qhux, Uu, Gsm, Uu, Uu, Uu^Xsf, Uu, Uu, Uu, Uu, Uu, Gsm, Xur, Xur, Xur, Xur, Xur, Xur, Xur, Xur, Xur, Xur, Xur, Xur, Xur
Xur, Xur, Xur, Xur, Xur, Xur, Xur, Uu, Uu^Xsf, Uu, Gsm, Gsm, Uu, Qxua^Qhux, Qxua^Qhux, Qxua^Qhux, Qxua^Qhux, Qxua^Qhux, Qxua^Qhux, Qxua^Qhux, Qxua^Qhux, Qxua^Qhux, Qxua^Qhux, Qxua^Qhux, Qxua^Qhux, Qxua^Qhux, Qxua^Qhux, Qxua^Qhux, Qxua^Qhux, Qxua^Qhux, Qxua^Qhux, Gsm, Qxua^Qhux, Uu, Uu, Uu, Gsm^Fst, Gsm^Fst, Uu, Gsm^Fst, Xur, Xur, Xur, Xur, Xur, Xur, Xur, Xur, Xur, Xur, Xur, Xur, Xur
Xur, Xur, Xur, Xur, Xur, Xur, Qsr, Gsm^Fst, Qsr, Gsm^Fst, Gsm^Fst, Gsm, Uu, Qxua^Qhux, Gsm, Gsm, Uu^Xsf, Uu, Uu, Qxua^Qhux, Uu, Qxua^Qhux, Qxua^Qhux, Qxua^Qhux, Qxua^Qhux, Qxua^Qhux, Qxua^Qhux, Qxua^Qhux, Qxua^Qhux, Qxua^Qhux, Qxua^Qhux, Gsm, Gsm, Uu, Uu, Uu, Uu, Gsm^Fst, Uu, Uu, Qsr, Xur, Xur, Xur, Xur, Xur, Xur, Xur, Xur, Xur, Xur, Xur, Xur
Xur, Xur, Xur, Xur, Xur, Xur, Qsr, Qsr, Qsr, Qsr, Gsm, Cdc, Gsm, Uu, Gsm^Fst, Uu, Gsm, Gsm, Gsm, Uu, Uu, Gsm, Gsm, Qxua^Qhux, Qxua^Qhux, Qxua^Qhux, Qxua^Qhux, Qxua^Qhux, Qxua^Qhux, Qxua^Qhux, Qxua^Qhux, Uu, Qxua^Qhux, Gsm, Gsm, Gsm^Fst, Uu, Uu, Uu, Uu^Xsf, Qsr, Xur, Xur, Xur, Xur, Xur, Xur, Xur, Xur, Xur, Xur, Xur, Xur
Xur, Xur, Xur, Xur, Xur, Xur, Xur, Qsr, Qsr, Qsr, Cdc, Cdc, Cdc, Cdc, Gsm, Gsm, Uu, Uu, Gsm, Gsm, Uu, Uu, Uu, Gsm, Gsm, Uu^Xsf, Uu, Qxua^Qhux, Qxua^Qhux, Qxua^Qhux, Qxua^Qhux, Uu, Gsm^Fst, Uu, Gsm, Cdc, Cdc, Qxua^Qhux, Uu, Qsr, Xur, Xur, Xur, Xur, Xur, Xur, Xur, Xur, Xur, Xur, Xur, Xur, Xur
Xur, Xur, Xur, Xur, Xur, Xur, Xur, Xur, Xur, Xur, Cdc, Kdc, Cdc, Gsm, Uu, Gsm, Uu^Xsf, Gsm, Uu, Uu, Uu, Gsm, Gsm, Gsm, Uu, Gsm, Gsm, Gsm^Fst, Gsm^Fst, Uu, Gsm, Gsm^Fst, Uu, Uu, Cdc, Cdc, Kdc, Cdc, Gsm^Fst, Xur, Xur, Xur, Xur, Xur, Xur, Xur, Xur, Xur, Xur, Xur, Xur, Xur, Xur
Xur, Xur, Xur, Xur, Xur, Xur, Xur, Xur, Xur, Xur, Xur, Cdc, Uu, Cdc, Gsm, Uu, Uu, Uu, Gsm^Fst, Gsm, Gsm^Fst, Uu, Gsm^Fst, Uu, Gsm^Fst, Uu, Uu, Gsm, Gsm, Uu, Uu, Gsm, Gsm, Uu, Uu, Cdc, Cdc, Cdc, Gsm^Fst, Xur, Xur, Xur, Xur, Xur, Xur, Xur, Xur, Xur, Xur, Xur, Xur, Xur, Xur
Xur, Xur, Xur, Xur, Xur, Xur, Xur, Xur, Xur, Xur, Xur, Xur, Xur, Xur, Xur, Xur, Xur, Gsm^Fst, Gsm, Uu, Gsm^Fst, Uu, Uu, Uu, Uu, Gsm^Fst, Gsm^Fst, Gsm, Uu, Gsm, Uu, Gsm^Fst, Gsm^Fst, Gsm, Gsm, Cdc, Gsm^Fst, Gsm, Uu, Xur, Xur, Xur, Xur, Xur, Xur, Xur, Xur, Xur, Xur, Xur, Xur, Xur, Xur
Xur, Xur, Xur, Xur, Xur, Xur, Xur, Xur, Xur, Xur, Xur, Xur, Xur, Xur, Xur, Xur, Xur, Xur, Xur, Gsm^Fst, Uu, Gsm, Gsm, Uu, Gsm, Gsm^Fst, Xur, Uu, Xur, Uu^Xsf, Xur, Uu, Uu, Uu, Xur, Xur, Xur, Xur, Xur, Xur, Xur, Xur, Xur, Xur, Xur, Xur, Xur, Xur, Xur, Xur, Xur, Xur, Xur
Xur, Xur, Xur, Xur, Xur, Xur, Xur, Xur, Xur, Xur, Xur, Xur, Xur, Xur, Xur, Xur, Xur, Xur, Xur, Xur, Uu, Gsm, Gsm, Uu, Xur, Xur, Xur, Xur, Xur, Xur, Xur, Xur, Xur, Xur, Xur, Xur, Xur, Xur, Xur, Xur, Xur, Xur, Xur, Xur, Xur, Xur, Xur, Xur, Xur, Xur, Xur, Xur, Xur
Xur, Xur, Xur, Xur, Xur, Xur, Xur, Xur, Xur, Xur, Xur, Xur, Xur, Xur, Xur, Xur, Xur, Xur, Xur, Xur, Xur, Uu, Gsm, Gsm^Fst, Xur, Xur, Xur, Xur, Xur, Xur, Xur, Xur, Xur, Xur, Xur, Xur, Xur, Xur, Xur, Xur, Xur, Xur, Xur, Xur, Xur, Xur, Xur, Xur, Xur, Xur, Xur, Xur, Xur
Xur, Xur, Xur, Xur, Xur, Xur, Xur, Xur, Xur, Xur, Xur, Xur, Xur, Xur, Xur, Xur, Xur, Xur, Xur, Xur, Uu, Gsm^Fst, Gsm^Fst, Uu, Xur, Xur, Xur, Xur, Xur, Xur, Xur, Xur, Xur, Xur, Xur, Xur, Xur, Xur, Xur, Xur, Xur, Xur, Xur, Xur, Xur, Xur, Xur, Xur, Xur, Xur, Xur, Xur, Xur
Xur, Xur, Xur, Xur, Xur, Xur, Xur, Xur, Xur, Xur, Xur, Xur, Xur, Xur, Xur, Xur, Xur, Xur, Gsm, Gsm^Fst, Uu, Uu, Uu, Uu, Gsm^Fst, Xur, Xur, Xur, Xur, Xur, Xur, Xur, Xur, Xur, Xur, Xur, Xur, Xur, Xur, Xur, Xur, Xur, Xur, Xur, Xur, Xur, Xur, Xur, Xur, Xur, Xur, Xur, Xur
Xur, Xur, Xur, Xur, Xur, Xur, Xur, Xur, Xur, Xur, Xur, Xur, Xur, Xur, Xur, Xur, Uu^Fst, Gsm^Fst, Gsm, Uu, Gsm^Fst, Gsm^Fst, Uu, Gsm^Fst, Xur, Xur, Xur, Xur, Xur, Xur, Xur, Xur, Xur, Xur, Xur, Xur, Xur, Xur, Xur, Xur, Xur, Xur, Xur, Xur, Xur, Xur, Xur, Xur, Xur, Xur, Xur, Xur, Xur
Xur, Xur, Xur, Xur, Xur, Xur, Xur, Xur, Xur, Xur, Xur, Xur, Xur, Xur, Xur, Xur, Uu, Gsm, Gsm, Gsm, Gsm^Fst, Uu, Xur, Xur, Xur, Xur, Xur, Xur, Xur, Xur, Xur, Xur, Xur, Xur, Xur, Xur, Xur, Xur, Xur, Xur, Xur, Xur, Xur, Xur, Xur, Xur, Xur, Xur, Xur, Xur, Xur, Xur, Xur
Xur, Xur, Xur, Xur, Xur, Xur, Xur, Xur, Xur, Xur, Xur, Xur, Xur, Xur, Gsm^Fst, Gsm, Gsm^Fst, Uu^Fst, Xur, Xur, Xur, Xur, Xur, Xur, Xur, Xur, Xur, Xur, Xur, Xur, Xur, Xur, Xur, Xur, Gsm^Fst, Xur, Xur, Xur, Xur, Xur, Xur, Xur, Xur, Xur, Xur, Xur, Xur, Xur, Xur, Xur, Xur, Xur, Xur
Xur, Xur, Xur, Xur, Xur, Xur, Xur, Xur, Xur, Xur, Xur, Xur, Xur, Gsm^Fst, Uu, Gsm, Gsm, Uu, Xur, Xur, Xur, Xur, Xur, Xur, Xur, Xur, Xur, Xur, Xur, Xur, Xur, Xur, Gsm, Gsm, Gsm^Fst, Gsm, Gsm^Fst, Xur, Xur, Xur, Xur, Xur, Xur, Xur, Xur, Xur, Gsm^Fst, Gsm, Xur, Gsm, Gsm, Xur, Xur
Xur, Xur, Xur, Xur, Xur, Xur, Xur, Xur, Xur, Xur, Xur, Xur, Xur, Uu^Fst, Gsm, Gsm^Fst, Xur, Xur, Xur, Xur, Uu^Xsf, Xur, Gsm^Fst, Gsm^Fst, Gsm^Fst, Gsm, Gsm, Xur, Xur, Xur, Gsm, Gsm, Gsm^Fst, Gsm^Fst, Gsm, Gsm^Fst, Gsm^Fst, Gsm, Gsm^Fst, Xur, Gsm, Xur, Xur, Xur, Xur, Gsm, Uu, Gsm, Uu, Xur, Xur, Xur, Gsm
Xur, Xur, Xur, Xur, Xur, Xur, Xur, Xur, Xur, Xur, Xur, Xur, Xur, Gsm, Uu, Uu^Fst, Uu, Xur, Xur, Xur, Gsm, Gsm, Gsm, Gsm, Gsm, Gsm, Gsm^Fst, Gsm, Gsm, Gsm, Gsm^Fst, Gsm^Fst, Gsm, Gsm^Fst, Xur, Gsm, Gsm, Gsm^Fst, Gsm^Fst, Gsm, Gsm^Fst, Gsm, Gsm, Xur, Gsm^Fst, Gsm, Uu^Xsf, Gsm, Gsm^Fst, Gsm, Xur, Xur, Xur
Xur, Xur, Xur, Xur, Xur, Xur, Xur, Xur, Xur, Xur, Xur, Xur, Xur, Gsm^Fst, Uu^Fst, Gsm, Gsm^Fst, Xur, Gsm, Gsm, Gsm, Gsm^Fst, Gsm^Fst, Gsm, Gsm, Gsm^Fst, Uu^Xsf, Gsm^Fst, Gsm, Gsm^Fst, Gsm^Fst, Gsm, Gsm^Fst, Xur, Xur, Uu^Xsf, Gsm, Gsm^Fst, Gsm, Gsm^Fst, Gsm, Gsm^Fst, Gsm^Fst, Gsm, Gsm^Fst, Gsm^Fst, Gsm, Gsm, Uu, Gsm^Fst, Gsm, Gsm, Gsm^Fst
Uu, Gsm, Gsm, Xur, Xur, Xur, Xur, Xur, Xur, Xur, Xur, Xur, Xur, Xur, Xur, Gsm, Gsm, Gsm, Gsm^Fst, Gsm^Fst, Gsm, Gsm, Gsm, Gsm, Gsm, Gsm^Fst, Gsm^Fst, Gsm, Gsm^Fst, Gsm, Gsm, Gsm, Gsm, Gsm, Gsm, Gsm, Gsm^Fst, Gsm^Fst, Gsm, Xur, Gsm, Gsm, Gsm^Fst, Gsm, Gsm, Gsm, Gsm^Fst, Uu, Gsm, Gsm, Gsm^Fst, Uu, Uu
Uu, Gsm, Uu, Gsm, Gsm, Xur, Xur, Xur, Gsm, Xur, Gsm, Xur, Gsm, Xur, Xur, Gsm, Gsm^Fst, Gsm^Fst, Gsm^Fst, Gsm, Gsm, Gsm^Fst, Gsm^Fst, Gsm^Fst, Gsm^Fst, Gsm, Gsm, Gsm, Gsm, Gsm^Fst, Gsm^Fst, Gsm^Fst, Gsm^Fst, Gsm, Gsm^Fst, Gsm^Fst, Gsm, Gsm^Fst, Gsm^Fst, Gsm^Fst, Gsm, Gsm, Qsr, Gsm, Gsm, Gsm, Gsm, Gsm, Xur, Xur, Gsm, Gsm^Fst, Uu
Uu, Gsm, Gsm, Uu, Gsm, Uu, Gsm, Gsm, Uu, Gsm, Gsm, Gsm, Gsm, Gsm, Gsm, Gsm^Fst, Gsm^Fst, Gsm, Gsm^Fst, Gsm^Fst, Gsm, Gsm^Fst, Gsm, Gsm, Gsm, Gsm^Fst, Gsm^Fst, Gsm^Fst, Gsm, Gsm^Fst, Gsm^Fst, Gsm, Gsm, Gsm, Gsm, Gsm, Qsr, Gsm, Gsm, Gsm, Qsr, Qsr, Qsr, Qsr, Qsr, Gsm^Fst, Gsm, Gsm, Gsm, Xur, Gsm^Fst, Uu, Gsm^Fst
Gsm, Gsm^Fst, Xur, Xur, Uu, Gsm^Fst, Uu, Gsm^Fst, Uu, Gsm, Gsm^Fst, Gsm^Fst, Gsm, Gsm, Gsm^Fst, Gsm^Fst, Uu^Xsf, Gsm^Fst, Gsm, Gsm, Gsm^Fst, Gsm, Uu^Xsf, Gsm^Fst, Gsm, Gsm^Fst, Gsm^Fst, Gsm, Gsm, Gsm^Fst, Gsm, Gsm, Gsm, Gsm, Qsr, Qsr, Qsr, Qsr, Qsr, Qsr, Qsr, Qsr, Qsr, Qsr, Qsr, Qsr, Qsr, Gsm^Fst, Gsm, Gsm, Gsm, Gsm, Qsr
Gsm, Gsm^Fst, Xur, Xur, Gsm^Fst, Gsm, Uu, Gsm, Xur, Gsm, Gsm, Uu^Xsf, Gsm, Gsm^Fst, Gsm^Fst, Gsm, Gsm, Gsm^Fst, Gsm, Gsm^Fst, Gsm^Fst, Gsm, Gsm^Fst, Gsm^Fst, Gsm, Gsm, Gsm^Fst, Gsm, Gsm^Fst, Gsm, Gsm, Gsm, Qsr, Qsr, Qsr, Qsr, Qsr, Qsr, Qsr, Qsr, Qsr, Qsr, Qsr, Qsr, Qsr, Qsr, Qsr, Qsr, Qsr, Gsm, Qsr, Qsr, Qsr
Uu, Gsm, Xur, Gsm, Xur, Gsm, Gsm^Fst, Gsm, Xur, Xur, Gsm^Fst, Gsm, Gsm^Fst, Gsm^Fst, Gsm, Gsm, Gsm^Fst, Gsm^Fst, Gsm^Fst, Gsm, Gsm^Fst, Gsm, Gsm, Gsm, Gsm, Gsm, Gsm^Fst, Gsm, Gsm, Gsm^Fst, Gsm, Gsm, Qsr, Qsr, Qsr, Qsr, Qsr, Qsr, Qsr, Qsr, Qsr, Qsr, Gsm, Qsr, Qsr, Qsr, Qsr, Qsr, Qsr, Qsr, Qsr, Qsr, Qsr
Gsm, Uu, Gsm^Fst, Xur, Uu, Gsm, Uu, Gsm^Fst, Xur, Xur, Gsm^Fst, Uu, Gsm^Fst, Gsm^Fst, Gsm^Fst, Gsm, Gsm, Gsm^Fst, Gsm, Gsm, Gsm^Fst, Gsm, Gsm, Gsm^Fst, Gsm^Fst, Gsm^Fst, Gsm, Gsm, Gsm, Gsm, Qsr, Qsr, Qsr, Qsr, Qsr, Qsr, Qsr, Qsr, Qsr, Qsr, Gsm, Gsm, Gsm, Gsm, Gsm, Qsr, Qsr, Qsr, Qsr, Qsr, Qsr, Qsr, Qsr
Qsr, Gsm, Gsm, Uu, Gsm, Gsm^Fst, Gsm, Xur, Gsm^Fst, Gsm, Gsm, Gsm, Gsm, Gsm, Gsm, Gsm^Fst, Gsm, Gsm^Fst, Gsm^Fst, Gsm, Gsm^Fst, Gsm, Gsm^Fst, Gsm^Fst, Gsm, Gsm, Gsm, Gsm^Fst, Gsm, Gsm, Qsr, Qsr, Qsr, Qsr, Qsr, Gsm, Gsm, Gsm, Cdc, Gsm, Gsm, Gsm, Uu, Gsm, Gsm, Gsm, Gsm, Qsr, Qsr, Qsr, Qsr, Qsr, Gsm
Qsr, Qsr, Qsr, Gsm, Gsm, Uu, Gsm, Gsm, Gsm, Gsm, Qsr, Qsr, Qsr, Gsm, Qsr, Gsm, Gsm, Gsm^Fst, Gsm, Gsm^Fst, Gsm^Fst, Gsm^Fst, Gsm, Gsm, Gsm, Gsm, Gsm, Gsm, Gsm, Qsr, Qsr, Qsr, Qsr, Qsr, Qsr, Gsm, Gsm, Cdc, Kdc, Cdc, Gsm, Uu, Uu, Uu, Gsm, Gsm, Gsm, Gsm, Gsm, Gsm, Gsm, Gsm, Gsm
Qsr, Qsr, Qsr, Qsr, Qsr, Gsm, Gsm, Gsm, Gsm, Qsr, Qsr, Qsr, Qsr, Qsr, Qsr, Gsm, Gsm, Gsm^Fst, Gsm^Fst, Gsm, Gsm^Fst, Gsm^Fst, Gsm, Gsm, Qsr, Qsr, Qsr, Qsr, Qsr, Qsr, Qsr, Qsr, Qsr, Qsr, Gsm, Gsm, Gsm, Cdc, Cdc, Cdc, Gsm, Gsm, Uu, Gsm, Uu, Uu, Uu, Gsm, Gsm, Gsm, Gsm, Gsm, Xu
Qsr, Qsr, Qsr, Qsr, Qsr, Qsr, Qsr, Qsr, Qsr, Qsr, Qsr, Qsr, Qsr, Qsr, Qsr, Qsr, Qsr, Gsm, Gsm, Gsm, Gsm, Gsm, Qsr, Qsr, Qsr, Qsr, Qsr, Qsr, Qsr, Qsr, Qsr, Qsr, Qsr, Gsm, Gsm, Gsm, Gsm, Uu, Gsm, Gsm, Gsm, Uu, Gsm, Uu, Xur, Uu, Gsm, Uu, Gsm, Uu, Gsm, Xu, Xu
Qsr, Qsr, Qsr, Qsr, Qsr, Qsr, Qsr, Qsr, Qsr, Qsr, Qsr, Qsr, Qsr, Qsr, Qsr, Qsr, Qsr, Qsr, Qsr, Gsm, Qsr, Qsr, Qsr, Qsr, Qsr, Qsr, Qsr, Qsr, Qsr, Qsr, Qsr, Qsr, Gsm, Gsm, Gsm, Gsm, Uu, Gsm, Gsm, Uu, Gsm, Uu, Xur, Xur, Xur, Gsm, Uu, Gsm, Gsm, Uu, Uu, Xu, Xu
Gsm, Qsr, Qsr, Qsr, Qsr, Qsr, Qsr, Qsr, Qsr, Qsr, Gsm, Qsr, Gsm, Qsr, Qsr, Qsr, Qsr, Qsr, Qsr, Qsr, Qsr, Qsr, Qsr, Qsr, Qsr, Qsr, Qsr, Qsr, Gsm, Qsr, Gsm, Gsm, Gsm, Gsm, Gsm, Gsm, Uu, Uu, Gsm, Uu^Xsf, Gsm, Uu, Uu, Xur, Xur, Xur, Uu, Uu, Uu, Uu, Gsm, Gsm, Uu
Gsm, Gsm, Gsm, Qsr, Qsr, Qsr, Qsr, Qsr, Gsm, Gsm, Gsm, Gsm, Gsm, Gsm, Gsm, Qsr, Qsr, Qsr, Qsr, Qsr, Qsr, Qsr, Qsr, Qsr, Gsm, Gsm, Gsm, Gsm, Gsm, Gsm, Gsm, Gsm, Uu^Xsf, Uu, Uu, Uu, Gsm, Uu, Gsm, Uu, Gsm, Gsm, Uu, Uu, Uu, Gsm, Uu^Xsf, Uu, Uu, Uu, Uu, Uu, Gsm
Gsm, Gsm, Gsm, Gsm, Gsm, Gsm, Gsm, Gsm, Gsm, Gsm, Uu, Gsm, Gsm, Gsm, Gsm, Gsm, Gsm, Qsr, Qsr, Qsr, Qsr, Qsr, Gsm, Gsm, Gsm, Gsm, Gsm, Gsm, Gsm, Gsm, Xur, Gsm, Gsm, Gsm, Uu, Gsm, Uu, Uu, Xur, Gsm, Uu, Gsm, Uu, Uu, Uu, Uu, Uu, Uu, Uu, Uu, Uu, Gsm, Uu
Gsm, Uu, Uu, Gsm, Gsm, Gsm, Gsm, Gsm, Xur, Uu, Gsm, Gsm, Gsm, Uu, Uu^Xsf, Gsm, Gsm, Gsm, Gsm, Gsm, Gsm, Gsm, Gsm, Gsm, Gsm, Gsm, Gsm, Xur, Gsm, Gsm, Gsm, Gsm, Gsm, Gsm, Uu, Uu, Uu, Uu, Xur, Xur, Uu, Uu, Gsm, Gsm, Gsm, Uu, Gsm, Uu, Uu, Gsm, Uu, Uu, Xu
Gsm, Gsm, Gsm, Gsm, Uu^Xsf, Uu, Gsm, Xur, Xur, Gsm, Gsm, Gsm, Xur, Gsm, Uu, Gsm, Gsm, Gsm, Gsm, Gsm, Gsm, Gsm, Gsm, Xur, Gsm, Xur, Gsm, Xur, Xur, Xur, Gsm, Gsm, Uu, Uu, Uu, Gsm, Uu, Gsm, Gsm, Uu, Uu, Uu, Uu, Uu, Uu, Uu, Uu, Uu, Uu, Uu, Xu, Xu, Xu
Uu, Uu, Uu, Uu, Uu, Gsm, Uu, Gsm, Uu, Gsm, Uu, Gsm, Xur, Xur, Uu, Gsm, Uu, Gsm, Uu^Xsf, Gsm, Uu, Gsm, Uu, Gsm, Gsm, Gsm, Uu, Gsm, Gsm, Gsm, Uu, Gsm, Uu, Gsm, Uu, Uu, Uu, Uu, Uu, Uu, Uu, Uu, Uu, Uu^Xsf, Uu, Uu, Uu, Uu, Xu, Xu, Xu, Xu, Xu
Xu, Gsm, Uu, Uu, 1 Uu, Uu, Gsm, Uu, Uu, Uu, Gsm, Uu, Uu, Gsm, Gsm, Uu, Gsm, Uu, Gsm, Gsm, Gsm, Uu, Uu, Uu, Uu, Gsm, Uu, Gsm, Uu, Gsm, Uu, Gsm, Uu, Uu, Uu, Uu, Uu, Uu, Uu, Uu, Xu, Gsm, Xu, Uu, Uu, Uu, Uu, Uu, Xu, Xu, Xu, Xu, Xu
Xu, Uu, Gsm, Uu, Gsm, Uu, Gsm, Gsm, Gsm, Gsm, Uu, Uu, Uu, Gsm, Uu, Gsm, Uu, Uu, Uu, Gsm, Uu, Uu, Uu, Gsm, Uu, Gsm, Uu, Uu, Uu, Gsm, Xu, Uu, Xu, Uu, Gsm, Uu, Gsm, Gsm, Xu, Xu, Xu, Xu, Xu, Uu, Uu, Uu, Xu, Xu, Xu, Xu, Xu, Xu, Xu
Xu, Xu, Xu, Uu, Uu, Uu, Uu, Uu, Uu, Uu, Uu, Uu, Uu, Uu, Uu, Uu, Uu, Uu, Xur, Uu, Xur, Uu, Uu, Uu, Uu, Uu, Uu, Uu, Xu, Xu, Xu, Xu, Xu, Xu, Xu, Uu, Uu, Uu, Xu, Xu, Xu, Xu, Xu, Xu, Xu, Xu, Xu, Xu, Xu, Xu, Xu, Xu, Xu
Xu, Xu, Xu, Uu, Uu, Uu, Uu, Uu, Uu, Uu, Uu, Uu, Uu, Xur, Xur, Xur, Xur, Xur, Xur, Xur, Xur, Xur, Xur, Uu, Uu, Uu, Uu, Xu, Xu, Xu, Xu, Xu, Xu, Xu, Xu, Uu, Xu, Xu, Xu, Xu, Xu, Xu, Xu, Xu, Xu, Xu, Xu, Xu, Xu, Xu, Xu, Xu, Xu
