border_size=1
usage=map

Qxua, Qxua, Qxua, Qxua, Qxua, Qxua, Qxua, Qxua, Qxua, Qxua, Qxua, Qxua, Qxua, Qxua, Qxua, Qxua, Qxua, Qxua, Qxua, Qxua, Qxua, Qxua, Qxua, Qxua, Qxua, Qxua, Qxua, Qxua, Qxua, Qxua, Qxua, Qxua, Qxua, Qxua, Qxua, Qxua, Qxua, Qxua, Qxua, Qxua, Qxua, Qxua, Qxua, Qxua, Qxua, Qxua, Qxua, Qxua, Qxua, Qxua, Qxua, Qxua, Qxua
Qxua^Xel, Qxua, Qxua^Xel, Qxua, Qxua^Xel, Qxua, Qxua^Xel, Qxua, Qxua^Xel, Qxua, Qxua^Xel, Qxua, Qxua^Xel, Qxua, Qxua^Xel, Qxua, Qxua^Xel, Qxua, Qxua^Xel, Qxua, Qxua^Xel, Qxua, Qxua^Xel, Qxua, Qxua^Xel, Qxua, Qxua, Qxua, Qxua, Qxua, Qxua, Qxua, Qxua^Xel, Qxua, Qxua^Xel, Qxua, Qxua^Xel, Qxua, Qxua^Xel, Qxua, Qxua, Qxua, Qxua, Qxua, Qxua, Qxua, Qxua, Qxua, Qxua, Qxua, Qxua, Qxua, Qxua
Gsm, Qxua, Gsm, Qxua, Gsm, Qxua, Gsm, Qxua, Gsm, Qxua, Gsm, Qxua, Gsm, Qxua, Gsm, Qxua, Gsm, Qxua, Gsm, Qxua, Gsm, Qxua, Gsm, Qxua, Gsm, Qxua, Qxua^Xel, Qxua, Qxua^Xel, Qxua, Qxua^Xel, Qxua, Gsm, Qxua, Gsm^Esf, Gsm, Gsm^Esf, Gsm^Esf, Gsm^Esf, Qxua, Qxua^Xel, Qxua, Qxua^Xel, Qxua, Qxua^Xel, Qxua, Qxua^Xel, Qxua, Qxua^Xel, Qxua, Qxua^Xel, Qxua, Qxua^Xel
Gsm^Esf, Gsm^Esf, Gsm^Esf, Gsm, Gsm^Esf, Gsm, Gsm^Cov, Gsm^Cov, Gsm^Cov, Gsm^Esf, Gsm, Gsm^Esf, Gsm^Esf, Gsm, Gsm^Esf, Gsm^Esf, Gsm^Esf, Gsm^Esf, Gsm^Esf, Gsm, Gsm^Esf, Gsm, Gsm^Esf, Gsm^Esf, Gsm^Esf, Gsm^Esf, Gsm, Qxua, Gsm^Esf, Gsm^Esf, Gsm^Esf, Gsm, Gsm^Esf, Gsm^Esf, Gsm^Esf, Gsm^Esf, Gsm, Gsm^Esf, Gsm^Esf, Gsm, Gsm, Qxua, Gsm^Esf, Gsm^Esf, Gsm^Esf, Qxua, Gsm^Esf, Gsm^Esf, Gsm^Esf, Gsm^Esf, Gsm^Esf, Gsm^Esf, Gsm^Esf
Gsm^Fst, Gsm^Esf, Gsm, Gsm, Gsm, Gsm, Gsm^Cov, Gsm^Kov, Gsm^Cov, Gsm, Gsm^Esf, Gsm^Esf, Gsm^Esf, Gsm^Esf, Gsm^Esf, Gsm^Esf, Gsm^Esf, Gsm^Esf, Gsm^Esf, Gsm^Esf, Gsm, Gsm^Esf, Gsm, Gsm, Gsm^Esf, Gsm^Esf, Gsm^Esf, Gsm, Gsm^Cov, Gsm^Cov, Gsm^Cov, Gsm^Esf, Gsm^Esf, Gsm^Esf, Gsm^Esf, Gsm, Gsm^Esf, Gsm, Gsm^Esf, Gsm^Esf, Gsm^Esf, Gsm^Esf, Gsm^Esf, Gsm^Esf, Gsm, Gsm^Esf, Gsm, Gsm^Esf, Gsm^Esf, Gsm^Esf, Gsm, Gsm, Gsm^Fst
Gsm^Fst, Gsm^Fst, Gsm^Fst, Gsm, Gsm, Gsm^Esf, Gsm^Esf, Gsm^Cov, Gsm, Gsm^Esf, Gsm, Gsm^Esf, Gsm^Esf, Gsm, Gsm, Gsm, Gsm, Gsm, Gsm, Gsm^Esf, Gsm^Esf, Gsm^Esf, Gsm, Gsm^Esf, Gsm, Gsm, Gsm^Esf, Gsm^Esf, Gsm^Cov, Gsm^Kov, Gsm^Cov, Gsm, Gsm, Gsm^Esf, Gsm, Gsm^Esf, Gsm, Gsm^Esf, Gsm, Gsm^Esf, Gsm, Gsm, Gsm^Fst, Gsm^Fst, Gsm^Fst, Gsm, Gsm^Fst, Gsm, Gsm^Fst, Gsm^Fst, Gsm^Fst, Gsm^Fst, Gsm
Qsr, Qsr, Qsr, Gsm^Fst, Gsm^Fst, Gsm^Esf, Gsm, Gsm^Esf, Gsm, Gsm^Fst, Gsm^Fst, Gsm, Gsm^Fst, Gsm^Fst, Gsm, Gsm^Fst, Gsm^Fst, Gsm, Gsm, Gsm, Gsm, Gsm, Gsm, Gsm, Gsm, Gsm, Xu, Gsm^Esf, Gsm, Gsm^Cov, Xu, Xu, Xu, Xu, Xu, Gsm, Xu, Gsm, Xu, Gsm, Gsm, Gsm, Gsm^Fst, Gsm^Fst, Gsm^Fst, Gsm^Fst, Gsm, Gsm^Fst, Gsm^Fst, Gsm^Fst, Gsm^Fst, Gsm^Fst, Gsm^Fst
Qsr, Qsr, Qsr, Gsm, Gsm^Fst, Gsm^Fst, Gsm^Fst, Gsm^Fst, Gsm^Fst, Gsm^Fst, Qsr, Gsm, Gsm^Fst, Gsm^Fst, Gsm^Fst, Gsm^Fst, Xu, Xu, Xu, Gsm, Xu, Gsm, Gsm, Gsm, Gsm, Xu, Xu, Xu, Xu, Xu, Xu, Xu, Xu, Xu, Xu, Xu, Xu, Xu, Xu, Xu, Xu, Xu, Xu^Fst, Gsm^Fst, Qsr, Qsr, Qsr, Qsr, Qsr, Qsr, Qsr, Gsm^Fst, Qsr
Xu, Qsr, Qsr, Qsr, Qsr, Gsm, Qsr, Gsm, Qsr, Qsr, Qsr, Qsr, Qsr, Qsr, Qsr, Qsr, Qsr, Xu, Xu, Xu, Xu, Gsm, Gsm, Gsm, Gsm, Xu, Xu, Xu, Xu, Xu, Xu, Xu, Xu, Xu, Xu, Xu, Xu, Xu, Xu, Xu, Xu, Xu, Xu, Qsr, Qsr, Qsr, Qsr, Qsr, Qsr, Qsr, Qsr, Qsr, Qsr
Xu, Qsr, Xu, Qsr, Qsr, Qsr, Qsr, Qsr, Qsr, Qsr, Xu, Qsr, Xu, Qsr, Xu, Qsr, Qsr, Qsr, Xu, Xu, Xu, Xu, Gsm, Gsm, Xu, Xu, Xu, Xu, Xu, Xu, Xu, Xu, Xu, Xu, Xu, Xu, Xu, Xu, Xu, Xu, Xu, Xu, Xu, Qsr, Qsr, Qsr, Xu, Xu, Xu, Xu, Xu, Xu, Xu
Xu, Xu, Xu, Xu, Xu, Xu, Xu, Xu, Xu, Xu, Xu, Xu, Xu, Xu, Xu, Xu, Qsr, Qsr, Xu, Xu, Xu, Gsm, Uu, Uu, Uu, Xu, Xu, Xu, Uu, Uu, Gsm, Uu, Uu, Uu, Uu, Xu, Xu, Xu, Xu, Xu, Xu, Xu, Xu, Qsr, Qsr, Xu, Qsr, Xu, Xu, Xu, Xu, Xu, Xu
Xu, Xu, Xu, Xu, Xu, Xu, Xu, Xu, Xu, Xu, Xu, Xu, Qsr, Xu, Qsr, Qsr, Qsr, Qsr, Xu, Xu, Xu, Uu, Uu, Gsm, Uu, Uu, Gsm, Uu, Gsm^Fst, Uu, Gsm^Fst, Uu, Gsm, Uu, Uu, Xu, Xu, Xu, Xu, Xu, Xu, Xu, Xu, Qsr, Qsr, Qsr, Qsr, Qsr, Xu, Xu, Xu, Xu, Xu
Xu, Xu, Xu, Xu, Xu, Xu, Xu, Xu, Xu, Xu, Qsr, Qsr, Qsr, Qsr, Qsr, Qsr, Xu, Xu, Xu, Xu, Xu, Xu, Xu, Uu, Uu, Gsm^Fst, Uu, Uu, Xu, Uu, Uu, Uu, Uu, Gsm^Fst, Xu, Xu, Xu, Xu, Xu, Xu, Xu, Xu, Xu, Xu, Xu, Qsr, Qsr, Qsr, Xu, Xu, Xu, Xu, Xu
Qsr, Xu, Xu, Xu, Qsr, Xu, Xu, Xu, Qsr, Qsr, Qsr, Qsr, Qsr, Qsr, Xu, Xu, Xu, Xu, Xu, Xu, Xu, Xu, Xu, Xu, Xu, Xu, Xu, Xu, Xu, Xu, Cdc, Gsm^Fst, Uu, Uu, Xu, Xu, Xu, Xu, Xu, Xu, Xu, Xu, Xu, Xu, Xu, Xu, Qsr, Qsr, Xu, Xu, Xu, Xu, Xu
Qsr, Qsr, Qsr, Qsr, Qsr, Qsr, Qsr, Qsr, Qsr, Qsr, Xu, Xu, Xu, Xu, Xu, Xu, Xu, Xu, Xu, Xu, Xu, Xu, Xu, Xu, Xu, Xu, Xu, Xu, Gsm^Fst, Cdc, Kdc, Cdc, Gsm, Xu, Xu, Xu, Xu, Xu, Xu, Xu, Xu, Xu, Xu, Xu, Xu, Xu, Qsr, Qsr, Xu, Xu, Xu, Xu, Xu
Qsr, Qsr, Qsr, Qsr, Qsr, Qsr, Qsr, Qsr, Xu, Xu, Xu, Xu, Xu, Xu, Xu, Xu, Xu, Xu, Xu, Xu, Xu, Xu, Xu, Xu, Xu, Xu, Qsr, Uu, Kdc, Cdc, Cdc, Cdc, Kdc, Xu, Xu, Xu, Xu, Xu, Xu, Xu, Xu, Xu, Xu, Xu, Xu, Qsr, Qsr, Qsr, Qsr, Xu, Xu, Xu, Xu
Xu, Xu, Xu, Xu, Xu, Xu, Xu, Xu, Xu, Xu, Xu, Xu, Xu, Xu, Xu, Xu, Xu, Xu, Xu, Xu, Xu, Xu, Xu, Xu, Qsr, Qsr, Qsr, Gsm^Fst, Gsm, Gsm^Fst, Uu, Uu^Fst, Gsm, Uu, Gsm^Fst, Xu, Xu, Xu, Xu, Xu, Xu, Xu, Xu, Xu, Xu, Xu, Qsr, Qsr, Qsr, Qsr, Qsr, Xu, Xu
Xu, Xu, Xu, Xu, Xu, Xu, Xu, Xu, Xu, Xu, Xu, Xu, Xu, Xu, Xu, Xu, Xu, Xu, Xu, Xu, Xu, Xu, Xu, Xu, Xu, Qsr, Qsr, Gsm^Fst, Gsm^Fst, Gsm, Gsm, Gsm, Gsm^Fst, Gsm, Gsm^Fst, Xu, Xu, Xu, Xu, Xu, Xu, Xu, Xu, Xu, Xu, Xu, Xu, Qsr, Qsr, Qsr, Qsr, Qsr, Qsr
Xu, Xu, Xu, Xu, Xu, Xu, Xu, Xu, Xu, Xu, Xu, Xu, Xu, Xu, Xu, Xu, Xu, Xu, Xu, Xu, Xu, Xu, Xu, Xu, Xu, Qsr, Uu, Uu, Uu, Gsm, Uu, Uu, Uu, Uu, Xu, Xu, Xu, Xu, Xu, Xu, Xu, Xu, Xu, Xu, Xu, Xu, Xu, Xu, Xu, Xu, Xu, Qsr, Qsr
Xu, Xu, Xu, Xu, Xu, Xu, Xu, Xu, Xu, Xu, Qsr, Qsr, Qsr, Xu, Xu, Xu, Xu, Xu, Xu, Xu, Xu, Xu, Xu, Xu, Xu, Xu, Uu, Uu^Xsf, Uu, Gsm, Uu, Uu^Xsf, Uu, Uu, Xu, Xu, Xu, Xu, Xu, Xu, Xu, Xu, Xu, Xu, Xu, Xu, Xu, Xu, Xu, Xu, Xu, Xu, Qsr
Xu, Xu, Xu, Xu, Xu, Xu, Xu, Xu, Xu, Qsr, Cdc, Cdc, Cdc, Qsr, Qsr, Qsr, Qsr, Qsr, Gsm^Fst, Xu, Uu, Xu, Xu, Xu, Uu, Uu, Uu, Uu, Uu, Gsm, Gsm, Uu, Uu, Xu, Xu, Xu, Xu, Xu, Xu, Xu, Xu, Xu, Xu, Xu, Xu, Xu, Xu, Xu, Xu, Xu, Xu, Xu, Xu
Xu, Xu, Xu, Xu, Xu, Xu, Xu, Xu, Xu, Qsr, Cdc, Kdc, Cdc, Kdc, Uu, Qsr, Qsr, Qsr, Uu, Gsm, Gsm, Gsm, Gsm, Uu, Uu, Gsm^Fst, Gsm^Fst, Qxu, Uu, Uu, Gsm, Gsm, Gsm, Xu, Xu, Xu, Xu, Xu, Xu, Xu, Xu, Xu, Xu, Xu, Xu, Xu, Xu, Xu, Xu, Xu, Xu, Xu, Xu
Xu, Xu, Xu, Xu, Xu, Xu, Qsr, Xu, Qsr, Qsr, Kdc, Cdc, Uu, Uu, Gsm^Fst, Gsm, Gsm^Fst, Gsm^Fst, Gsm, Gsm, Uu, Uu^Xsf, Uu, Gsm^Fst, Uu, Qxu, Gsm, Gsm, Uu, Gsm, Qxu, Gsm, Gsm, Uu, Xu, Xu, Xu, Xu, Xu, Xu, Xu, Xu, Xu, Xu, Xu, Xu, Xu, Xu, Xu, Xu, Xu, Xu, Xu
Xu, Xu, Xu, Xu, Xu, Qsr, Uu, Qsr, Uu, Uu, Uu, Uu, Uu, Uu, Uu, Uu, Gsm, Gsm, Gsm, Gsm, Uu, Uu, Gsm^Fst, Gsm, Qxu, Uu, Gsm, Uu, Uu, Qxu, Qxu, Uu, Gsm, Uu, Xu, Xu, Xu, Xu, Xu, Xu, Xu, Xu, Xu, Xu, Xu, Xu, Xu, Xu, Xu, Xu, Xu, Xu, Xu
Xu, Xu, Xu, Xu, Xu, Qsr, Uu, Gsm, Gsm^Fst, Gsm^Fst, Gsm, Uu, Uu, Uu, Gsm, Gsm^Fst, Qxu, Uu, Uu, Gsm^Fst, Uu, Gsm, Uu, Uu, Uu, Uu, Gsm, Uu, Uu, Qxu, Qxu, Qxu, Gsm, Gsm, Qsr, Qsr, Qsr, Xu, Xu, Xu, Xu, Xu, Xu, Xu, Xu, Xu, Xu, Xu, Xu, Xu, Xu, Xu, Xu
Xu, Xu, Xu, Xu, Qsr, Qsr, Gsm, Uu, Uu, Uu, Gsm, Gsm, Gsm^Fst, Uu, Gsm, Qxu, Qxu, Uu^Xsf, Uu, Gsm, Gsm^Fst, Gsm, Qxu, Uu, Gsm, Gsm, Uu, Uu^Xsf, Uu, Uu, Uu, Gsm, Gsm, Uu^Xsf, Qsr, Qsr, Qsr, Qsr, Xu, Xu, Xu, Xu, Xu, Xu, Xu, Xu, Xu, Xu, Xu, Xu, Xu, Xu, Xu
Xu, Xu, Xu, Xu, Qsr, Qsr, Qsr, Uu^Xsf, Uu, Uu, Gsm, Uu, Gsm, Gsm^Fst, Gsm, Uu, Uu, Uu, Gsm, Gsm, Uu, Uu, Uu, Qxu, Qxu, Gsm, Uu, Uu, Gsm, Gsm^Fst, Gsm, Gsm^Fst, Uu, Gsm^Fst, Gsm^Fst, Qsr, Qsr, Qsr, Uu, Xu, Xu, Xu, Xu, Xu, Xu, Xu, Xu, Xu, Xu, Xu, Xu, Xu, Xu
Xu, Xu, Xu, Qsr, Qsr, Qsr, Qsr, Uu, Gsm^Fst, Gsm, Uu, Uu, Uu^Xsf, Uu, Uu, Gsm, Gsm, Gsm, Gsm, Uu, Qxu, Uu, Qxu, Qxu, Qxu, Qxu, Uu, Gsm^Fst, Gsm, Uu, Qxu, Uu, Uu, Gsm, Gsm, Uu, Uu, Uu^Xsf, Uu, Xu, Xu, Xu, Xu, Xu, Xu, Xu, Xu, Xu, Xu, Xu, Xu, Xu, Xu
Xu, Xu, Xu, Xu, Xu, Qsr, Uu, Gsm^Fst, Gsm^Fst, Uu, Gsm^Fst, Gsm, Uu, Uu, Qxu, Uu, Qxu, Uu, Uu, Qxu, Qxu, Qxu, Qxu, Qxu, Qxu, Qxu, Gsm^Fst, Gsm, Uu, Uu, Uu, Qxu, Uu, Uu, Uu, Gsm, Uu, Gsm^Fst, Gsm, Xu, Xu, Xu, Xu, Xu, Xu, Xu, Xu, Xu, Xu, Xu, Xu, Xu, Xu
Xu, Xu, Xu, Xu, Xu, Xu, Xu, Uu, Uu, Uu, Uu, Gsm, Uu, Gsm^Fst, Qxu, Qxu, Qxu, Qxu, Qxu, Qxu, Qxu, Qxu, Qxu, Qxu, Qxu, Uu, Uu, Uu, Qxu, Uu, Gsm, Uu, Uu, Uu^Xsf, Uu, Uu, Uu, Uu, Uu, Gsm, Xu, Xu, Xu, Xu, Xu, Xu, Xu, Xu, Xu, Xu, Xu, Xu, Xu
Xu, Xu, Xu, Xu, Xu, Xu, Xu, Uu, Uu^Xsf, Uu, Gsm, Gsm, Uu, Qxu, Qxu, Qxu, Qxu, Qxu, Qxu, Qxu, Qxu, Qxu, Qxu, Qxu, Qxu, Qxu, Qxu, Qxu, Qxu, Qxu, Qxu, Gsm, Qxu, Uu, Uu, Uu, Gsm^Fst, Gsm^Fst, Uu, Gsm^Fst, Xu, Xu, Xu, Xu, Xu, Xu, Xu, Xu, Xu, Xu, Xu, Xu, Xu
Xu, Xu, Xu, Xu, Xu, Xu, Qsr, Gsm^Fst, Qsr, Gsm^Fst, Gsm^Fst, Gsm, Uu, Qxu, Gsm, Gsm, Uu^Xsf, Uu, Uu, Qxu, Uu, Qxu, Qxu, Qxu, Qxu, Qxu, Qxu, Qxu, Qxu, Qxu, Qxu, Gsm, Gsm, Uu, Uu, Uu, Uu, Gsm^Fst, Uu, Uu, Qsr, Xu, Xu, Xu, Xu, Xu, Xu, Xu, Xu, Xu, Xu, Xu, Xu
Xu, Xu, Xu, Xu, Xu, Xu, Qsr, Qsr, Qsr, Qsr, Gsm, Kdc, Gsm, Uu, Gsm^Fst, Uu, Gsm, Gsm, Gsm, Uu, Uu, Gsm, Gsm, Qxu, Qxu, Qxu, Qxu, Qxu, Qxu, Qxu, Qxu, Uu, Qxu, Gsm, Gsm, Gsm^Fst, Uu, Uu, Uu, Uu^Xsf, Qsr, Xu, Xu, Xu, Xu, Xu, Xu, Xu, Xu, Xu, Xu, Xu, Xu
Xu, Xu, Xu, Xu, Xu, Xu, Xu, Qsr, Qsr, Qsr, Cdc, Cdc, Cdc, Kdc, Gsm, Gsm, Uu, Uu, Gsm, Gsm, Uu, Uu, Uu, Gsm, Gsm, Uu^Xsf, Uu, Qxu, Qxu, Qxu, Qxu, Uu, Gsm^Fst, Uu, Gsm, Kdc, Cdc, Qxu, Uu, Qsr, Xu, Xu, Xu, Xu, Xu, Xu, Xu, Xu, Xu, Xu, Xu, Xu, Xu
Xu, Xu, Xu, Xu, Xu, Xu, Xu, Xu, Xu, Xu, Cdc, Kdc, Cdc, Gsm, Uu, Gsm, Uu^Xsf, Gsm, Uu, Uu, Uu, Gsm, Gsm, Gsm, Uu, Gsm, Gsm, Gsm^Fst, Gsm^Fst, Uu, Gsm, Gsm^Fst, Uu, Uu, Kdc, Cdc, Kdc, Cdc, Gsm^Fst, Xu, Xu, Xu, Xu, Xu, Xu, Xu, Xu, Xu, Xu, Xu, Xu, Xu, Xu
Xu, Xu, Xu, Xu, Xu, Xu, Xu, Xu, Xu, Xu, Xu, Cdc, Uu, Kdc, Gsm, Uu, Uu, Uu, Gsm^Fst, Gsm, Gsm^Fst, Uu, Gsm^Fst, Uu, Gsm^Fst, Uu, Uu, Gsm, Gsm, Uu, Uu, Gsm, Gsm, Uu, Uu, Cdc, Cdc, Cdc, Gsm^Fst, Xu, Xu, Xu, Xu, Xu, Xu, Xu, Xu, Xu, Xu, Xu, Xu, Xu, Xu
Xu, Xu, Xu, Xu, Xu, Xu, Xu, Xu, Xu, Xu, Xu, Xu, Xu, Xu, Xu, Xu, Xu, Gsm^Fst, Gsm, Uu, Gsm^Fst, Uu, Uu, Uu, Uu, Gsm^Fst, Gsm^Fst, Gsm, Uu, Gsm, Uu, Gsm^Fst, Gsm^Fst, Gsm, Gsm, Kdc, Gsm^Fst, Gsm, Uu, Xu, Xu, Xu, Xu, Xu, Xu, Xu, Xu, Xu, Xu, Xu, Xu, Xu, Xu
Xu, Xu, Xu, Xu, Xu, Xu, Xu, Xu, Xu, Xu, Xu, Xu, Xu, Xu, Xu, Xu, Xu, Xu, Xu, Gsm^Fst, Uu, Gsm, Gsm, Uu, Gsm, Gsm^Fst, Xu, Uu, Xu, Uu^Xsf, Xu, Uu, Uu, Uu, Xu, Xu, Xu, Xu, Xu, Xu, Xu, Xu, Xu, Xu, Xu, Xu, Xu, Xu, Xu, Xu, Xu, Xu, Xu
Xu, Xu, Xu, Xu, Xu, Xu, Xu, Xu, Xu, Xu, Xu, Xu, Xu, Xu, Xu, Xu, Xu, Xu, Xu, Xu, Uu, Gsm, Gsm, Uu, Xu, Xu, Xu, Xu, Xu, Xu, Xu, Xu, Xu, Xu, Xu, Xu, Xu, Xu, Xu, Xu, Xu, Xu, Xu, Xu, Xu, Xu, Xu, Xu, Xu, Xu, Xu, Xu, Xu
Xu, Xu, Xu, Xu, Xu, Xu, Xu, Xu, Xu, Xu, Xu, Xu, Xu, Xu, Xu, Xu, Xu, Xu, Xu, Xu, Xu, Uu, Gsm, Gsm^Fst, Xu, Xu, Xu, Xu, Xu, Xu, Xu, Xu, Xu, Xu, Xu, Xu, Xu, Xu, Xu, Xu, Xu, Xu, Xu, Xu, Xu, Xu, Xu, Xu, Xu, Xu, Xu, Xu, Xu
Xu, Xu, Xu, Xu, Xu, Xu, Xu, Xu, Xu, Xu, Xu, Xu, Xu, Xu, Xu, Xu, Xu, Xu, Xu, Xu, Uu, Gsm^Fst, Gsm^Fst, Uu, Xu, Xu, Xu, Xu, Xu, Xu, Xu, Xu, Xu, Xu, Xu, Xu, Xu, Xu, Xu, Xu, Xu, Xu, Xu, Xu, Xu, Xu, Xu, Xu, Xu, Xu, Xu, Xu, Xu
Xu, Xu, Xu, Xu, Xu, Xu, Xu, Xu, Xu, Xu, Xu, Xu, Xu, Xu, Xu, Xu, Xu, Xu, Xu, Gsm^Fst, Uu, Uu, Uu, Uu, Gsm^Fst, Xu, Xu, Xu, Xu, Xu, Xu, Xu, Xu, Xu, Xu, Xu, Xu, Xu, Xu, Xu, Xu, Xu, Xu, Xu, Xu, Xu, Xu, Xu, Xu, Xu, Xu, Xu, Xu
Xu, Xu, Xu, Xu, Xu, Xu, Xu, Xu, Xu, Xu, Xu, Xu, Xu, Xu, Xu, Xu, Xu, Xu, Xu, Gsm, Gsm^Fst, Gsm^Fst, Uu, Gsm^Fst, Uu, Xu, Xu, Xu, Xu, Xu, Xu, Xu, Xu, Xu, Xu, Xu, Xu, Xu, Xu, Xu, Xu, Xu, Xu, Xu, Xu, Xu, Xu, Xu, Xu, Xu, Xu, Xu, Xu
Xu, Xu, Xu, Xu, Xu, Xu, Xu, Xu, Xu, Xu, Xu, Xu, Xu, Xu, Xu, Xu, Xu, Xu, Xu, Xu, Gsm^Fst, Uu, Uu, Gsm^Fst, Xu, Xu, Xu, Xu, Xu, Xu, Xu, Xu, Xu, Xu, Xu, Xu, Xu, Xu, Xu, Xu, Xu, Xu, Xu, Xu, Xu, Xu, Xu, Xu, Xu, Xu, Xu, Xu, Xu
Xu, Xu, Xu, Xu, Xu, Xu, Xu, Xu, Xu, Xu, Xu, Xu, Xu, Xu, Xu, Xu, Xu, Xu, Xu, Xu, Xu, Uu, Uu, Gsm, Uu, Xu, Xu, Xu, Xu, Xu, Xu, Xu, Xu, Xu, Gsm^Fst, Xu, Xu, Xu, Xu, Xu, Xu, Xu, Xu, Xu, Xu, Gsm, Xu, Xu, Xu, Xu, Xu, Xu, Xu
Xu, Xu, Xu, Xu, Xu, Xu, Xu, Xu, Xu, Xu, Xu, Xu, Xu, Xu, Xu, Xu, Xu, Xu, Xu, Xu, Xu, Gsm^Fst, Gsm, Gsm^Fst, Gsm, Xu, Xu, Xu, Xu, Xu, Xu, Xu, Gsm, Gsm, Gsm^Fst, Gsm, Gsm^Fst, Xu, Xu, Xu, Xu, Xu, Xu, Gsm, Xu, Xu, Gsm^Fst, Gsm, Xu, Gsm, Gsm, Xu, Xu
Xu, Xu, Xu, Xu, Xu, Xu, Xu, Xu, Xu, Xu, Xu, Xu, Xu, Xu, Xu, Xu, Xu, Xu, Xu, Xu, Gsm, Gsm, Gsm^Fst, Gsm^Fst, Gsm^Fst, Gsm, Gsm, Xu, Xu, Xu, Gsm, Gsm, Gsm^Fst, Gsm^Fst, Gsm, Gsm^Fst, Gsm^Fst, Gsm, Gsm^Fst, Xu, Gsm, Xu, Xu, Gsm, Xu, Gsm, Uu, Gsm, Uu, Xu, Xu, Xu, Gsm
Xu, Xu, Xu, Xu, Xu, Xu, Xu, Xu, Xu, Xu, Xu, Xu, Xu, Xu, Xu, Xu, Xu, Xu, Xu, Xu, Gsm, Gsm, Gsm, Gsm, Gsm, Gsm, Gsm^Fst, Gsm, Gsm, Gsm, Gsm^Fst, Gsm^Fst, Gsm, Gsm^Fst, Xu, Gsm, Gsm, Gsm^Fst, Gsm^Fst, Gsm, Gsm^Fst, Gsm, Gsm, Xu, Gsm^Fst, Gsm, Uu, Gsm, Gsm^Fst, Gsm, Xu, Xu, Xu
Xu, Xu, Xu, Xu, Xu, Xu, Xu, Xu, Xu, Xu, Xu, Xu, Xu, Xu, Xu, Xu, Xu, Xu, Gsm, Gsm, Gsm, Gsm^Fst, Gsm^Fst, Gsm, Gsm, Gsm^Fst, Gsm, Gsm^Fst, Gsm, Gsm^Fst, Gsm^Fst, Gsm, Gsm^Fst, Xu, Xu, Gsm, Gsm, Gsm^Fst, Gsm, Gsm^Fst, Gsm, Gsm^Fst, Gsm^Fst, Gsm, Gsm^Fst, Gsm^Fst, Gsm, Gsm, Uu, Gsm^Fst, Gsm, Gsm, Gsm^Fst
Uu, Gsm, Gsm, Xu, Xu, Xu, Xu, Xu, Xu, Xu, Xu, Xu, Xu, Xu, Xu, Xu, Gsm, Gsm, Gsm^Fst, Gsm^Fst, Gsm, Gsm, Gsm, Gsm, Gsm, Gsm^Fst, Gsm^Fst, Gsm, Gsm^Fst, Gsm, Gsm, Gsm, Gsm, Gsm, Gsm, Gsm, Gsm^Fst, Gsm^Fst, Gsm, Xu, Gsm, Gsm, Gsm^Fst, Gsm, Gsm, Gsm, Gsm^Fst, Uu, Gsm, Gsm, Gsm^Fst, Uu, Uu
Uu, Gsm, Uu, Gsm, Gsm, Xu, Xu, Xu, Gsm, Xu, Gsm, Xu, Gsm, Xu, Xu, Gsm, Gsm^Fst, Gsm^Fst, Gsm^Fst, Gsm, Gsm, Gsm^Fst, Gsm^Fst, Gsm^Fst, Gsm^Fst, Gsm, Gsm, Gsm, Gsm, Gsm^Fst, Gsm^Fst, Gsm^Fst, Gsm^Fst, Gsm, Gsm^Fst, Gsm^Fst, Gsm, Gsm^Fst, Gsm^Fst, Gsm^Fst, Gsm, Gsm, Qsr, Gsm, Gsm, Uu, Gsm, Gsm, Xu, Xu, Gsm, Gsm^Fst, Uu
Uu, Gsm, Gsm, Uu, Gsm, Uu, Gsm, Gsm, Uu, Gsm, Gsm, Gsm, Gsm, Gsm, Gsm, Gsm^Fst, Gsm^Fst, Gsm, Gsm^Fst, Gsm^Fst, Gsm, Gsm^Fst, Gsm, Gsm, Gsm, Gsm^Fst, Gsm^Fst, Gsm^Fst, Gsm, Gsm^Fst, Gsm^Fst, Gsm, Gsm, Gsm, Gsm, Gsm, Qsr, Gsm, Gsm, Gsm, Qsr, Qsr, Qsr, Qsr, Qsr, Gsm^Fst, Gsm, Gsm, Gsm, Xu, Gsm^Fst, Uu, Gsm^Fst
Gsm, Gsm^Fst, Xu, Xu, Uu, Gsm^Fst, Uu, Gsm^Fst, Uu, Gsm, Gsm^Fst, Gsm^Fst, Gsm, Gsm, Gsm^Fst, Gsm^Fst, Gsm, Gsm^Fst, Gsm, Gsm, Gsm^Fst, Gsm, Gsm, Gsm^Fst, Gsm, Gsm^Fst, Gsm^Fst, Gsm, Gsm, Gsm^Fst, Gsm, Gsm, Gsm, Gsm, Qsr, Qsr, Qsr, Qsr, Qsr, Qsr, Qsr, Qsr, Qsr, Qsr, Qsr, Qsr, Qsr, Gsm^Fst, Gsm, Gsm, Gsm, Gsm, Qsr
Gsm, Gsm^Fst, Xu, Xu, Gsm^Fst, Gsm, Uu, Gsm, Xu, Gsm, Gsm, Uu, Gsm, Gsm^Fst, Gsm^Fst, Gsm, Gsm, Gsm^Fst, Gsm, Gsm^Fst, Gsm^Fst, Gsm, Gsm^Fst, Gsm^Fst, Gsm, Gsm, Gsm^Fst, Gsm, Gsm^Fst, Gsm, Gsm, Gsm, Qsr, Qsr, Qsr, Qsr, Qsr, Qsr, Qsr, Qsr, Qsr, Qsr, Qsr, Qsr, Qsr, Qsr, Qsr, Qsr, Qsr, Gsm, Qsr, Qsr, Qsr
Uu, Gsm, Xu, Gsm, Xu, Gsm, Gsm^Fst, Gsm, Xu, Xu, Gsm^Fst, Gsm, Gsm^Fst, Gsm^Fst, Gsm, Gsm, Gsm^Fst, Gsm^Fst, Gsm^Fst, Gsm, Gsm^Fst, Gsm, Gsm, Gsm, Gsm, Gsm, Gsm^Fst, Gsm, Gsm, Gsm^Fst, Gsm, Gsm, Qsr, Qsr, Qsr, Qsr, Qsr, Qsr, Qsr, Qsr, Qsr, Qsr, Uu, Qsr, Qsr, Qsr, Qsr, Qsr, Qsr, Qsr, Qsr, Qsr, Qsr
Gsm, Uu, Gsm^Fst, Xu, Uu, Gsm, Uu, Gsm^Fst, Xu, Xu, Gsm^Fst, Uu, Gsm^Fst, Gsm^Fst, Gsm^Fst, Gsm, Gsm, Gsm^Fst, Gsm, Gsm, Gsm^Fst, Gsm, Gsm, Gsm^Fst, Gsm^Fst, Gsm^Fst, Gsm, Gsm, Gsm, Gsm, Qsr, Qsr, Qsr, Qsr, Qsr, Qsr, Qsr, Qsr, Qsr, Qsr, Gsm, Gsm, Gsm, Gsm, Gsm, Qsr, Qsr, Qsr, Qsr, Qsr, Qsr, Qsr, Qsr
Qsr, Gsm, Gsm, Uu, Gsm, Gsm^Fst, Gsm, Xu, Gsm^Fst, Gsm, Gsm, Gsm, Gsm, Gsm, Gsm, Gsm^Fst, Gsm, Gsm^Fst, Gsm^Fst, Gsm, Gsm^Fst, Gsm, Gsm^Fst, Gsm^Fst, Gsm, Gsm, Gsm, Gsm^Fst, Gsm, Gsm, Qsr, Qsr, Qsr, Qsr, Qsr, Uu, Gsm, Uu, Cdc, Gsm, Uu, Uu, Uu, Uu, Uu, Gsm, Uu, Qsr, Qsr, Qsr, Qsr, Qsr, Gsm
Qsr, Qsr, Qsr, Gsm, Gsm, Uu, Gsm, Gsm, Gsm, Gsm, Qsr, Qsr, Qsr, Gsm, Qsr, Gsm, Gsm, Gsm^Fst, Gsm, Gsm^Fst, Gsm^Fst, Gsm^Fst, Gsm, Gsm, Gsm, Gsm, Gsm, Gsm, Gsm, Qsr, Qsr, Qsr, Qsr, Qsr, Qsr, Gsm, Uu, Cdc, Kdc, Cdc, Gsm, Uu, Uu, Uu, Gsm, Gsm, Gsm, Uu, Gsm, Uu, Uu, Gsm, Gsm
Qsr, Qsr, Qsr, Qsr, Qsr, Gsm, Gsm, Gsm, Gsm, Qsr, Qsr, Qsr, Qsr, Qsr, Qsr, Gsm, Gsm, Gsm^Fst, Gsm^Fst, Gsm, Gsm^Fst, Gsm^Fst, Gsm, Gsm, Qsr, Qsr, Qsr, Qsr, Qsr, Qsr, Qsr, Qsr, Qsr, Qsr, Uu, Uu, Gsm, Cdc, Cdc, Cdc, Gsm, Gsm, Uu, Gsm, Uu, Uu, Uu, Gsm, Gsm, Gsm, Gsm, Gsm, Xu
Qsr, Qsr, Qsr, Qsr, Qsr, Qsr, Qsr, Qsr, Qsr, Qsr, Qsr, Qsr, Qsr, Qsr, Qsr, Qsr, Qsr, Gsm, Gsm, Gsm, Gsm, Gsm, Qsr, Qsr, Qsr, Qsr, Qsr, Qsr, Qsr, Qsr, Qsr, Qsr, Qsr, Uu, Uu, Uu, Gsm, Uu, Gsm, Gsm, Gsm, Uu, Gsm, Uu, Xu, Uu, Gsm, Uu, Gsm, Uu, Gsm, Xu, Xu
Qsr, Qsr, Qsr, Qsr, Qsr, Qsr, Qsr, Qsr, Qsr, Qsr, Qsr, Qsr, Qsr, Qsr, Qsr, Qsr, Qsr, Qsr, Qsr, Gsm, Qsr, Qsr, Qsr, Qsr, Qsr, Qsr, Qsr, Qsr, Qsr, Qsr, Qsr, Qsr, Uu, Uu, Uu, Gsm, Uu, Gsm, Gsm, Uu, Gsm, Uu, Xu, Xu, Xu, Gsm, Uu, Gsm, Gsm, Uu, Uu, Xu, Xu
Uu, Qsr, Qsr, Qsr, Qsr, Qsr, Qsr, Qsr, Qsr, Qsr, Gsm, Qsr, Uu, Qsr, Qsr, Qsr, Qsr, Qsr, Qsr, Qsr, Qsr, Qsr, Qsr, Qsr, Qsr, Qsr, Qsr, Qsr, Uu, Qsr, Gsm, Gsm, Gsm, Gsm, Gsm, Gsm, Uu, Uu, Gsm, Uu^Xsf, Gsm, Uu, Uu, Xu, Xu, Xu, Uu, Uu, Uu, Uu, Gsm, Gsm, Uu
Uu, Uu, Uu, Qsr, Qsr, Qsr, Qsr, Qsr, Uu, Gsm, Gsm, Gsm, Uu, Uu, Uu, Qsr, Qsr, Qsr, Qsr, Qsr, Qsr, Qsr, Qsr, Qsr, Uu, Uu, Uu, Uu, Uu, Uu, Gsm, Gsm, Uu^Xsf, Uu, Uu, Uu, Gsm, Uu, Gsm, Uu, Gsm, Gsm, Uu, Uu, Uu, Gsm, Uu^Xsf, Uu, Uu, Uu, Uu, Uu, Gsm
Gsm, Gsm, Gsm, Gsm, Uu, Uu, Uu, Uu, Gsm, Gsm, Uu, Gsm, Gsm, Uu, Gsm, Uu, Gsm, Qsr, Qsr, Qsr, Qsr, Qsr, Gsm, Gsm, Uu, Uu, Gsm, Gsm, Gsm, Gsm, Xu, Gsm, Gsm, Gsm, Uu, Gsm, Uu, Uu, Xu, Gsm, Uu, Gsm, Uu, Uu, Uu, Uu, Uu, Uu, Uu, Uu, Uu, Gsm, Uu
Gsm, Uu, Uu, Gsm, Gsm, Uu, Gsm, Gsm, Xu, Uu, Gsm, Gsm, Gsm, Uu, Uu^Xsf, Gsm, Gsm, Uu, Uu, Uu, Uu, Uu, Gsm, Gsm, Gsm, Gsm, Gsm, Xu, Gsm, Gsm, Gsm, Gsm, Gsm, Gsm, Uu, Uu, Uu, Uu, Xu, Xu, Uu, Uu, Gsm, Gsm, Gsm, Uu, Gsm, Uu, Uu, Gsm, Uu, Uu, Xu
Gsm, Gsm, Gsm, Gsm, Uu^Xsf, Uu, Gsm, Xu, Xu, Gsm, Gsm, Gsm, Xu, Gsm, Uu, Gsm, Gsm, Gsm, Gsm, Uu, Gsm, Uu, Gsm, Xu, Gsm, Xu, Gsm, Xu, Xu, Xu, Gsm, Gsm, Uu, Uu, Uu, Gsm, Uu, Gsm, Gsm, Uu, Uu, Uu, Uu, Uu, Uu, Uu, Uu, Uu, Uu, Uu, Xu, Xu, Xu
Uu, Uu, Uu, Uu, Uu, Gsm, Uu, Gsm, Uu^Cov, Gsm, Uu, Gsm, Xu, Xu, Uu, Gsm, Uu, Gsm, Uu^Xsf, Gsm, Uu, Gsm, Uu, Gsm, Gsm, Gsm, Uu, Gsm, Gsm, Gsm, Uu, Gsm, Uu, Gsm, Uu, Uu, Uu, Uu, Uu, Uu, Uu, Uu, Uu, Uu^Xsf, Uu, Uu, Uu, Uu, Xu, Xu, Xu, Xu, Xu
Xu, Gsm, Uu, Uu, Uu, Uu, Gsm, Uu^Cov, 1 Uu^Kov, Uu^Cov, Gsm, Uu, Uu, Gsm, Gsm, Uu, Gsm, Uu, Gsm, Gsm, Gsm, Uu, Uu, Uu, Uu, Gsm, Uu, Gsm, Uu, Gsm, Uu, Gsm, Uu, Uu, Uu, Uu, Uu, Uu, Uu, Uu, Xu, Gsm, Xu, Uu, Uu, Uu, Uu, Uu, Xu, Xu, Xu, Xu, Xu
Xu, Uu, Gsm, Uu, Gsm, Uu, Gsm, Gsm^Cov, Gsm^Cov, Gsm^Cov, Uu, Uu, Uu, Gsm, Uu, Gsm, Uu, Uu, Uu, Gsm, Uu, Uu, Uu, Gsm, Uu, Gsm, Uu, Uu, Uu, Gsm, Xu, Uu, Xu, Uu, Gsm, Uu, Gsm, Gsm, Xu, Xu, Xu, Xu, Xu, Uu, Uu, Uu, Xu, Xu, Xu, Xu, Xu, Xu, Xu
Xu, Xu, Xu, Uu, Uu, Uu, Uu, Uu, Uu, Uu, Uu, Uu, Uu, Uu, Uu, Uu, Uu, Uu, Xu, Uu, Xu, Uu, Uu, Uu, Uu, Uu, Uu, Uu, Xu, Xu, Xu, Xu, Xu, Xu, Xu, Uu, Uu, Uu, Xu, Xu, Xu, Xu, Xu, Xu, Xu, Xu, Xu, Xu, Xu, Xu, Xu, Xu, Xu
Xu, Xu, Xu, Uu, Uu, Uu, Uu, Uu, Uu, Uu, Uu, Uu, Uu, Xu, Xu, Xu, Xu, Xu, Xu, Xu, Xu, Xu, Xu, Uu, Uu, Uu, Uu, Xu, Xu, Xu, Xu, Xu, Xu, Xu, Xu, Uu, Xu, Xu, Xu, Xu, Xu, Xu, Xu, Xu, Xu, Xu, Xu, Xu, Xu, Xu, Xu, Xu, Xu
