border_size=1
usage=map

Qxdp, Qxdp, Qxdp, Qxdp, Qxdp, Qxdp, Qxdp, Qxdp, Qxdp, Qxdp, Qxdp, Qxdp, Qxdp, Qxdp, Qxdp, Qxdp, Qxdp^Xel, Qxu, Qxu, Qxdp, Qxu, Qxu, Qxu, Qxdp^Xel, Qxdp^Xel, Qxdp, Qxdp, Qxdp, Qxdp, Qxdp, Qxdp, Qxdp, Qxdp, Qxdp, Qxdp
Qxdp, Qxdp, Qxdp, Qxdp, Qxdp, Qxdp, Qxdp, Qxdp, Qxdp, Qxdp, Qxdp, Qxdp, Qxdp, Qxdp, Qxdp, Qxdp, Qxdp^Xel, Qxdp, Qxdp, Qxu, Qxu, Qxu, Qxdp, Qxdp^Xel, Qxdp, Qxdp, Qxdp, Qxdp, Qxdp, Qxdp, Qxdp, Qxdp, Qxdp, Qxdp, Qxdp
Qxdp, Qxdp, Qxdp, Qxdp, Qxdp, Qxdp, Qxdp, Qxdp, Qxdp, Qxdp, Qxdp, Qxdp, Qxdp, Qxdp, Qxdp, Qxdp, Qxdp, Qxdp^Xel, Qxdp^Xel, Qxu, Qxdp, Qxu, Qxdp^Xel, Qxdp^Xel, Qxdp, Qxdp, Qxdp, Qxdp, Qxdp, Qxdp, Qxdp, Qxdp, Qxdp, Qxdp, Qxdp
Qxdp, Qxdp, Qxdp, Qxdp, Qxdp, Qxdp, Qxdp, Qxdp, Qxdp, Qxdp, Qxdp, Qxdp, Qxdp, Qxdp, Qxdp, Qxdp, Qxdp, Qxdp, Qxdp^Xel, Qxdp, Qxdp, Qxdp, Qxdp^Xel, Qxdp, Qxdp, Qxdp, Qxdp, Qxdp, Qxdp, Qxdp, Qxdp, Qxdp, Qxdp, Qxdp, Qxdp
Qxdp, Qxdp, Qxdp, Qxdp, Qxdp, Qxdp, Qxdp, Qxdp, Qxdp, Qxdp, Qxdp, Qxdp, Qxdp, Qxdp, Qxdp, Qxdp, Qxdp, Qxdp, Qxdp, Qxdp^Xel, Qxdp, Qxdp^Xel, Qxdp, Qxdp, Qxdp, Qxdp, Qxdp, Qxdp, Qxdp, Qxdp, Qxdp, Qxdp, Qxdp, Qxdp, Qxdp
Qxdp, Qxdp, Qxdp, Qxdp, Qxdp, Qxdp, Qxdp, Qxdp, Qxdp, Qxdp, Qxdp, Qxdp, Qxdp, Qxdp, Qxdp, Qxdp, Qxdp, Qxdp, Qxdp, Qxdp^Xel, Qxdp, Qxdp^Xel, Qxdp, Qxdp, Qxdp, Qxdp, Qxdp, Qxdp, Qxdp, Qxdp, Qxdp, Qxdp, Qxdp, Qxdp, Qxdp
Qxdp, Qxdp, Qxdp, Qxdp, Qxdp, Qxdp, Qxdp, Qxdp, Qxdp, Qxdp, Qxdp, Qxdp, Qxdp, Qxdp, Qxdp, Qxdp, Qxdp, Qxdp, Qxdp, Qxdp^Xel, Qxdp, Qxdp^Xel, Qxdp, Qxdp, Qxdp, Qxdp, Qxdp, Qxdp, Qxdp, Qxdp, Qxdp, Qxdp, Qxdp, Qxdp, Qxdp
Qxdp, Qxdp, Qxdp, Qxdp, Qxdp, Qxdp, Qxdp, Qxdp, Qxdp, Qxdp, Qxdp, Qxdp, Qxdp, Qxdp, Qxdp, Qxdp, Qxdp, Qxdp, Qxdp^Xel, Qxdp^Xel, Qxdp, Qxdp^Xel, Qxdp^Xel, Qxdp, Qxdp, Qxdp, Qxdp, Qxdp, Qxdp, Qxdp, Qxdp, Qxdp, Qxdp, Qxdp, Qxdp
Qxdp, Qxdp, Qxdp, Qxdp, Qxdp, Qxdp, Qxdp, Qxdp, Qxdp, Qxdp, Qxdp, Qxdp, Qxdp, Qxdp, Qxdp, Qxdp, Qxdp, Qxdp^Xel, Qxdp, Qxdp, Qxdp, Qxdp, Qxdp, Qxdp^Xel, Qxdp, Qxdp, Qxdp, Qxdp, Qxdp, Qxdp, Qxdp, Qxdp, Qxdp, Qxdp, Qxdp
Qxdp, Qxdp, Qxdp, Qxdp, Qxdp, Qxdp, Qxdp, Qxdp, Qxdp, Qxdp, Qxdp, Qxdp, Qxdp, Qxdp, Qxdp, Qxdp, Qxdp, Qxdp^Xel, Qxdp, Qxdp, Qxdp, Qxdp, Qxdp, Qxdp^Xel, Qxdp, Qxdp, Qxdp, Qxdp, Qxdp, Qxdp, Qxdp, Qxdp, Qxdp, Qxdp, Qxdp
Qxdp, Qxdp, Qxdp, Qxdp, Qxdp, Qxdp, Qxdp, Qxdp, Qxdp, Qxdp, Qxdp, Qxdp, Qxdp, Qxdp, Qxdp, Qxdp, Qxdp, Qxdp^Xel, Qxdp, Qxdp, Qxdp, Qxdp, Qxdp, Qxdp^Xel, Qxdp, Qxdp, Qxdp, Qxdp, Qxdp, Qxdp, Qxdp, Qxdp, Qxdp, Qxdp, Qxdp
Qxdp, Qxdp, Qxdp, Qxdp, Qxdp, Qxdp, Qxdp, Qxdp, Qxdp, Qxdp, Qxdp, Qxdp, Qxdp, Qxdp, Qxdp, Qxdp, Qxdp, Qxdp^Xel, Qxdp^Xel, Qxdp, Qxdp, Qxdp, Qxdp^Xel, Qxdp^Xel, Qxdp, Qxdp, Qxdp, Qxdp, Qxdp, Qxdp, Qxdp, Qxdp, Qxdp, Qxdp, Qxdp
Qxdp, Qxdp, Qxdp, Qxdp, Qxdp, Qxdp, Qxdp, Qxdp, Qxdp, Qxdp, Qxdp, Qxdp, Qxdp, Qxdp, Qxdp, Qxdp, Qxdp, Qxdp, Qxdp, Qxdp^Xel, Qxdp, Qxdp^Xel, Qxdp, Qxdp, Qxdp, Qxdp, Qxdp, Qxdp, Qxdp, Qxdp, Qxdp, Qxdp, Qxdp, Qxdp, Qxdp
Qxdp, Qxdp, Qxdp, Qxdp, Qxdp, Qxdp, Qxdp, Qxdp, Qxdp, Qxdp, Qxdp, Qxdp, Qxdp, Qxdp, Qxdp, Qxdp, Qxdp, Qxdp, Qxdp, Qxdp^Xel, Qxdp, Qxdp^Xel, Qxdp, Qxdp, Qxdp, Qxdp, Qxdp, Qxdp, Qxdp, Qxdp, Qxdp, Qxdp, Qxdp, Qxdp, Qxdp
Qxdp, Qxdp, Qxdp, Qxdp, Qxdp, Qxdp, Qxdp, Qxdp, Qxdp, Qxdp, Qxdp, Qxdp, Qxdp, Qxdp, Qxdp, Qxdp, Qxdp, Qxdp, Qxdp, Qxdp^Xel, Qxdp, Qxdp^Xel, Qxdp, Qxdp, Qxdp, Qxdp, Qxdp, Qxdp, Qxdp, Qxdp, Qxdp, Qxdp, Qxdp, Qxdp, Qxdp
Qxdp, Qxdp, Qxdp, Qxdp, Qxdp, Qxdp, Qxdp, Qxdp, Qxdp, Qxdp, Qxdp, Qxdp, Qxdp, Qxdp, Qxdp, Qxdp, Qxdp, Qxdp, Qxdp, Qxdp^Xel, Qxdp, Qxdp^Xel, Qxdp, Qxdp, Qxdp, Qxdp, Qxdp, Qxdp, Qxdp, Qxdp, Qxdp, Qxdp, Qxdp, Qxdp, Qxdp
Qxdp, Qxdp, Qxdp, Qxdp, Qxdp, Qxdp, Qxdp, Qxdp, Qxdp, Qxdp, Qxdp, Qxdp, Qxdp, Qxdp, Qxdp, Qxdp, Qxdp, Qxdp, Qxdp^Xel, Qxdp^Xel, Qxdp, Qxdp^Xel, Qxdp^Xel, Qxdp, Qxdp, Qxdp, Qxdp, Qxdp, Qxdp, Qxdp, Qxdp, Qxdp, Qxdp, Qxdp, Qxdp
Qxdp, Qxdp, Qxdp, Qxdp, Qxdp, Qxdp, Qxdp, Qxdp, Qxdp, Qxdp, Qxdp, Qxdp, Qxdp, Qxdp, Qxdp, Qxdp, Qxdp, Qxdp^Xel, Qxdp, Qxdp, Qxdp, Qxdp, Qxdp, Qxdp^Xel, Qxdp^Xel, Qxdp, Qxdp, Qxdp, Qxdp, Qxdp, Qxdp, Qxdp, Qxdp, Qxdp, Qxdp
Qxdp, Qxdp, Qxdp, Qxdp, Qxdp, Qxdp, Qxdp, Qxdp, Qxdp, Qxdp, Qxdp, Qxdp, Qxdp^Xel, Qxdp, Qxdp, Qxdp, Qxdp, Qxdp^Xel, Qxdp, Qxdp, Qxdp, Qxdp, Qxdp, Qxdp, Qxdp^Xel, Qxdp, Qxdp, Qxdp, Qxdp, Qxdp, Qxdp, Qxdp, Qxdp, Qxdp, Qxdp
Qxdp, Qxdp, Qxdp, Qxdp, Qxdp, Qxdp, Qxdp, Qxdp, Qxdp, Qxdp, Qxdp^Xel, Qxdp^Xel, Qxdp, Qxdp^Xel, Qxdp^Xel, Qxdp, Qxdp, Qxdp^Xel, Qxdp, Qxdp, Qxdp, Qxdp, Qxdp, Qxdp, Qxdp^Xel, Qxdp, Qxdp, Qxdp, Qxdp, Qxdp, Qxdp, Qxdp, Qxdp, Qxdp, Qxdp
Qxdp, Qxdp, Qxdp, Qxdp, Qxdp, Qxdp, Qxdp, Qxdp, Qxdp^Xel, Qxdp^Xel, Qxdp, Qxdp, Qxdp, Qxdp, Qxdp, Qxdp^Xel, Qxdp^Xel, Qxdp^Xel, Qxdp, Qxdp, Qxdp, Qxdp, Qxdp, Qxdp, Qxdp^Xel, Qxdp, Qxdp, Qxdp, Qxdp, Qxdp, Qxdp, Qxdp, Qxdp, Qxdp, Qxdp
Qxdp, Qxdp, Qxdp, Qxdp, Qxdp, Qxdp, Qxdp^Xel, Qxdp^Xel, Qxdp, Qxdp, Qxdp, Qxdp, Qxdp^Xel, Qxdp, Qxdp, Qxdp, Qxdp, Qxdp, Qxdp, Qxdp, Qxdp, Qxdp, Qxdp^Xel, Qxdp^Xel, Qxdp, Qxdp, Qxdp, Qxdp, Qxdp, Qxdp, Qxdp, Qxdp, Qxdp, Qxdp, Qxdp
Qxdp, Qxdp, Qxdp, Qxdp, Qxdp, Qxdp^Xel, Qxdp, Qxdp, Qxdp, Qxdp, Qxdp^Xel, Qxdp^Xel, Qxdp, Qxdp^Xel, Qxdp^Xel, Qxdp, Qxdp, Qxdp, Qxdp^Xel, Qxdp, Qxdp^Xel, Qxdp^Xel, Qxdp, Qxdp, Qxdp, Qxdp, Qxdp, Qxdp, Qxdp, Qxdp, Qxdp, Qxdp, Qxdp, Qxdp, Qxdp
Qxdp, Qxdp, Qxdp, Qxdp, Qxdp, Qxdp^Xel, Qxdp, Qxdp, Qxdp^Xel, Qxdp^Xel, Qxdp, Qxdp, Qxdp, Qxdp, Qxdp, Qxdp^Xel, Qxdp^Xel, Qxdp^Xel, Qxdp, Qxdp^Xel, Qxdp, Qxdp, Qxdp, Qxdp, Qxdp, Qxdp, Qxdp, Qxdp, Qxdp, Qxdp, Qxdp, Qxdp, Qxdp, Qxdp, Qxdp
Qxdp, Qxdp, Qxdp, Qxdp, Qxdp, Qxdp^Xel, Qxdp, Qxdp^Xel, Qxdp, Qxdp, Qxdp, Qxdp, Qxdp, Qxdp, Qxdp, Qxdp, Qxdp, Qxdp, Qxdp, Qxdp, Qxdp, Qxdp, Qxdp, Qxdp, Qxdp, Qxdp, Qxdp^Xel, Qxdp^Xel, Qxdp^Xel, Qxdp, Qxdp, Qxdp, Qxdp, Qxdp, Qxdp
Qxdp, Qxdp, Qxdp, Qxdp, Qxdp, Qxdp^Xel, Qxdp, Qxdp^Xel, Qxdp, Qxdp, Qxdp, Qxdp, Qxdp, Qxdp, Qxdp, Qxdp, Qxdp, Qxdp, Qxdp, Qxdp, Qxdp, Qxdp, Qxdp, Qxdp, Qxdp^Xel, Qxdp^Xel, Qxdp, Qxdp, Qxdp, Qxdp^Xel, Qxdp^Xel, Qxdp, Qxdp, Qxdp, Qxdp
Qxdp, Qxdp, Qxdp, Qxdp, Qxdp^Xel, Qxdp^Xel, Qxdp, Qxdp^Xel, Qxdp^Xel, Qxdp, Qxdp, Qxdp, Qxdp, Qxdp, Qxdp^Xel, Qxdp^Xel, Qxdp^Xel, Qxdp, Qxdp, Qxdp, Qxdp, Qxdp, Qxdp^Xel, Qxdp^Xel, Qxdp, Qxdp, Qxdp, Qxdp, Qxdp, Qxdp, Qxdp^Xel, Qxdp, Qxdp, Qxdp, Qxdp
Qxdp, Qxdp, Qxdp^Xel, Qxdp^Xel, Qxdp, Qxdp, Qxdp, Qxdp, Qxdp, Qxdp^Xel, Qxdp^Xel, Qxdp, Qxdp^Xel, Qxdp^Xel, Qxdp, Qxdp, Qxdp, Qxdp^Xel, Qxdp^Xel, Qxdp, Qxdp^Xel, Qxdp^Xel, Qxdp, Qxdp, Qxdp, Qxdp, Qxdp^Xel, Qxdp^Xel, Qxdp^Xel, Qxdp, Qxdp^Xel, Qxdp, Qxdp, Qxdp, Qxdp
Qxdp, Qxdp^Xel, Qxdp, Qxdp, Qxdp, Qxdp, Qxdp, Qxdp, Qxdp, Qxdp, Qxdp, Qxdp^Xel, Qxdp, Qxdp, Qxdp^Xel, Qxdp, Qxdp, Qxdp, Qxdp, Qxdp^Xel, Qxdp, Qxdp, Qxdp, Qxdp, Qxdp^Xel, Qxdp^Xel, Qxdp, Qxdp, Qxdp^Xel, Qxdp, Qxdp^Xel, Qxdp, Qxdp, Qxdp, Qxdp
Qxdp, Qxdp^Xel, Qxdp, Qxdp, Qxdp, Qxdp, Qxdp, Qxdp, Qxdp, Qxdp, Qxdp, Qxdp, Qxdp^Xel, Qxdp^Xel, Qxdp, Qxdp^Xel, Qxdp^Xel, Qxdp, Qxdp, Qxdp, Qxdp, Qxdp, Qxdp^Xel, Qxdp^Xel, Qxdp, Qxdp, Qxdp, Qxdp, Qxdp^Xel, Qxdp, Qxdp^Xel, Qxdp, Qxdp, Qxdp, Qxdp
Qxdp, Qxdp^Xel, Qxdp, Qxdp, Qxdp, Qxdp, Qxdp, Qxdp, Qxdp, Qxdp, Qxdp, Qxdp^Xel, Qxdp, Qxdp, Qxdp, Qxdp, Qxdp, Qxdp^Xel, Qxdp^Xel, Qxdp, Qxdp^Xel, Qxdp^Xel, Qxdp, Qxdp, Qxdp, Qxdp, Qxdp, Qxdp, Qxdp^Xel, Qxdp, Qxdp^Xel, Qxdp, Qxdp, Qxdp, Qxdp
Qxdp, Qxdp^Xel, Qxdp, Qxdp, Qxdp, Qxdp, Qxdp, Qxdp, Qxdp, Qxdp, Qxdp, Qxdp^Xel, Qxdp, Qxdp, Qxdp, Qxdp, Qxdp, Qxdp, Qxdp, Qxdp^Xel, Qxdp, Qxdp, Qxdp, Qxdp, Qxdp, Qxdp, Qxdp^Xel, Qxdp^Xel, Qxdp, Qxdp, Qxdp, Qxdp^Xel, Qxdp^Xel, Qxdp, Qxdp
Qxdp, Qxdp^Xel, Qxdp^Xel, Qxdp, Qxdp, Qxdp, Qxdp, Qxdp, Qxdp, Qxdp, Qxdp^Xel, Qxdp^Xel, Qxdp, Qxdp, Qxdp, Qxdp, Qxdp, Qxdp, Qxdp, Qxdp, Qxdp, Qxdp, Qxdp, Qxdp, Qxdp^Xel, Qxdp^Xel, Qxdp, Qxdp, Qxdp, Qxdp, Qxdp, Qxdp, Qxdp, Qxdp^Xel, Qxdp
Qxdp, Qxdp, Qxdp, Qxdp^Xel, Qxdp^Xel, Qxdp, Qxdp, Qxdp, Qxdp^Xel, Qxdp^Xel, Qxdp, Qxdp, Qxdp, Qxdp, Qxdp, Qxdp, Qxdp, Qxdp, Qxdp, Qxdp, Qxdp, Qxdp, Qxdp^Xel, Qxdp^Xel, Qxdp, Qxdp, Qxdp, Qxdp, Qxdp, Qxdp, Qxdp, Qxdp, Qxdp, Qxdp^Xel, Qxdp
Qxdp, Qxdp, Qxdp, Qxdp, Qxdp, Qxdp^Xel, Qxdp^Xel, Qxdp^Xel, Qxdp, Qxdp, Qxdp, Qxdp, Qxdp, Qxdp, Qxdp, Qxdp, Qxdp, Qxdp, Qxdp, Qxdp, Qxdp^Xel, Qxdp^Xel, Qxdp, Qxdp, Qxdp, Qxdp, Qxdp, Qxdp, Qxdp, Qxdp, Qxdp, Qxdp, Qxdp, Qxdp^Xel, Qxdp
Qxdp, Qxdp, Qxdp, Qxdp, Qxdp, Qxdp, Qxdp, Qxdp, Qxdp, Qxdp, Qxdp, Qxdp, Qxdp, Qxdp, Qxdp, Qxdp, Qxdp, Qxdp, Qxdp^Xel, Qxdp^Xel, Qxdp, Qxdp, Qxdp, Qxdp, Qxdp, Qxdp, Qxdp, Qxdp, Qxdp, Qxdp, Qxdp, Qxdp, Qxdp, Qxdp^Xel, Qxdp
Qxdp, Qxdp, Qxdp, Qxdp, Qxdp, Qxdp, Qxdp, Qxdp, Qxdp, Qxdp, Qxdp, Qxdp, Qxdp, Qxdp, Qxdp, Qxdp, Qxdp^Xel, Qxdp^Xel, Qxdp, Qxdp, Qxdp, Qxdp, Qxdp^Xel, Qxdp^Xel, Qxdp^Xel, Qxdp, Qxdp, Qxdp, Qxdp, Qxdp, Qxdp, Qxdp, Qxdp, Qxdp^Xel, Qxdp
Qxdp, Qxdp, Qxdp, Qxdp, Qxdp, Qxdp, Qxdp, Qxdp, Qxdp, Qxdp, Qxdp, Qxdp, Qxdp, Qxdp, Qxdp^Xel, Qxdp^Xel, Qxdp, Qxdp, Qxdp, Qxdp, Qxdp^Xel, Qxdp^Xel, Qxdp, Qxdp, Qxdp, Qxdp^Xel, Qxdp, Qxdp, Qxdp, Qxdp, Qxdp, Qxdp, Qxdp, Qxdp^Xel, Qxdp
Qxdp, Qxdp, Qxdp, Qxdp, Qxdp, Qxdp, Qxdp, Qxdp, Qxdp, Qxdp, Qxdp, Qxdp, Qxdp, Qxdp, Qxdp^Xel, Qxdp, Qxdp, Qxdp, Qxdp^Xel, Qxdp^Xel, Qxdp, Qxdp, Qxdp, Qxdp, Qxdp, Qxdp^Xel, Qxdp^Xel, Qxdp, Qxdp, Qxdp, Qxdp, Qxdp, Qxdp^Xel, Qxdp^Xel, Qxdp
Qxdp, Qxdp, Qxdp, Qxdp, Qxdp, Qxdp, Qxdp, Qxdp, Qxdp, Qxdp, Qxdp, Qxdp, Qxdp, Qxdp, Qxdp^Xel, Qxdp, Qxdp, Qxdp, Qxdp^Xel, Qxdp, Qxdp, Qxdp, Qxdp, Qxdp, Qxdp, Qxdp, Qxdp, Qxdp^Xel, Qxdp^Xel, Qxdp, Qxdp^Xel, Qxdp^Xel, Qxdp, Qxdp, Qxdp
Qxdp, Qxdp, Qxdp, Qxdp, Qxdp, Qxdp, Qxdp, Qxdp, Qxdp, Qxdp, Qxdp, Qxdp, Qxdp, Qxdp, Qxdp^Xel, Qxdp, Qxdp, Qxdp, Qxdp^Xel, Qxdp, Qxdp, Qxdp, Qxdp, Qxdp, Qxdp, Qxdp, Qxdp, Qxdp, Qxdp, Qxdp^Xel, Qxdp, Qxdp, Qxdp, Qxdp, Qxdp
Qxdp, Qxdp, Qxdp, Qxdp, Qxdp, Qxdp, Qxdp, Qxdp, Qxdp, Qxdp, Qxdp, Qxdp, Qxdp, Qxdp, Qxdp^Xel, Qxdp, Qxdp, Qxdp, Qxdp^Xel, Qxdp, Qxdp, Qxdp, Qxdp, Qxdp, Qxdp, Qxdp, Qxdp, Qxdp, Qxdp, Qxdp, Qxdp, Qxdp, Qxdp, Qxdp, Qxdp
Qxdp, Qxdp, Qxdp, Qxdp, Qxdp, Qxdp, Qxdp, Qxdp, Qxdp, Qxdp, Qxdp, Qxdp, Qxdp, Qxdp, Qxdp^Xel, Qxdp, Qxdp, Qxdp, Qxdp, Qxdp^Xel, Qxdp^Xel, Qxdp, Qxdp, Qxdp, Qxdp, Qxdp, Qxdp, Qxdp, Qxdp, Qxdp, Qxdp, Qxdp, Qxdp, Qxdp, Qxdp
Qxdp, Qxdp, Qxdp, Qxdp, Qxdp, Qxdp, Qxdp, Qxdp, Qxdp, Qxdp, Qxdp, Qxdp, Qxdp, Qxdp, Qxdp^Xel, Qxdp, Qxdp, Qxdp, Qxdp, Qxdp, Qxdp, Qxdp^Xel, Qxdp, Qxdp, Qxdp, Qxdp, Qxdp, Qxdp, Qxdp, Qxdp, Qxdp, Qxdp, Qxdp, Qxdp, Qxdp
Qxdp, Qxdp, Qxdp, Qxdp, Qxdp, Qxdp, Qxdp, Qxdp, Qxdp, Qxdp, Qxdp, Qxdp, Qxdp, Qxdp, Qxdp, Qxdp^Xel, Qxdp^Xel, Qxdp, Qxdp, Qxdp, Qxdp, Qxdp^Xel, Qxdp^Xel, Qxdp, Qxdp, Qxdp, Qxdp, Qxdp, Qxdp, Qxdp, Qxdp, Qxdp, Qxdp, Qxdp, Qxdp
Qxdp, Qxdp, Qxdp, Qxdp, Qxdp, Qxdp, Qxdp, Qxdp, Qxdp, Qxdp, Qxdp, Qxdp, Qxdp, Qxdp, Qxdp, Qxdp, Qxdp, Qxdp^Xel, Qxdp, 1 Qxdp, Qxdp, Qxdp, Qxdp^Xel, Qxdp, Qxdp, Qxdp, Qxdp, Qxdp, Qxdp, Qxdp, Qxdp, Qxdp, Qxdp, Qxdp, Qxdp
Qxdp, Qxdp, Qxdp, Qxdp, Qxdp, Qxdp, Qxdp, Qxdp, Qxdp, Qxdp, Qxdp, Qxdp, Qxdp, Qxdp, Qxdp, Qxdp, Qxdp, Qxdp^Xel, Qxdp, Qxdp, Qxdp, Qxdp, Qxdp^Xel, Qxdp, Qxdp, Qxdp, Qxdp, Qxdp, Qxdp, Qxdp, Qxdp, Qxdp, Qxdp, Qxdp, Qxdp
Qxdp, Qxdp, Qxdp, Qxdp, Qxdp, Qxdp, Qxdp, Qxdp, Qxdp, Qxdp, Qxdp, Qxdp, Qxdp, Qxdp, Qxdp, Qxdp, Qxdp^Xel, Qxdp^Xel, Qxdp, Qxdp, Qxdp, Qxdp, Qxdp^Xel, Qxdp, Qxdp, Qxdp, Qxdp, Qxdp, Qxdp, Qxdp, Qxdp, Qxdp, Qxdp, Qxdp, Qxdp
Qxdp, Qxdp, Qxdp, Qxdp, Qxdp, Qxdp, Qxdp, Qxdp, Qxdp, Qxdp, Qxdp, Qxdp, Qxdp, Qxdp, Qxdp, Qxdp, Qxdp^Xel, Qxdp, Qxdp, Qxdp, Qxdp, Qxdp^Xel, Qxdp, Qxdp, Qxdp, Qxdp, Qxdp, Qxdp, Qxdp, Qxdp, Qxdp, Qxdp, Qxdp, Qxdp, Qxdp
