border_size=1
usage=map

Wwt, Wwt, Gs, Gg, Gs^Fct, Gs^Fct, Gs^Fct, Gs, Gs, Gg, Gg, Gg, Rp, Rp, Gg, Gs, Gs^Fds, Gg, Gg, Gll, Hh, Mm, Mm, Mm, Mm, Mm, Mm, Hh, Gll, Gg, Wwt, Wwt, Gg, Gs, Gs^Fct, Gs, Gs, Hh, Hh, Hh, Hh
Wwt, Wwt, Gs, Gs^Fct, Gs^Fct, Gs^Fct, Gs^Fct, Gs^Fct, Gs, Gg, Gg^Es, Gg, Rp, Rp, Gs, Gs, Hh^Fds, Gs^Fds, Gll, Gs, Hh, Mm, Mm, Mm, Mm, Mm, Hh, Hh^Fds, Gll, Gs, Wwt, Wwt, Wwf, Gs, Gll, Gs^Fct, Gll, Hh, Hh, Hh, Hh
Wwt, Wwt, Wwt, Gll, Gs, Gs, Gs, Gs^Fct, Gs, Gg, Gs, Gg, Rp, Rp, Gs, Hh, Hh, Hh^Fds, Gll, Gs, Gs, Hh^Fds, Hh, Hh, Hh^Fds, Hh^Fds, Gs^Es, Gs^Fds, Gg, Gs, Gs^Fct, Wwt, Wwt, Wwf, Gs^Fct, Gs^Fct, Gs^Fct, Gs^Fds, Gll, Hh^Fds, Hh
Gg, Wwt, Wwt, Wwt, Wwt, Wwt, Wwt, Gs, Gg, Gg^Es, Gs^Fct, Gs, Rp, Rp, Gs, Gll, Hh^Fds, Hh, Hh, Gs^Fds, Ce, Ce, Ce, Gs^Fds, Gg, Gs, Gg^Es, Gll, Gs^Fds, Gs^Fct, Gs^Fct, Gs, Wwt, Wwt, Gll, Gg, Gs^Fct, Gll, Gs^Fds, Hh, Hh
Gg, Gs, Gs, Wwt, Wwt, Wwt, Wwt, Wwt, Wwf, Gs, Gs^Fct, Gs^Fct, Rp, Rp, Gs, Gs^Fds, Gs^Fds, Hh, Hh, Gll, Ce, 2 Ke, Ce, Gll, Gs^Fds, Gs^Vc, Hh^Fds, Hh, Hh, Gll, Gs^Fct, Gs^Es, Wwt, Wwt, Gs, Gs^Fct, Gll, Gs^Fds, Hh, Hh, Hh
Gg, Gs^Fct, Gs^Fct, Gs, Gg^Es, Gg, Wwt, Wwt, Wwf, Gs, Gs^Fct, Gs^Fct, Rp, Rp, Rp, Gs, Gs, Gs, Gs, Ce, Gs, Ce, Gs, Ce, Hh, Hh^Fds, Hh, Hh, Gs^Fds, Gg, Wwf, Wwt, Wwt, Wwt, Gs, Gs^Fct, Gs^Fds, Gs^Fds, Hh^Fds, Hh, Hh
Hh^Fds, Gs^Fct, Gll, Gs, Gs, Gg, Gs, Wwt, Wwt, Wwf, Gll, Gs^Fct, Gs, Rp, Rp, Rp, Rp, Gg, Re^Vct, Gg^Es, Gg, Ce, Gg^Es, Gs, Gs, Hh, Gs, Hh^Fds, Gs, Gs, Wwf, Wwt, Gll, Gg, Gs^Fct, Gs^Fct, Gll, Hh, Hh, Hh^Fds, Hh
Hh, Hh^Fds, Hh, Hh, Hh, Gs^Es, Gs^Fct, Wwt, Wwt, Wwt, Wwt, Wwt, Wwt, Gg, Gg, Rp, Rp, Rp, Rp, Gs, Gg, Gs, Gg, Gg, Re^Vct, Gs, Gg^Efm, Gs, Gg, Gg, Wwt, Wwt, Wwt, Gs^Fct, Gs^Fct, Gs^Fct, Gll, Hh, Hh, Hh^Fds, Hh
Hh^Fds, Hh, Hh^Fds, Hh^Fds, Hh, Gs^Fct, Gs^Fds, Gs^Fct, Gs, Wwt, Wwf, Wwt, Wwt, Wwt, Re^Vct, Gg, Gg, Rp, Rp, Gg, Gg^Es, Gg, Gs, Gg, Gg^Efm, Gg, Gs^Efm, Gg^Efm, Csog, Ksog, Csog, Wwt, Wwt, Gll, Gs^Fct, Gs^Fds, Gs^Fds, Gg, Gs, Hh, Gs
Hh^Fds, Hh^Fds, Hh, Hh, Hh, Gs^Fds, Gll, Gs^Fct, Gs^Fds, Gs, Gg^Es, Gg, Wwt, Wwt, Wwt, Gg, Gs, Rp, Rp, Gg, Gs^Es, Re^Vct, Gs, Gg^Efm, Gg, Gg, Gs, Gg, Gg, Csog, Wwt, Wwt^Bw\, Wwt^Bw\, Gs, Gs, Gs, Gs^Vc, Gs, Gg^Es, Gs, Gg
Hh, Hh, Gll, Hh, Gg, Gs^Fds, Gs, Gs^Fct, Gs, Gll, Gs^Fct, Gs^Es, Gs, Wwt, Wwt, Gs, Gg, Rp, Rp, Gg, Gg^Es, Gg, Gg, Gs^Efm, Gs, Gs^Efm, Wwt, Wwt, Wwt, Wwt, Wwt, Wwt, Gs, Rb, Gg^Efm, Gg, Gs, Gg^Es, Gs, Gg^Es, Gg
Hh, Hh, Gs^Fds, Gs^Fds, Gll, Gg, Gs^Fds, Gg, Gg, Gs^Fds, Gs^Fct, Gs^Fct, Gs, Wwt, Wwt, Wwt, Wwt, Wwt^Bsb|, Wwt^Bsb|, Gg, Wwf, Gg, Gg, Gs, Wwt, Wwt, Wwt, Wwt, Wwf, Wwt, Gs, Gg, Gg, Rb, Gs^Efm, Gs^Efm, Gs^Fct, Gs^Fct, Gs^Fct, Gs, Gs
Gs, Gs, Gll, Gg, Gs^Fct, Gll, Gs^Fct, Gll, Gg^Es, Gs^Fds, Gs^Fct, Gs^Fct, Gs, Gg, Gg, Wwt, Wwt, Wwt^Bsb|, Wwt^Bsb|, Wwt, Wwt, Wwt, Wwt, Wwt, Wwt, Wwt, Gs^Fds, Gs, Gs, Gs^Fds, Hh^Fds, Gs, Gs, Rb, Rb, Gs^Fct, Gs^Fct, Gs^Fct, Gs^Fct, Gs^Fct, Gs
Gs^Fds, Gs^Fds, Gs^Fct, Gs^Fct, Gs^Fct, Gs^Fct, Gll, Gs^Fds, Gs, Gs, Gs, Gs, Gg, Gs^Es, Gg^Es, Gg, Gg, Rp, Rp, Gs^Fct, Gs^Fct, Wwt, Wwt, Wwt, Gll, Gll, Gs^Fds, Gg, Gs^Fds, Hh, Mm, Hh, Hh, Gs, Gs, Rb, Gll, Gll, Gs^Fct, Gs, Rb
Gg, Gll, Gs^Fct, Gs^Fct, Gs^Fct, Gll, Gs^Vc, Gs, Gg^Efm, Gg^Efm, Gg, Gg^Es, Gg, Gg, Gg, Gg^Es, Rp, Rp, Rp, Gs^Fct, Gs^Fct, Wwt, Wwt, Gs^Fds, Gs^Fds, Gs^Fds, Gs^Fds, Gll, Hh^Fds, Hh^Fds, Mm, Mm, Mm, Hh^Fds, Gs^Fds, Rb, Gs^Es, Gs^Fct, Rb, Rb, Gg^Es
Gg^Es, Gg, Gs, Gs^Fct, Gs^Es, Gs, Gg^Es, Gg^Efm, Gs^Efm, Gs^Efm, Gg, Gs, Gs, Gs^Vc, Gg, Gs, Rp, Rp, Gs, Gs^Fct, Wwt, Wwt, Wwt, Gs, Gs^Fct, Gs^Fct, Gs, Gs^Fds, Hh, Mm, Mm, Mm, Hh, Hh^Fds, Gs^Fds, Rb, Rb, Rb, Gg^Es, Gg^Efm, Gg^Efm
Gs^Fct, Gg, Gs, Gs^Es, Gg, Gg, Gg, Gg, Gs, Gs^Fct, Gll, Gs^Fct, Gs^Fct, Gs^Es, Gg, Gg, Rp, Rp, Gg, Wwt, Wwt, Wwt, Gs, Gg, Gg, Gg^Es, Gg^Es, Gs, Hh, Mm, Mm, Hh, Gg, Gll, Gg^Efm, Rb, Gs^Fds, Gs^Fds, Gg, Gs^Efm, Gs
Gs^Fct, Gs^Fct, Gll, Gs, Gll, Gs, Gs, Gs, Hh, Hh, Hh^Fds, Gll, Gg, Gs, Gs, Gg, Rp, Rp, Gg, Wwt, Wwt, Gs^Vc, Gg^Es, Gg, Gs^Fct, Gll, Gs^Fct, Gs^Fct, Gs, Hh^Fds, Hh^Fds, Hh^Fds, Gs, Gg, Gg^Efm, Rb, Rb, Gs^Vc, Gs, Gs^Fds, Gs^Fds
Gs^Fct, Gll, Gs^Fct, Gs^Fct, Gs^Fct, Gs^Fct, Hh^Fds, Hh^Fds, Mm, Mm, Mm, Hh^Fds, Gll, Gs^Fct, Gs^Fct, Gs, Rp, Rp, Gs, Wwt, Wwt, Wwf, Wwt, Gs, Gs, Gs^Fct, Gll, Gs^Fct, Gs, Gs, Gs^Fds, Gs^Fds, Gs^Es, Gg, Rb, Rb, Gs, Gs, Hh, Hh^Fds, Hh^Fds
Gs^Fct, Gs^Fct, Gll, Gll, Gs^Fct, Gg, Hh^Fds, Mm, Mm, Mm, Mm, Hh^Fds, Gll, Gs^Fct, Gs, Gs, Rp, Rp, Gs, Gg, Csog, Wwt, Wwt, Wwt, Gg, Gs, Gs, Gs, Gg, Gs^Es, Gs, Gs^Es, Rb, Rb, Gs^Fds, Gs^Fds, Gs^Fds, Hh, Hh, Hh, Hh
Gll, Gs^Fct, Gg, Gg, Gs^Fct, Gg, Gg, Hh, Mm, Mm, Hh, Hh, Gg, Gs^Fct, Gs, Gg^Es, Rp, Rp, Gs, Gs, Csog, Ksog, Wwt, Wwt, Wwf, Gg^Es, Gs^Vc, Gg, Wwt, Gg, Gg, Gg, Rb, Gs^Fct, Gs^Fct, Gs^Fds, Hh^Fds, Hh, Hh^Fds, Hh^Fds, Hh^Fds
Gs^Es, Gg, Gs, Gs^Fct, Gs, Gg, Gs, Hh, Hh^Fds, Hh^Fds, Gll, Gs^Fct, Gll, Gg, Gs, Gs, Rp, Rp, Gg, Gs^Es, Gg, Csog, Wwt, Wwt, Wwt, Wwt, Wwt, Wwt, Wwt, Wwt, Wwt, Gg^Efm, Rb, Gs^Fct, Gll^Efm, Gs^Fds, Gll^Efm, Hh, Hh, Hh^Fds, Hh
Gg, Gs, Gs, Gs, Gg^Es, Gg, Gg, Gs, Gs, Gs, Gg, Gg, Gg, Gs^Fct, Gs, Gg, Rp, Rp, Gg, Gg^Es, Wwt, Wwt, Wwt, Wwt, Wwf, Wwt, Wwt, Wwt, Hh^Fds, Wwt, Wwt, Wwt, Rb, Gs^Fct, Gs^Efm, Gs^Fct, Gs^Fct, Hh, Hh^Fds, Hh, Hh
Gg, Gs^Fct, Gg, Gs, Gs^Fct, Gg, Gs^Efm, Gs^Efm, Gg, Gg, Gs^Es, Gs, Gs^Fct, Gs^Fct, Gs, Gg^Es, Rp, Rp, Gg, Gs^Vc, Wwt, Wwt, Gg, Gg, Gg^Efm, Gs, Hh^Fds, Hh, Mm^Xm, Hh^Fds, Wwt, Wwt, Gg^Efm, Rb, Rb, Ksog, Gs^Fct, Gll^Efm, Gs^Fds, Hh, Gs
Gll, Gg, Gs^Fct, Gll, Gs^Fct, Gs^Fct, Gg^Efm, Gg^Efm, Gg, Gs, Gs^Fct, Gll, Gs^Fct, Gs, Gg, Gg^Es, Rp, Rp, Wwt, Wwt, Wwt, Wwt, Gg, Gg^Es, Gs^Vc, Gs, Hh, Mm, Mm, Hh, Wwt, Wwt, Wwt^Bsb/, Rb, Gs^Efm, Gs^Efm, Gs^Fct, Gs^Fct, Gll, Gs^Fds, Gll
Gs^Fct, Gs^Fct, Gll, Gs^Fct, Gs, Gs, Gg^Es, Gg^Es, Gg, Gs, Gs, Gs^Fct, Gs, Gg, Gg, Gs, Gg, Rp, Wwt^Bsb\, Wwt, Ksog, Gg, Gg^Efm, Gs^Efm, Rp, Gs, Gs, Hh, Hh, Hh^Fds, Rp, Wwt^Bsb/, Wwt, Wwt, Gg^Efm, Gs^Efm, Gs^Fct, Gs, Gs^Fds, Gll, Gs^Fct
Gll, Gs^Fct, Gs^Fct, Gs, Gg, Gs^Vc, Gs, Gs, Gs, Gg, Gg, Gs, Gg, Gg^Es, Gs, Gg, Gg, Wwt, Wwt, Wwt^Bsb\, Rp, Gg, Rp, Rp, Ksog, Rp, Rp, Gs, Gs^Efm, Gs^Efm, Rp, Gs^Efm, Wwt, Wwt, Gg, Gs^Efm, Gg, Gs^Fct, Gs^Fct, Gs^Fct, Gs^Fct
Gll^Es, Gg, Gg, Gs, Gs^Es, Gs, Hh, Gs, Gs^Fds, Gs^Fds, Gs^Fds, Gg, Gg, Gg^Efm, Gs^Efm, Gg, Wwf, Wwt, Wwt, Ksog, Gg, Rp, Ksog, Rp, Csog, Rp, Ksog, Rp, Rp, Rp, Gg^Efm, Wwt, Wwt, Wwt, Gg, Gs^Efm, Gg^Es, Gs, Gs^Fct, Gs^Fct, Gs^Fct
Gs^Fct, Gs^Es, Gs, Gg, Gg, Hh, Hh^Fds, Hh^Fds, Hh^Fds, Gll, Gs^Fds, Gs, Gs^Es, Gs^Efm, Gg^Efm, Gg, Wwt, Wwt, Gg, Gg^Efm, Gg^Efm, Rp, Rp, Csog, 3 Ksog, Csog, Rp, Rp, Gg^Efm, Hh, Hh^Fds, Wwt, Wwt, Wwt, Wwt, Gg, Gg, Gs, Gs^Fct, Gs^Fct, Gs^Fds
Gs^Fds, Gs^Fct, Gll, Gg, Gs^Fds, Hh, Hh^Fds, Hh^Fds, Hh, Gll, Gs, Gs, Gg, Gg, Wwt, Gs^Vc, Wwt, Wwt, Gg, Gg^Es, Gs^Efm, Rp, Ksog, Csog, Csog, Csog, Ksog, Rp, Hh, Hh, Gll, Gs, Gs^Vc, Wwt, Wwt, Gs, Gg^Es, Gs, Gs, Gs^Fct, Gs
Gll, Gs^Fct, Gs^Fct, Gg, Gs, Hh^Fds, Hh, Hh, Gll, Gs, Gg, Gg, Gg, Wwt, Wwt, Wwt, Wwt^Cov, Wwf^Cov, Gs^Cov, Gs^Es, Hh^Fds, Rp, Rp, Rp, Ksog, Rp, Rp, Rp, Hh^Fds, Hh, Hh^Fds, Gg, Wwt, Wwt, Wwt, Gg, Gs, Gg, Gg, Gs, Gs
Gs, Gs, Gs^Fds, Gg^Es, Gs, Gs^Fds, Gll, Hh^Fds, Gs^Fds, Gg, Gg, Gg^Es, Wwt, Wwt, Wwt, Wwt, Wwt^Cov, Gg^Kov, Hh^Cov, Hh, Mm, Hh^Fds, Gs^Efm, Rp, Rp, Rp, Gg^Efm, Gg^Efm, Hh, Hh^Fds, Gll, Wwt, Wwt, Wwt, Gs, Gg, Gg^Es, Gs, Gs^Fds, Gg, Gg
Gs^Fct, Gs^Fct, Gs^Fds, Gg, Gs^Es, Gs^Fds, Gll, Gll, Gs^Fds, Gs, Gg, Gg, Wwt, Wwt, Hh^Fds, Wwt, Wwt, Wwf^Cov, Hh^Fds, Mm, Mm^Xm, Hh, Gs^Efm, Gg^Efm, Rp, Gg, Gg^Efm, Gg^Es, Wwt, Gs^Vc, Wwt, Wwt, Gs, Gs, Hh, Gs, Gg, Gs, Gll, Gll, Gs^Fct
Gs^Fct, Gs^Fct, Gg, Gg, Gs, Gs^Fds, Gs^Fds, Gs^Fds, Gs, Gs^Es, Wwt, Wwt, Wwt, Wwf, Hh, Hh, Wwt, Wwt, Wwt, Hh^Fds, Hh, Hh^Fds, Gs, Ksog, Rp, Ksog, Wwt, Wwt, Wwt, Wwt, Wwt, Wwt, Gs^Fds, Hh, Mm, Hh^Fds, Gll, Gs^Fct, Gs^Fct, Gs^Fct, Gll
Gll, Gll, Wwt, Gg, Gg^Es, Gll, Gg, Gs, Gg, Gg, Wwt, Wwt, Gs, Hh^Fds, Hh^Fds, Hh^Fds, Gs, Wwt, Wwt, Wwt, Wwt, Wwt, Wwt, Wwt, Wwt^Bsb|, Wwt, Wwt, Wwt, Gs, Wwt, Wwt, Wwt, Gs^Fds, Hh^Fds, Hh, Hh, Gs, Gs^Fct, Gs^Fct, Gs^Fds, Gs^Fct
Wwt, Wwt, Wwt, Wwt, Wwt, Gg, Gs, Gs, Gll, Wwt, Wwt, Wwt, Gg, Gs, Gs, Gs, Gg, Gs^Vc, Gg, Wwt, Wwt, Wwt, Wwt, Wwt, Wwt^Bsb|, Wwt, Gg, Gs^Es, Gg^Es, Wwt, Wwt, Wwt, Gll, Gs^Fds, Gll, Gs, Gg, Gs, Gs, Gll, Gs^Fct
Wwt, Wwt, Gg, Wwt, Wwt, Wwt, Gs^Fct, Gs^Fct, Wwf, Wwt, Wwt, Wwt, Gg, Gg, Gs, Gg^Es, Gg^Es, Gg, Gs, Gs, Gg, Gg, Gg, Rp, Rp, Gg, Gll, Gs, Gs, Wwt, Wwt, Wwt, Wwt, Wwf, Wwf, Wwf, Wwt, Gg^Es, Gs, Gs^Fct, Gs^Fct
Gs^Fds, Gs, Gs, Gg^Es, Wwt, Wwt, Wwt, Gs^Fct, Wwt, Wwt, Gg, Gg, Gg, Gs^Es, Gs^Fds, Gg, Gs, Gs, Gs^Fct, Gs^Fct, Gll, Gs^Es, Gs, Rp, Rp, Gs^Fct, Gs^Fct, Gs^Fct, Gg, Wwf, Wwf, Wwt, Wwt, Wwt, Wwt, Wwt, Wwt, Wwt, Wwt, Gs^Es, Gs
Gll, Gs^Fds, Gll, Gs^Es, Gg, Wwt, Wwf, Wwt, Wwt, Wwt, Gs, Gs^Es, Gll, Gll, Gs^Fds, Gll, Gs^Fds, Gs^Fds, Gs^Fds, Gs^Fct, Gs^Fct, Gs^Fct, Gs, Rp, Rp, Gs^Fct, Gs^Fct, Gg, Gg^Es, Gs^Vc, Gg, Wwt, Wwt, Wwt, Wwt, Wwt, Wwt, Wwt, Wwt, Gs, Gg
Gs^Fct, Gll, Gs^Fct, Gs^Fct, Gs^Fds, Gg, Gs, Wwf, Gg^Efm, Gg^Efm, Gs, Gs^Fds, Hh, Hh, Hh, Hh^Fds, Hh^Fds, Gll, Gll, Gs^Fds, Gs, Gs^Fct, Gs, Rp, Rp, Gs, Gs^Es, Gs, Gg, Gs, Gg^Efm, Gg, Gg, Gg^Es, Gg, Wwt, Wwt, Wwt, Wwt, Wwt, Wwt
Gs^Fds, Gs^Fds, 1 Gll, Gs^Fct, Gs^Fct, Gg, Gs^Fds, Gg, Gs^Es, Gg^Efm, Gs, Gs^Fds, Hh^Fds, Mm, Mm, Mm, Mm, Hh, Hh^Fds, Gll, Gs^Fds, Gs, Gg, Rp, Rp, Gg, Gs, Gg, Gs, Gs, Gg^Efm, Gg^Efm, Gg, Gs, Gs, Gg, Gg, Wwt, Wwt, Wwt, Wwt
Gs^Fds, Gs^Fct, Gs^Fct, Gs^Fct, Gg, Gll, Gg, Gs^Fds, Gs^Fds, Gs^Es, Hh, Hh, Hh^Fds, Mm, Mm, Mm, Mm, Hh, Hh, Hh^Fds, Gs^Fds, Gs, Gg, Rp, Rp, Gs, Gs, Gs, Gg, Gs^Es, Gg, Gs, Gs^Fct, Gs^Es, Gs^Fct, Gs^Es, Gg, Wwf, Wwt, Wwt, Wwt
