border_size=1
usage=map

Md, Md, Md, Md, Md^Xm, Md, Md, Md, Md, Md, Md^Xm, Md, Md, Md, Md, Md, Md, Md, Md, Md, Md, Md, Md^Xm, Md, Md^Xm, Md, Md, Md, Md, Md, Md, Md, Md^Xm, Md, Md^Xm, Md, Md, Md, Md, Md, Md, Md, Md, Md, Md, Md, Md^Xm, Md, Md, Md, Md, Md^Xm, Md^Xm, Md, Md, Md, Md, Md, Md, Md, Md
Md, Md, Md^Xm, Md^Xm, Md, Md^Xm, Md, Md, Md, Md, Md, Md^Xm, Md, Md^Xm, Md, Md^Xm, Md, Md^Xm, Md, Md, Md^Xm, Md^Xm, Md, Md^Xm, Md, Md^Xm, Md, Md, Md^Xm, Md, Md^Xm, Md, Md^Xm, Md, Md^Xm, Md, Md^Xm, Md^Xm, Md^Xm, Md^Xm, Md^Xm, Md, Md^Xm, Md^Xm, Md, Md, Md^Xm, Md^Xm, Md^Xm, Md, Md^Xm, Md^Xm, Md^Xm, Md, Md, Md, Md, Md^Xm, Md, Md^Xm, Md
Md^Xm, Md, Md, Md, Md, Md, Md, Md, Md, Md, Md, Md, Md, Md, Md, Md, Md, Md, Md, Md^Xm, Md, Md, Md, Md, Md, Md, Md, Md, Md^Xm, Md, Md, Md^Xm, Md, Md^Xm, Md, Md^Xm, Md, Md, Md, Md^Xm, Md, Md^Xm, Md^Xm, Md^Xm, Md, Md^Xm, Md, Md, Md, Md, Md, Md^Xm, Md, Md^Xm, Md^Xm, Md, Md^Xm, Md, Md, Md^Xm, Md
Md^Xm, Md^Xm, Md, Md, Md, Md, Hhd, Md, Hhd, Md, Hhd, Md, Hhd, Md, Md, Md, Md, Md, Md, Md, Md, Md, Hhd, Md, Hhd, Md, Hhd, Md, Md, Md, Md, Md, Md, Md, Md, Md, Md, Md, Md, Md, Md, Md, Md, Md^Xm, Md^Xm, Md, Md, Md, Md, Md^Xm, Md^Xm, Md, Md, Md, Md, Md, Md^Xm, Md, Md^Xm, Md, Md^Xm
Md, Md, Md, Md, Md, Md, Hhd, Hhd, Hhd, Hhd, Hhd, Hhd, Hhd, Hhd, Hhd, Md, Hhd, Md, Hhd, Hhd, Hhd, Hhd, Hhd, Hhd, Hhd, Hhd, Hhd, Hhd, Hhd, Md, Hhd, Md, Md, Md, Hhd, Md, Hhd, Hhd, Hhd, Md, Md, Md, Md, Md, Md, Md^Xm, Md, Md, Md, Md, Md, Md^Xm, Md, Md, Md, Md, Md^Xm, Md, Md^Xm, Md, Md^Xm
Md^Xm, Md, Hhd, Md, Hhd, Hhd, Hd, Hd, Hd, Hd, Hd, Hd, Hd, Hhd, Hd, Hhd, Hhd, Hhd, Hd, Hhd, Hd, Hd, Hd, Hd, Hd, Hhd, Hd, Hhd, Hd, Hhd, Hhd, Hhd, Hhd, Hhd, Hhd, Hhd, Hhd, Hhd, Hhd, Hhd, Hhd, Hhd, Hhd, Md, Hhd, Md, Hhd, Hhd, Hhd, Hhd, Hhd, Md, Md, Md^Xm, Md^Xm, Md, Md, Md, Md, Md, Md
Md, Md, Hhd, Hhd, Hhd, Hd, Hd, Hd, Dd, Hd, Hd, Hd, Hd, Hd, Hd, Hd, Hd, Hd, Hd, Hd, Hd, Hd, Dd, Hd, Hd, Hd, Hd, Hd, Hd, Hd, Hd, Hd, Hd, Hd, Hd, Hd, Hd, Hd, Hd, Hd, Hd, Hd, Hd, Hhd, Hhd, Hhd, Hhd, Hhd, Hd, Hhd, Hhd, Hhd, Hhd, Md, Md, Md^Xm, Md, Md^Xm, Md, Md^Xm, Md
Md, Hhd, Hhd, Hd, Hd, Hd, Hd, Dd, Dd, Dd, Dd, Dd, Dd, Dd, Dd, Dd, Dd^Esd, Dd, Dd^Esd, Dd, Dd, Dd, Dd^Esd, Dd, Dd, Dd, Dd, Dd, Dd, Hd, Hd, Hd, Hd, Hd, Hd, Hd, Dd, Hd, Dd, Dd, Dd, Hd, Hd, Hd, Hd, Hd, Hd, Hd, Hd, Hd, Hd, Hd, Hd, Hhd, Hhd, Md, Md, Md, Md^Xm, Md^Xm, Md
Md, Hhd, Hd, Hd, Dd, Dd, Dd, Dd, Dd^Esd, Dd, Dd^Esd, Dd^Esd, Dd^Esd, Dd^Esd, Dd^Esd, Dd, Dd^Esd, Dd, Dd, Dd^Dr, Dd, Dd^Esd, Dd, Dd^Esd, Dd, Dd^Esd, Dd^Esd, Dd, Dd^Esd, Dd, Dd, Dd, Dd, Dd, Dd, Dd, Dd^Esd, Dd, Dd, Dd, Dd, Dd, Dd, Hd, Dd, Hd, Dd, Hd, Dd^Vdt, Hd, Dd^Vdt, Hd, Hd, Hhd, Hhd, Md, Md, Md, Md, Md^Xm, Md
Md, Hhd, Hhd, Hd, Dd, Dd^Esd, Dd, Dd^Esd, Dd, Dd^Esd, Dd, Dd, Dd, Dd, Dd^Esd, Dd^Dc, Dd, Dd^Esd, Dd^Esd, Dd^Esd, Dd^Esd, Dd^Esd, Dd^Dc, Dd, Dd, Dd, Dd, Dd, Dd, Dd^Dc, Dd, Dd, Dd, Dd, Dd, Dd, Dd, Dd, Dd^Esd, Dd^Esd, Dd^Esd, Dd^Vdt, Dd^Esd, Dd, Ce, Ce, Ce, Dd, Dd, Dd, Dd, Hd, Hd, Hd, Hhd, Hhd, Hhd, Md, Md, Md^Xm, Md
Hhd, Hhd, Hhd, Hd, Hd, Dd, Dd^Esd, Dd^Dc, Dd, Dd, Qlf, Qlf, Qlf, Dd, Dd^Esd, Dd^Dr, Dd, Dd, Xue, Dd, Dd^Dc, Dd, Dd, Dd, Dd^Esd, Dd^Esd, Dd, Dd, Dd, Dd, Dd, Dd, Dd, Dd, Dd, Dd^Esd, Dd^Dc, Dd, Dd^Esd, Dd^Esd, Dd, Dd, Dd, Dd, Ce, 2 Ke, Ce, Dd, Dd, Dd^Esd, Dd, Hd, Hd, Hd, Hd, Hhd, Hhd, Md, Md, Md^Xm, Md^Xm
Hhd, Hhd, Hd, Hd, Dd, Dd, Dd^Esd, Dd, Dd, Dd, Dd, Dd, Dd^Esd, Dd, Dd^Esd, Dd, Dd, Xue, Ql, Xue, Dd^Dr, Dd^Dr, Dd, Dd, Dd^Esd, Dd, Dd, Dd, Hd, Dd, Hhd, Hd, Hd, Dd, Dd, Dd^Esd, Dd^Esd, Dd, Dd^Esd, Dd, Dd^Esd, Dd^Vdt, Dd, Dd, Dd, Ce, Dd, Dd^Esd, Dd^Cov, Dd^Cov, Dd^Cov, Dd, Hd, Hd, Hd, Hhd, Hhd, Hhd, Md, Md, Md
Hd, Hd, Dd, Dd, Dd, Dd^Esd, Dd, Dd, Dd, Dd, Qlf, Qlf, Qlf, Dd^Esd, Dd, Dd, Dd^Dr, Xue, Xue, Uue, Dd^Dr, Dd, Dd, Dd^Esd, Dd, Dd, Dd^Esd, Dd, Hd, Hhd, Hhd, Hhd, Hd, Hd, Dd, Dd^Esd, Dd, Dd, Dd^Dc, Dd^Esd, Dd, Dd^Esd, Dd^Esd, Dd^Vdt, Dd^Esd, Dd^Esd, Dd^Esd, Dd, Dd^Cov, 1 Dd^Kov, Dd^Cov, Dd^Esd, Dd^Vdt, Hd, Hd, Hd, Hhd, Md, Md, Md, Md^Xm
Dd, Dd, Dd, Dd, Dd^Esd, Dd, Dd, Dd, Qlf, Dd^Esd, Qlf, Mv, Dd, Dd^Esd, Qlf, Dd, Dd, Dd, Dd^Dr, Dd, Dd, Dd, Hd, Dd, Dd, Dd^Dc, Dd^Esd, Dd, Dd, Hd, Hhd, Hhd, Hd, Hd, Dd, Dd, Dd^Esd, Dd^Esd, Dd, Dd, Dd^Dc, Dd^Esd, Dd, Dd^Esd, Dd^Esd, Dd, Dd, Dd, Dd, Dd^Cov, Dd^Esd, Dd, Dd^Dr, Dd^Esd, Dd^Esd, Hd, Hd, Hhd, Md, Md, Md^Xm
Dd^Esd, Dd, Dd, Dd^Dc, Dd, Dd, Dd, Dd^Esd, Qlf, Dd^Esd, Dd^Esd, Qlf, Dd, Dd, Qlf, Dd, Dd, Dd, Dd, Dd, Hd, Hd, Hd, Hd, Dd, Dd, Dd, Dd^Esd, Dd, Hd, Hd, Hhd, Dd^Esd, Dd, Dd^Esd, Dd^Esd, Xue, Xue, Uue, Dd, Dd^Esd, Dd^Esd, Dd^Esd, Dd, Dd^Esd, Dd^Vdt, Dd, Dd, Dd^Dr, Dd, Dd^Vdt, Dd^Esd, Dd^Esd, Dd^Esd, Dd^Esd, Hd, Hd, Hhd, Md, Md, Md^Xm
Dd, Dd^Esd, Dd^Esd, Dd, Dd, Dd^Dr, Dd, Dd^Esd, Dd, Dd, Qlf, Dd, Dd, Qlf, Dd, Dd, Dd, Dd^Dc, Dd, Dd, Hhd, Hhd, Hhd, Dd, Dd, Dd^Dr, Dd, Dd^Esd, Dd, Dd, Dd, Hd, Dd, Dd, Dd, Dd^Esd, Uue, Ql, Xue, Dd, Dd^Esd, Dd, Dd, Dd, Dd^Dc, Dd, Dd, Dd, Dd, Dd, Xue, Dd, Dd, Dd^Esd, Dd, Hd, Hd, Hhd, Hhd, Md, Md^Xm
Dd, Dd^Esd, Dd, Dd^Esd, Dd^Esd, Dd, Dd^Dr, Dd^Esd, Dd^Esd, Dd, Dd^Esd, Qlf, Dd, Dd, Dd, Dd, Dd^Esd, Dd^Esd, Dd^Esd, Dd, Dd, Hhd, Dd, Dd, Dd, Dd, Xue, Dd, Dd^Esd, Dd^Dr, Dd, Dd, Dd, Qlf, Qlf, Dd^Esd, Dd, Xue, Dd, Dd, Dd^Dc, Dd, Dd^Esd, Dd^Esd, Dd, Dd, Dd^Dr, Dd, Dd, Xue, Ql, Xue, Dd, Dd^Dr, Dd^Esd, Hd, Hd, Hd, Hhd, Md, Md
Dd, Dd^Esd, Dd, Dd^Dr, Dd^Esd, Dd^Esd, Xue, Xue, Xue, Dd^Esd, Dd^Esd, Dd^Esd, Dd, Dd^Esd, Dd^Esd, Dd, Dd, Dd, Dd, Dd^Esd, Dd, Dd, Dd, Dd^Dr, Dd, Xue, Ql, Uue, Dd^Esd, Dd, Qlf, Qlf, Dd^Esd, Dd, Dd, Dd, Dd, Dd^Esd, Dd^Dc, Dd^Esd, Dd^Esd, Dd^Esd, Dd, Dd, Dd^Dr, Dd, Dd, Dd, Dd, Uue, Xue, Xue, Dd, Dd, Dd^Dc, Dd, Hd, Hd, Hd, Hhd, Md
Dd^Esd, Dd^Esd, Dd^Esd, Dd^Dc, Dd, Dd, Uue, Ql, Xue, Dd^Dc, Dd^Dr, Dd^Esd, Dd, Dd, Dd, Dd, Xue, Xue, Xue, Dd^Dr, Dd, Dd^Esd, Dd^Dc, Dd, Dd, Xue, Uue, Xue, Dd, Dd, Dd, Dd^Esd, Mv, Qlf, Dd^Esd, Qlf, Dd, Dd^Esd, Dd, Dd, Dd, Dd, Dd, Dd, Dd, Dd, Dd, Dd, Qlf, Dd, Dd, Dd, Dd, Dd^Dr, Dd, Dd^Esd, Dd, Hd, Hd, Hhd, Md
Dd, Dd^Esd, Dd, Dd, Hd, Dd, Dd, Uue, Dd, Dd^Dr, Dd, Dd, Dd, Dd, Dd^Dr, Dd, Xue, Ql, Uue, Dd, Dd^Dr, Dd^Dc, Dd^Esd, Dd^Esd, Dd, Dd, Dd, Dd, Dd, Qlf, Dd, Qlf, Qlf, Qlf, Dd^Esd, Qlf, Dd, Dd, Dd^Esd, Dd, Dd, Dd^Dr, Dd, Dd, Dd, Dd^Dr, Dd^Esd, Dd, Dd, Qlf, Qlf, Qlf, Dd, Dd^Dr, Dd, Dd^Esd, Dd^Esd, Hd, Hd, Hhd, Hhd
Dd, Dd, Hd, Dd, Hhd, Hd, Hd, Dd, Dd, Dd^Dr, Dd, Dd, Dd, Dd, Dd, Dd, Dd, Xue, Dd, Dd, Dd^Esd, Dd^Esd, Dd, Dd^Dr, Dd^Esd, Dd^Esd, Dd, Dd^Esd, Dd^Esd, Qlf, Qlf, Dd, Dd^Esd, Dd, Qlf, Qlf, Dd, Dd, Dd, Dd^Esd, Dd, Dd, Xue, Xue, Xue, Dd, Dd, Dd^Esd, Qlf, Dd, Dd^Esd, Dd^Esd, Dd^Esd, Dd^Esd, Dd, Dd^Dr, Dd^Esd, Dd, Hd, Hd, Hhd
Hd, Hd, Hhd, Hhd, Hd, Hhd, Dd, Dd, Dd, Dd^Dc, Dd, Dd, Dd^Esd, Dd, Dd^Esd, Dd^Dr, Dd^Esd, Dd, Dd^Dr, Dd, Dd^Esd, Dd, Qlf, Dd^Esd, Dd, Qlf, Qlf, Dd, Dd^Esd, Dd, Dd, Dd^Esd, Dd, Qlf, Dd, Dd^Dr, Dd, Dd^Dr, Dd, Dd^Esd, Dd^Dr, Dd, Xue, Ql, Xue, Dd, Dd, Qlf, Mv, Qlf, Dd, Dd, Xue, Uue, Xue, Dd, Dd^Dc, Dd^Esd, Hd, Hd, Hhd
Dd, Hd, Hhd, Hhd, Hhd, Hd, Dd, Dd, Dd, Dd^Esd, Dd^Esd, Dd, Dd, Dd, Dd, Dd^Esd, Dd^Esd, Dd^Esd, Dd^Esd, Dd, Dd^Esd, Qlf, Qlf, Dd^Esd, Dd^Esd, Qlf, Dd, Dd, Dd, Dd^Esd, Qlf, Dd, Dd, Dd, Uue, Dd, Dd^Esd, Dd, Qlf, Dd, Dd, Dd, Dd, Uue, Dd, Dd^Dc, Dd^Esd, Qlf, Qlf, Qlf, Dd, Dd, Uue, Ql, Xue, Dd^Esd, Dd^Esd, Dd, Dd, Hd, Hd
Dd, Dd, Hd, Hhd, Hd, Hd, Dd, Dd, Dd^Esd, Dd^Dc, Dd, Dd^Esd, Dd, Dd, Qlf, Qlf, Dd, Dd^Esd, Dd, Dd^Esd, Dd^Esd, Dd, Dd, Dd, Dd, Dd, Dd, Dd, Dd^Dr, Dd, Dd, Qlf, Dd, Xue, Ql, Xue, Dd^Esd, Dd, Qlf, Dd, Dd^Esd, Qlf, Qlf, Dd, Dd, Dd^Dr, Dd, Dd^Esd, Dd^Esd, Dd, Dd, Dd^Esd, Dd, Xue, Dd^Esd, Dd^Esd, Dd, Dd^Esd, Dd, Dd, Dd
Dd, Hd, Dd, Hd, Dd, Hd, Dd, Dd, Dd, Dd, Dd, Dd^Esd, Dd, Qlf, Dd, Dd, Dd^Esd, Qlf, Qlf, Dd, Dd^Dc, Dd, Dd^Dr, Dd, Uue, Xue, Xue, Dd, Dd, Dd, Dd^Dr, Dd, Dd, Uue, Xue, Xue, Dd, Qlf, Dd, Dd, Dd, Dd, Dd, Qlf, Dd, Dd, Qlf, Dd^Esd, Dd, Dd^Esd, Qlf, Dd, Dd^Dr, Dd, Dd^Esd, Dd, Dd^Dr, Dd^Esd, Dd^Esd, Dd, Dd
Dd, Dd, Dd^Esd, Dd, Dd, Dd, Xue, Xue, Xue, Dd^Esd, Dd, Dd^Esd, Dd, Dd^Esd, Qlf, Qlf, Qlf, Dd^Esd, Qlf, Dd, Dd^Esd, Dd, Dd, Dd, Xue, Ql, Uue, Dd^Esd, Dd^Esd, Dd, Dd, Dd, Dd^Esd, Dd, Dd^Esd, Dd, Dd^Esd, Dd^Esd, Qlf, Qlf, Qlf, Dd^Esd, Dd^Esd, Qlf, Dd, Dd, Dd, Qlf, Qlf, Qlf, Dd, Dd, Dd, Dd, Dd^Esd, Dd, Dd, Dd, Dd^Esd, Dd^Dc, Dd
Dd^Esd, Dd, Dd, Dd, Dd, Dd, Xue, Ql, Uue, Dd^Esd, Dd, Dd^Esd, Qlf, Dd^Esd, Qlf, Mv, Qlf, Dd, Dd, Dd, Dd, Dd, Qlf, Dd, Dd, Xue, Dd, Dd, Dd^Dr, Dd^Esd, Dd^Esd, Dd, Dd^Dr, Dd, Dd^Dr, Dd, Qlf, Dd, Qlf, Mv, Qlf, Dd, Dd^Esd, Qlf, Dd, Dd, Dd, Dd, Dd, Dd, Dd, Dd, Dd^Esd, Dd^Esd, Hd, Hd, Hd, Dd, Dd, Dd^Esd, Dd
Dd, Dd^Dc, Dd, Dd^Esd, Dd^Esd, Dd, Dd, Xue, Dd, Dd^Esd, Dd, Dd, Qlf, Dd, Dd, Qlf, Dd^Esd, Dd, Qlf, Dd^Esd, Dd^Esd, Dd, Qlf, Qlf, Dd, Dd^Dr, Dd, Dd, Dd, Dd, Dd^Dc, Dd, Dd, Dd, Dd, Dd, Qlf, Dd, Dd, Qlf, Dd, Dd, Dd, Dd, Dd^Esd, Dd, Dd^Esd, Dd^Esd, Dd^Dc, Dd^Esd, Dd, Dd, Dd^Dc, Dd^Esd, Hd, Hd, Hhd, Hd, Hd, Dd, Dd
Dd, Dd, Dd^Esd, Dd^Esd, Dd^Dc, Dd^Esd, Dd, Dd^Esd, Dd^Esd, Dd^Esd, Dd^Dc, Dd, Dd, Qlf, Qlf, Dd^Esd, Dd^Esd, Qlf, Dd, Dd, Dd^Esd, Dd^Esd, Dd, Dd, Dd, Dd, Dd, Dd, Dd^Dc, Dd, Dd^Esd, Dd, Dd^Esd, Dd, Dd, Dd, Dd, Qlf, Dd, Dd^Esd, Qlf, Qlf, Dd, Uue, Dd, Dd, Uue, Dd, Dd, Dd^Esd, Dd^Esd, Dd, Dd, Dd, Dd, Hd, Hhd, Hhd, Hhd, Hd, Hd
Dd, Dd, Dd, Dd, Dd, Dd, Dd, Dd, Dd, Dd^Esd, Dd, Dd, Dd, Dd, Dd, Dd^Esd, Dd^Esd, Dd, Dd, Dd, Dd^Esd, Dd, Dd, Dd^Esd, Dd, Dd, Dd^Esd, Dd, Dd^Esd, Dd^Esd, Dd, Dd, Dd, Dd^Dc, Dd^Esd, Dd^Esd, Dd^Esd, Dd^Esd, Dd^Dc, Dd, Dd, Dd, Xue, Uue, Uue, Uue, Xue, Dd, Uue, Dd, Dd, Dd^Esd, Dd^Esd, Dd, Hd, Hd, Hd, Hhd, Hd, Hd, Dd
Hd, Hd, Hd, Hd, Hd, Hd, Hd, Dd, Dd, Dd, Dd^Dc, Dd^Esd, Dd, Dd, Dd, Dd^Dr, Dd, Dd, Xue, Xue, Xue, Dd, Dd^Dr, Dd^Dc, Dd, Dd, Dd^Esd, Dd, Dd, Dd, Dd, Dd, Dd, Dd, Dd^Esd, Dd, Xue, Dd, Dd, Dd, Uue, Dd, Xue, Uue, Dd^Esd, Dd, Dd, Xue, Dd, Uue, Uue, Dd, Dd^Esd, Dd, Dd^Esd, Dd, Dd^Esd, Hd, Dd, Hd, Dd
Hd, Hd, Hd, Hd, Hd, Hd, Hd, Hd, Dd, Dd, Dd, Dd^Esd, Dd, Dd, Dd^Dc, Dd, Dd^Esd, Dd, Uue, Ql, Xue, Dd, Dd, Dd, Dd, Dd^Esd, Dd^Dc, Dd, Dd, Dd, Dd, Dd, Xue, Xue, Dd^Esd, Dd^Esd, Xue, Dd, Uue, Uue, Uue, Uue, Dd^Esd, Dd^Esd, Dd, Ql, Dd, Xue, Dd, Uue, Dd, Dd^Esd, Xue, Xue, Uue, Dd^Esd, Dd^Esd, Dd^Esd, Dd^Esd, Dd, Dd
Hd, Hd, Hd, Hd, Hd, Hd, Hd, Hd, Hd, Hd, Dd, Dd, Dd, Dd^Esd, Dd, Dd, Dd, Dd, Dd, Xue, Dd, Dd, Dd^Dr, Dd, Dd^Esd, Dd^Esd, Dd, Dd, Xue, Dd, Xue, Dd, Dd, Dd, Dd^Esd, Dd, Dd^Esd, Dd^Esd, Xue, Dd^Esd, Ql, Dd, Dd, Ql, Dd^Esd, Ql, Ql, Dd^Esd, Dd^Esd, Xue, Uue, Xue, Dd, Uue, Dd, Xue, Dd, Dd^Esd, Dd^Dc, Dd^Esd, Dd
Hd, Dd, Dd, Hd, Dd, Hd, Hd, Hd, Hd, Hd, Hd, Dd, Dd, Dd^Esd, Dd, Dd, Dd, Dd^Dr, Dd, Dd, Dd, Dd, Hd, Dd, Dd, Dd, Dd, Dd, Dd, Dd, Dd, Dd^Esd, Dd, Xue, Uue, Uue, Ql, Dd^Esd, Ql, Dd^Esd, Xue, Ql, Xue, Xue, Xue, Dd^Esd, Ql, Uue, Dd^Esd, Dd^Esd, Dd, Uue, Dd^Esd, Uue, Dd, Uue, Dd, Dd^Esd, Dd^Esd, Dd^Esd, Dd
Dd^Esd, Dd, Dd, Dd^Cov, Dd, Dd, Dd, Hd, Hd, Hd, Dd, Dd, Dd^Dc, Dd^Esd, Dd, Dd, Dd^Esd, Dd, Dd, Dd, Dd, Hd, Hd, Dd, Dd, Dd, Xue, Dd, Dd^Esd, Dd^Esd, Dd, Dd, Uue, Uue, Uue, Uue, Dd, Ql, Dd^Esd, Dd^Esd, Uue, Dd^Esd, Uue, Xue, Xue, Uue, Uue, Ql, Dd^Esd, Uue, Uue, Ql, Dd, Dd^Esd, Dd^Esd, Uue, Xue, Dd^Esd, Dd^Esd, Dd^Esd, Dd
Dd, Dd^Cov, Dd^Cov, Dd^Cov, Dd^Cov, Dd^Cov, Dd, Dd, Hd, Hd, Dd, Dd, Dd^Esd, Dd^Esd, Dd, Dd, Dd, Dd^Esd, Dd^Esd, Dd^Esd, Dd^Esd, Dd, Dd^Esd, Dd^Esd, Dd, Dd, Dd, Dd, Dd, Dd, Xue, Uue, Uue, Dd, Xue, Xue, Dd^Esd, Ql, Ql, Uue, Dd^Esd, Xue, Uue, Dd, Ql, Xue, Dd^Esd, Dd, Ql, Dd, Xue, Ql, Ql, Xue, Dd^Esd, Uue, Xue, Dd, Dd^Esd, Dd, Dd^Esd
Dd, Dd, Dd^Cov, 4 Dd^Kov, Dd^Cov, Dd^Esd, Dd, Dd, Dd, Hd, Dd, Dd, Dd, Dd, Dd, Dd, Dd, Dd, Dd, Dd^Dc, Dd, Dd^Esd, Dd, Dd, Dd, Dd, Xue, Dd, Xue, Xue, Dd, Dd, Dd, Xue, Xue, Dd^Esd, Ql, Dd^Esd, Uue, Ql, Ql, Dd^Esd, Ql, Ql, Dd, Ql, Dd^Esd, Ql, Dd, Xue, Xue, Ql, Uue, Dd, Xue, Dd, Xue, Dd^Esd, Dd, Dd, Dd^Esd
Dd^Esd, Dd^Cov, Dd, Dd^Cov, Dd, Dd^Cov, Dd, Dd^Dc, Dd^Dr, Dd, Dd, Dd, Qlf, Dd, Dd, Qlf, Qlf, Qlf, Dd, Dd, Dd^Dr, Dd, Dd, Dd, Xue, Dd, Dd, Dd, Xue, Xue, Dd, Uue, Dd, Xue, Ql, Dd^Esd, Uue, Xue, Dd^Esd, Uue, Ql, Dd^Esd, Dd, Uue, Ql, Dd^Esd, Uue, Dd, Ql, Xue, Xue, Xue, Uue, Ql, Dd, Uue, Dd, Dd, Dd, Dd^Dc, Dd
Dd, Dd, Dd, Dd^Cov, Dd, Dd^Dr, Dd, Dd, Dd, Dd, Dd, Qlf, Dd, Qlf, Dd, Dd, Dd, Dd, Xue, Dd, Dd, Dd, Dd, Dd, Dd, Dd, Dd, Dd, Dd, Xue, Dd, Uue, Ql, Ql, Uue, Ql, Dd, Ql, Xue, Dd^Esd, Dd, Xue, Xue, Uue, Ql, Dd, Xue, Uue, Ql, Uue, Xue, Xue, Ql, Dd^Esd, Dd^Esd, Dd^Esd, Uue, Dd^Esd, Dd, Dd, Dd^Esd
Dd, Dd, Dd^Esd, Dd, Dd, Dd^Dc, Xue, Uue, Xue, Qlf, Dd, Dd, Qlf, Hd, Hd, Dd^Esd, Dd^Esd, Xue, Ql, Xue, Dd, Dd^Dr, Dd, Dd, Dd, Dd, Dd, Dd, Dd, Dd, Uue, Dd, Ql, Uue, Ql, Ql, Xue, Xue, Xue, Ql, Ql, Xue, Xue, Dd, Ql, Dd, Ql, Dd, Ql, Xue, Xue, Xue, Uue, Ql, Uue, Xue, Dd, Uue, Dd, Dd, Dd^Esd
Dd, Dd, Dd^Esd, Dd^Esd, Dd, Dd, Xue, Ql, Uue, Qlf, Dd, Qlf, Mv, Qlf, Hd, Dd, Dd^Esd, Uue, Xue, Uue, Dd, Dd^Dr, Dd, Dd, Dd, Dd, Dd, Dd, Xue, Xue, Xue, Uue, Ql, Xue, Uue, Uue, Xue, Xue, Ql, Ql, Ql, Xue, Xue, Xue, Dd, Dd, Dd, Dd, Ql, Ql, Uue, Uue, Ql, Ql, Xue, Dd, Uue, Uue, Dd, Dd, Dd
Dd, Dd, Dd^Esd, Dd^Dc, Dd^Esd, Dd, Dd, Xue, Dd, Dd, Dd, Qlf, Qlf, Qlf, Hd, Dd, Dd^Esd, Dd, Dd, Dd, Dd, Dd^Esd, Dd^Esd, Dd, Dd, Xue, Xue, Dd, Xue, Dd, Dd^Esd, Dd^Esd, Dd, Ql, Ql, Uue, Ql, Xue, Ql, Ql, Ql, Ql, Ql, Xue, Dd, Ql, Dd, Xue, Uue, Ql, Ql, Uue, Uue, Ql, Dd, Dd, Dd^Esd, Xue, Dd, Dd, Dd
Dd^Esd, Dd, Dd^Esd, Dd, Dd, Dd, Dd^Dr, Dd^Dr, Dd, Qlf, Dd, Dd^Esd, Hd, Hd, Hd, Qlf, Dd, Dd, Dd, Dd^Dr, Dd^Esd, Dd, Dd^Dc, Dd^Esd, Dd^Esd, Dd, Dd, Dd, Xue, Xue, Xue, Ql, Uue, Xue, Ql, Uue, Ql, Ql, Ql, Xu, Ql, Ql, Ql, Ql, Ql, Ql, Ql, Ql, Ql, Ql, Uue, Ql, Uue, Dd, Uue, Dd^Esd, Dd^Esd, Dd, Dd, Dd, Dd
Dd, Dd, Dd, Dd, Dd, Dd, Dd, Dd^Esd, Dd^Esd, Qlf, Qlf, Dd^Esd, Dd^Esd, Dd, Qlf, Qlf, Dd, Dd, Dd, Dd^Esd, Dd, Dd, Dd, Dd, Dd^Esd, Dd, Xue, Dd, Xue, Xue, Ql, Ql, Xue, Uue, Ql, Uue, Ql, Ql, Ql, Ql, Ql, Ql, Ql, Xue, Xue, Uue, Ql, Uue, Dd^Esd, Uue, Xue, Ql, Uue, Xue, Dd^Esd, Uue, Xue, Dd, Dd, Dd^Esd, Dd^Esd
Dd, Dd, Dd, Dd^Esd, Dd, Dd^Dc, Hd, Hd, Dd, Dd, Dd, Qlf, Dd^Esd, Dd, Dd, Dd, Qlf, Dd, Dd, Dd^Esd, Dd^Dc, Dd, Dd^Esd, Dd, Dd, Dd^Esd, Dd, Dd, Uue, Xue, Dd, Ql, Uue, Ql, Ql, Ql, Xue, Xue, Xue, Ql, Xue, Ql, Xue, Xue, Xue, Dd, Xue, Uue, Dd^Esd, Xue, Xue, Uue, Ql, Uue, Uue, Uue, Dd^Esd, Dd, Dd, Dd, Dd^Esd
Dd^Esd, Dd, Dd^Esd, Dd^Esd, Dd, Hd, Hd, Hd, Hd, Qlf, Qlf, Dd, Dd^Esd, Dd^Esd, Dd, Qlf, Dd, Dd, Dd, Dd, Dd^Esd, Dd, Dd^Esd, Dd, Xue, Dd, Dd^Esd, Dd^Esd, Dd^Esd, Dd^Esd, Ql, Uue, Xue, Dd^Esd, Ql, Uue, Ql, Xue, Xue, Xue, Xue, Uue, Dd, Xue, Xue, Uue, Uue, Ql, Uue, Xue, Xue, Uue, Ql, Ql, Uue, Dd^Esd, Dd, Xue, Dd, Dd^Dc, Dd^Esd
Dd, Dd^Esd, Dd, Dd, Hd, Hd, Hd, Hd, Dd, Dd, Qlf, Dd, Uue, Xue, Uue, Qlf, Dd, Dd^Esd, Dd, Dd, Dd^Esd, Dd, Dd^Esd, Dd, Dd, Dd, Dd, Uue, Uue, Dd, Dd, Xue, Xue, Dd^Esd, Dd^Esd, Uue, Ql, Dd^Esd, Dd, Xue, Dd^Esd, Dd^Esd, Uue, Uue, Ql, Ql, Ql, Ql, Uue, Xue, Xue, Xue, Ql, Uue, Xue, Uue, Xue, Xue, Dd, Dd^Esd, Dd
Hd, Dd, Hd, Hd, Hd, Hd, Hd, Hd, Dd, Dd, Dd, Dd, Xue, Ql, Xue, Dd, Dd, Dd^Esd, Dd^Dc, Dd, Dd^Esd, Dd, Dd^Esd, Dd^Dc, Dd, Xue, Dd, Dd, Dd, Ql, Ql, Xue, Xue, Xue, Xue, Dd^Esd, Dd^Esd, Dd^Esd, Ql, Dd, Ql, Ql, Ql, Ql, Xue, Uue, Ql, Ql, Xue, Xue, Xue, Dd^Esd, Uue, Xue, Dd, Uue, Xue, Dd, Dd^Esd, Dd^Esd, Dd
Hd, Hd, Hd, Hd, Hd, Hd, Hd, Hd, Dd, Dd^Esd, Dd^Esd, Dd, Dd, Xue, Dd, Dd, Dd^Esd, Dd^Esd, Dd, Dd, Dd, Dd, Dd, Dd^Esd, Dd, Dd, Dd, Xue, Dd, Dd, Ql, Uue, Uue, Xue, Dd^Esd, Xue, Xue, Dd, Uue, Xue, Dd, Dd^Esd, Dd^Esd, Ql, Dd, Dd^Esd, Dd^Esd, Xue, Xue, Xue, Uue, Uue, Ql, Dd, Uue, Dd, Dd, Dd, Dd^Esd, Dd, Dd
Dd, Hd, Hd, Hd, Hd, Hd, Hd, Dd, Dd, Dd, Dd, Dd^Esd, Dd, Dd, Dd^Esd, Dd^Esd, Dd, Dd, Dd, Dd^Esd, Dd^Esd, Dd, Dd, Dd, Dd^Esd, Dd, Dd, Dd, Xue, Dd, Dd, Ql, Uue, Ql, Ql, Dd, Dd, Uue, Dd, Uue, Dd, Xue, Dd, Xue, Dd, Uue, Uue, Dd, Dd, Uue, Ql, Ql, Dd, Dd, Uue, Dd, Dd^Esd, Dd, Dd^Dc, Dd, Dd
