Aa^Fpa, Aa^Fpa, Aa^Fpa, Aa, Aa, Aa, Aa, Aa, Gll^Esa, Gg, Aa^Fpa, Aa, Aa, Aa, Aa, Aa, Gll^Esa, Gll^Esa, Aa^Feta, Gg, Aa^Feta, Aa, Aa, Aa, Aa^Fpa, Rra, Rra, Rra, Aa^Fpa, Aa, Gll^Esa, Gg^Esa, Aa^Fpa, Gd^Fetd, Aa, Gll^Fp, Aa^Fetd, Gll, Ai, Ai, Ai, Gd, Aa^Fetd, Aa^Fetd, Aa, Aa, Aa^Fpa, Hh^Fpa, Hh^Fpa, Mm, Mm, Mm, Mm, Mm, Mm, Mm, Mm
Aa^Feta, Aa, Gll^Esa, Aa^Fpa, Aa^Feta, Aa^Feta, Aa^Feta, Aa^Feta, Gll^Esa, Aa^Feta, Aa^Feta, Aa^Fpa, Aa^Fpa, Aa, Aa^Fpa, Aa^Feta, Gll^Esa, Aa, Aa^Fpa, Aa^Feta, Aa^Feta, Aa^Fpa, Aa^Fpa, Aa^Fpa, Gll^Esa, Rra, Aa^Feta, Rra, Gll^Esa, Aa, Aa^Fpa, Gd, Aa^Fpa, Aa, Aa^Fetd, Aa^Fetd, Aa^Fetd, Wwb^Cov, Ai, Wwb^Cov, Ai, Wwb^Cov, Aa, Aa^Fetd, Aa^Fetd, Aa, Aa^Fpa, Hh^Fpa, Hh^Fpa, Mm, Mm, Mm, Mm, Mm, Mm, Mm, Mm
Aa^Feta, Aa^Fpa, Aa^Fpa, Aa^Vea, Aa^Fpa, Aa^Fpa, Gll^Esa, Aa^Feta, Aa^Fpa, Aa^Fpa, Aa^Feta, Aa^Feta, Aa^Feta, Aa^Feta, Aa^Fpa, Aa^Fpa, Aa^Fpa, Aa, Hh^Fpa, Gll^Esa, Aa^Fpa, Aa^Feta, Aa^Feta, Aa^Fpa, Aa^Fpa, Rra, Aa^Feta, Rra, Aa, Aa, Aa^Fpa, Gll^Esa, Aa, Gll^Esa, Aa^Fetd, Aa^Fetd, Aa^Fetd, Wwb^Cov, Wwb^Cov, 2 Rb^Kov, Wwb^Cov, Wwb^Cov, Aa, Aa^Fetd, Aa^Fetd, Aa, Aa, Hh^Fpa, Hh^Fpa, Mm, Mm, Mm, Mm, Mm, Mm, Mm, Mm
Aa^Fpa, Aa^Fpa, Gll^Esa, Aa^Fpa, Hh^Fpa, Gll^Esa, Hh^Fpa, Aa, Hh^Fpa, Aa, Gll^Esa, Aa^Fpa, Gll^Esa, Aa^Feta, Aa^Feta, Aa^Fpa, Aa^Fpa, Hh^Fpa, Mm, Hh^Fpa, Hh^Fpa, Aa^Fpa, Hh^Fpa, Aa, Gll^Esa, Rra, Rra, Rra, Aa^Fpa, Aa, Aa^Fpa, Gll^Esa, Aa, Gll^Esa, Aa, Aa, Gd^Cov, Rb^Cov, Ai, Rb^Cov, Ai, Rb^Cov, Aa^Fetd, Aa^Fetd, Aa^Fetd, Aa, Gll^Esa, Hh^Fpa, Hh^Fpa, Mm, Mm, Mm, Mm, Mm, Mm, Mm, Mm
Hh^Fpa, Hh^Fpa, Hh^Fpa, Hh^Fpa, Hh^Fpa, Hh^Fpa, Hh^Fpa, Hh^Fpa, Hh^Fpa, Hh^Fpa, Hh^Fpa, Aa^Fpa, Aa^Fpa, Gll^Esa, Aa^Feta, Aa^Fpa, Gll^Esa, Hh^Fpa, Mm, Mm, Mm, Hh^Fpa, Hh^Fpa, Gll^Esa, Aa^Fpa, Rra, Aa^Feta, Rra, Aa^Fpa, Aa^Vea, Aa^Fpa, Aa^Fpa, Aa^Feta, Aa, Aa, Aa^Fetd, Aa^Fetd, Aa^Fetd, Aa^Fetd, Wwb^Cov, Aa^Fetd, Gd^Cov, Aa^Fetd, Aa^Fetd, Gll^Esa, Aa, Aa, Gll^Esa, Aa^Fpa, Hh^Fpa, Hh^Fpa, Mm, Mm, Mm, Mm, Mm, Mm
Hh^Fpa, Hh^Fpa, Mm, Mm, Mm, Mm, Mm, Mm, Mm, Hh^Fpa, Hh^Fpa, Gll^Esa, Aa^Fpa, Aa, Aa^Feta, Aa^Fpa, Aa^Fpa, Hh^Fpa, Hh^Fpa, Mm, Mm, Mm, Hh^Fpa, Aa, Aa^Fpa, Rra, Aa^Feta, Rra, Rra, Aa^Fpa, Gll^Esa, Aa^Feta, Gll^Esa, Aa, Aa, Aa^Fpa, Aa, Aa^Fetd, Aa^Fetd, Aa, Aa^Fetd, Aa^Fetd, Aa^Fetd, Aa^Fetd, Aa, Gll^Esa, Aa, Aa^Fpa, Aa^Feta, Hh^Fpa, Hh^Fpa, Hh^Fpa, Hh^Fpa, Mm, Hh^Fpa, Mm, Hh^Fpa
Mm, Mm, Mm, Mm, Mm, Mm, Mm, Mm, Mm, Mm, Mm, Hh^Fpa, Hh^Fpa, Aa^Vea, Aa^Fpa, Gll^Esa, Gll^Esa, Aa^Fpa, Hh^Fpa, Mm, Mm, Mm, Hh^Fpa, Aa^Vea, Aa^Fpa, Rra, Rra, Rra, Aa^Feta, Rra, Rra, Aa^Feta, Aa, Aa^Feta, Aa^Fpa, Aa, Aa, Aa, Aa, Aa^Fetd, Aa, Aa, Aa^Fpa, Aa, Gll^Esa, Aa^Fpa, Aa^Vea, Gll^Esa, Aa, Gll^Esa, Gll^Esa, Aa, Gll^Esa, Hh^Fpa, Hh^Fpa, Hh^Fpa, Aa^Fpa
Mm, Mm, Mm, Mm, Hh^Fp, Mm, Hh^Fp, Mm, Hh^Fp, Mm, Mm, Mm, Mm, Hh^Fpa, Gll^Esa, Aa^Fpa, Aa^Feta, Hh^Fpa, Mm, Mm, Mm, Mm, Hh^Fpa, Hh^Fpa, Aa^Fpa, Aa^Fpa, Aa, Rra, Rra, Aa^Feta, Rra, Rra, Rra, Gll^Esa, Aa^Fpa, Gll^Esa, Gll^Esa, Aa, Aa, Aa, Aa^Fpa, Aa, Gll^Esa, Aa^Feta, Aa^Fpa, Aa^Fpa, Gll^Esa, Aa^Fpa, Aa^Fpa, Aa, Aa, Aa^Feta, Aa^Fpa, Gll^Esa, Aa^Feta, Aa^Feta, Aa
Mm, Mm, Hh^Fp, Hh^Fp, Gg^Fet, Hh^Fp, Ww^Ewf, Hh^Fp, Gg^Fet, Hh^Fp, Hh^Fp, Mm, Mm, Hh^Fpa, Hh^Fpa, Gll^Esa, Aa^Feta, Hh^Fpa, Hh^Fpa, Mm, Mm, Mm, Hh^Fpa, Gll^Esa, Aa^Fpa, Aa^Fpa, Aa, Gll^Esa, Aa, Rra, Rra, Aa^Feta, Aa^Feta, Rra, Rra, Aa, Aa^Fpa, Aa^Feta, Aa^Fpa, Aa, Gll^Esa, Aa^Feta, Aa^Fpa, Aa^Fpa, Aa, Gll^Esa, Aa^Fpa, Gll^Esa, Aa, Aa^Fpa, Aa, Aa^Fpa, Aa, Aa^Fpa, Gll^Esa, Aa^Fpa, Ai
Mm, Mm, Hh^Fp, Hh^Fp, Wwt, Wwt, Wwt, Ww^Ewf, Ww^Ewf, Hh^Fp, Hh^Fp, Mm, Mm, Mm, Hh^Fpa, Hh^Fpa, Aa^Feta, Aa, Aa^Fpa, Hh^Fpa, Hh^Fpa, Hh^Fpa, Gll^Esa, Aa, Aa^Fpa, Gll^Esa, Aa, Aa, Aa^Fpa, Gll^Esa, Aa^Fpa, Rra, Rra, Rra, Rra, Gll^Esa, Aa, Aa, Gll^Esa, Aa^Fpa, Aa^Vea, Aa^Feta, Aa^Fpa, Aa^Fpa, Aa^Feta, Aa, Aa^Fpa, Aa^Feta, Aa^Fpa, Aa^Fpa, Aa^Vea, Aa^Fpa, Aa, Gll^Esa, Wwt, Ai, Aa
Mm, Mm, Hh^Fp, Gg^Fet, Ww^Ewf, Ww^Ewf, Ww^Ewf, Wwt, Ww^Ewf, Gg^Fet, Hh^Fp, Hh^Fp, Mm, Mm, Hh^Fpa, Aa^Fpa, Aa^Fpa, Aa^Feta, Aa, Aa^Fpa, Aa, Aa, Aa, Aa^Fpa, Aa^Fpa, Aa, Aa^Feta, Aa^Feta, Aa^Fpa, Aa, Hh^Fpa, Aa^Fpa, Rra, Aa^Feta, Rra, Aa, Aa, Gll^Esa, Aa, Aa, Aa, Aa^Fpa, Aa, Gll^Esa, Aa^Feta, Aa^Fpa, Aa^Feta, Aa^Fpa, Aa^Fpa, Aa^Feta, Aa^Fpa, Aa^Fpa, Aa, Ww^Ewl, Aa^Feta, Aa^Feta, Aa^Fpa
Mm, Mm, Hh^Fp, Hh^Fp, Ww^Ewf, Wwt, Wot, Wot, Ww^Ewf, Wwt, Hh^Fp, Mm, Mm, Mm, Hh^Fpa, Aa^Fpa, Aa^Fpa, Aa, Gll^Esa, Aa^Fpa, Aa^Fpa, Gll^Esa, Aa^Fpa, Aa, Aa^Fpa, Gll^Esa, Gll^Esa, Aa^Fpa, Aa, Ha, Ha, Hh^Fpa, Rra, Rra, Rra, Aa^Fpa, Wwt, Ai, Ww^Ewl, Ww^Ewl, Wwt, Aa, Ww^Ewl, Aa^Feta, Gll^Esa, Aa^Fpa, Gll^Esa, Aa^Fpa, Gll^Esa, Aa^Fpa, Gll^Esa, Gll^Esa, Ww^Ewl, Ai, Aa^Fpa, Aa, Gll^Esa
Mm, Mm, Hh^Fp, Gg^Fet, Wwt, Wwt, Ww^Ewf, Wwt, Ww^Ewf, Wwt, Gg^Fet, Hh^Fp, Hh^Fp, Hh^Fp, Gll^Esa, Gll^Esa, Aa^Fpa, Aa^Feta, Aa, Gll^Esa, Aa, Aa^Feta, Gll^Esa, Aa^Feta, Aa^Fpa, Aa, Gll^Esa, Aa^Fpa, Aa^Fpa, Hh^Fpa, Hh^Fpa, Hh^Fpa, Rra, Aa^Feta, Rra, Ww^Ewl, Aa^Feta, Aa^Feta, Aa, Aa^Fpa, Aa^Fpa, Ai, Aa, Ww^Ewl, Ai, Aa, Aa, Aa^Fpa, Aa, Aa, Ai, Ww^Ewl, Gll^Esa, Gll^Esa, Aa^Fpa, Gll^Esa, Aa
Mm, Mm, Mm, Hh^Fp, Gg^Fet, Ww^Ewf, Wwt, Wwt, Gg^Fet, Wwt, Wwt, Aa^Fpa, Aa^Fpa, Aa^Fpa, Aa, Aa^Vea, Aa^Fpa, Gll^Esa, Aa^Fpa, Aa, Aa^Fpa, Gll^Esa, Aa^Fpa, Gll^Esa, Aa^Fpa, Aa, Aa, Aa, Aa^Fpa, Aa^Fpa, Aa, Aa^Fpa, Rra, Rra, Wwt^Bsa|, Ai, Aa, Aa, Ha, Hh^Fpa, Hh^Fpa, Ha, Ha, Aa, Aa^Feta, Ww^Ewl, Ai, Ai, Ww^Ewl, Wwt, Gll, Aa, Aa^Fpa, Aa, Aa^Feta, Aa^Fpa, Aa
Mm, Mm, Mm, Hh^Fp, Hh^Fp, Hh^Fp, Hh^Fp, Gg^Fet, Hh^Fp, Gll^Fp, Aa^Fpa, Ai, Aa^Fpa, Aa^Feta, Aa^Fpa, Aa^Fpa, Gll^Esa, Gll^Esa, Aa^Feta, Aa^Feta, Aa^Feta, Aa^Feta, Aa, Aa^Fpa, Aa, Gll^Esa, Ai, Aa, Ai, Aa, Wwt, Aa^Fpa, Wwt^Bsa|, Wwt^Bsa|, Rra, Aa^Fpa, Aa, Aa^Fpa, Hh^Fpa, Ha, Ha, Hh^Fpa, Ha, Aa^Feta, Aa, Aa^Fpa, Aa^Fpa, Aa^Vea, Aa, Gll, Aa^Feta, Aa^Fpa, Hh^Fpa, Gll, Hh, Aa^Fpa, Aa^Fpa
Mm, Mm, Mm, Mm, Mm, Mm, Mm, Hh^Fp, Mm, Hh^Fpa, Aa^Fpa, Ai, Aa, Gll^Esa, Aa^Feta, Aa^Feta, Gll^Esa, Aa, Ai, Gll^Esa, Aa, Gll^Esa, Aa, Gll^Esa, Ww^Ewl, Ww^Ewl, Aa, Ai, Aa, Ww^Ewl, Aa, Wwt, Rra, Rra, Rra, Aa^Fpa, Aa^Fpa, Aa^Fpa, Aa^Fpa, Hh^Fpa, Aa, Hh^Fpa, Hh^Fpa, Gll^Fp, Gll, Aa, Aa^Fpa, Aa, Aa^Feta, Aa, Hh^Fpa, Hh, Hh^Fpa, Hh^Fpa, Hh, Hh, Gg
Hh^Fp, Mm, Mm, Mm, Mm, Mm, Mm, Mm, Mm, Hh^Fpa, Hh^Fpa, Ww^Ewl, Wwt, Gll^Esa, Wwt, Ww^Ewl, Ai, Ww^Ewl, Gll, Ww^Ewl, Ai, Wwt, Ai, Wwt, Aa^Fpa, Aa^Fpa, Aa^Fpa, Aa, Aa^Fpa, Aa, Aa^Fpa, Aa^Fpa, Rra, Rra, Rra, Gll^Fp, Aa^Feta, Gll^Fp, Aa^Fpa, Gll^Fp, Aa, Gll^Fp, Aa^Fpa, Aa^Fpa, Gll^Fp, Aa^Feta, Gll^Fp, Gll, Aa^Fpa, Aa^Fpa, Hh^Fpa, Hh, Hh, Hh^Fpa, Hh^Fp, Hh^Fp, Gg
Hh^Fp, Hh^Fp, Hh^Fp, Mm, Mm, Mm, Mm, Mm, Hh^Fpa, Hh^Fpa, Aa^Fpa, Aa^Fpa, Aa, Wwt, Gll, Aa, Gll^Fp, Aa, Aa^Fpa, Aa^Fpa, Aa^Feta, Aa^Vea, Aa^Feta, Aa, Gll^Fp, Aa, Gll^Fp, Aa^Fpa, Aa^Fpa, Gll^Fp, Aa^Feta, Aa^Feta, Cva, Cva, Cva, Aa^Feta, Gg^Fet, Aa^Fpa, Gll^Fp, Gg, Gll^Fp, Gg, Gg^Fet, Gg^Fet, Aa^Fpa, Aa^Fpa, Aa, Gll, Aa^Feta, Aa^Fpa, Gll, Hh^Fp, Hh^Fpa, Hh, Hh, Hh^Fpa, Gg
Gll^Fp, Hh^Fp, Hh^Fp, Hh^Fp, Hh^Fp, Mm, Hh^Fp, Hh^Fp, Aa^Feta, Aa^Fpa, Aa^Vea, Gll, Aa^Feta, Gll, Aa^Fpa, Aa, Gg^Fet, Aa^Fpa, Gll^Fp, Gg^Fet, Aa^Fpa, Aa, Gll^Fp, Aa^Fpa, Gll, Gg^Fet, Aa^Feta, Gll, Aa, Gg, Gg^Fet, Cva, Rra, Rra, Rra, Cva, Aa^Feta, Gll^Fp, Aa^Fpa, Aa^Fpa, Aa^Vea, Gg^Fet, Aa, Gll, Aa, Aa, Gg, Gll^Fp, Aa, Gg^Fet, Aa, Gll, Hh^Fpa, Hh^Fp, Hh, Hh^Fpa, Gg
Gll^Fp, Aa^Fpa, Aa^Fpa, Gll^Fp, Gll^Fp, Hh^Fp, Gll^Fp, Gll^Fp, Aa^Fpa, Aa^Fpa, Hh^Fpa, Aa^Fpa, Aa^Fpa, Aa^Fpa, Gg^Fet, Aa^Fpa, Aa, Gll^Fp, Aa^Fpa, Gll, Gll, Aa, Cva, Gg, Aa, Aa, Aa^Fpa, Aa, Gg, Aa^Fpa, Gg^Fet, Cva, Rra, Rra, Rra, Cva, Gg^Fet, Aa^Fpa, Gll^Fp, Aa^Fpa, Gll^Fp, Aa, Aa^Fpa, Gll^Fp, Gg, Aa, Cva, Gll, Aa, Gg, Gll^Fp, Aa^Fpa, Gg, Gll, Gll^Fp, Aa^Fpa, Gll^Fp
Gg^Fet, Aa, Gll^Fp, Gll^Fp, Hh^Fp, Hh^Fp, Hh^Fp, Hh^Fp, Hh^Fp, Hh^Fpa, Mm, Hh, Hh, Gll^Fp, Aa^Fpa, Gg^Fet, Aa, Aa^Vea, Gll^Fp, Aa^Fpa, Gll, Cva, Gg^Fet, Cva, Aa, Gll, Aa^Fpa, Aa, Gll^Fp, Aa^Fpa, Aa, Gg, Rra, Rra, Rra, Gll, Aa, Aa^Fpa, Gll^Fp, Aa^Feta, Gg^Fet, Aa^Fpa, Aa^Fpa, Gg^Fet, Aa, Cva, Gg^Fet, Cva, Gg, Aa^Feta, Aa^Fpa, Aa^Fpa, Aa^Fpa, Aa^Vea, Gg^Fet, Aa^Fpa, Gg
Gg, Aa^Vea, Aa^Fpa, Hh^Fp, Mm, Mm, Mm, Mm, Mm, Mm, Mm, Mm, Mm, Hh^Fpa, Hh^Fpa, Gg^Fet, Gg^Fet, Gll^Fp, Gll, Gg^Fet, Gg, Cva, Gll, Cva, Aa^Fpa, Aa, Gg^Fet, Gll^Fp, Gg^Fet, Aa, Gg, Gll^Fp, Aa^Fpa, Rra, Rra, Rra, Gll^Fp, Aa^Fpa, Gg^Fet, Aa^Fpa, Aa^Fpa, Gll^Fp, Aa, Gll^Fp, Gg, Cva, Aa, Cva, Aa, Gll, Aa^Fpa, Gll^Fp, Aa^Fpa, Gll^Fp, Gll^Fp, Gg^Fet, Hh^Fp
Gg^Fet, Gll, Gll^Fp, Hh^Fp, Mm, Mm, Mm, Mm, Hh, Mm, Mm, Mm, Mm, Mm, Hh^Fp, Aa^Fpa, Aa, Aa, Aa^Fpa, Aa^Feta, Aa, Aa, Aa, Gll^Fp, Aa, Gll^Fp, Gll, Gg^Fet, Aa, Aa, Gg, Aa, Gg^Fet, Rra, Rra, Rra, Gg^Fet, Gg, Gll, Aa, Gg, Gg^Fet, Gll^Fp, Aa^Feta, Gll, Gll, Aa, Gll, Gg^Fet, Aa^Fpa, Aa^Fpa, Gg^Fet, Gll, Gll, Hh^Fp, Hh^Fp, Mm
Gg, Aa^Fpa, Aa, Hh, Hh, Hh^Fp, Hh^Fp, Hh, Gg, Hh, Hh^Fp, Mm, Mm, Mm, Mm, Hh, Gg, Aa^Fpa, Aa, Gg^Fet, Gll^Fp, Aa^Feta, Gll^Fp, Aa, Aa^Fpa, Aa^Fpa, Gll, Aa, Ai, Ww^Ewl, Ai, Ai, Wwt, Rra, Wwt^Bsa|, Rra, Wwt, Wwt, Ww^Ewl, Ai, Ww^Ewl, Gll, Aa, Aa^Fpa, Aa^Fpa, Gll^Fp, Gg^Ve, Gll^Fp, Aa^Fpa, Gll, Hh^Fp, Hh^Fp, Hh^Fp, Hh^Fp, Mm, Mm, Mm
Gg, Aa, Aa^Fpa, Gll, Gg, Hh^Fp, Gll^Fp, Gll^Fp, Gll, Gll^Fp, Gll, Hh^Fp, Mm, Mm, Mm, Hh, Gg, Gll^Fp, Aa, Gg, Gg, Gg, Gg^Fet, Aa^Feta, Gg, Gll, Ww^Ewl, Wwt, Cva, Kva, Cva, Cva, Kva, Wwt^Bsa|, Rra, Wwt^Bsa|, Kva, Cva, Cva, Kva, Cva, Ww^Ewl, Ai, Gg, Aa, Aa, Gg^Fet, Aa^Feta, Aa^Fpa, Hh^Fp, Mm, Mm, Mm, Mm, Mm, Mm, Mm
Gg^Fet, Gg, Aa^Fpa, Gll^Fp, Gll^Fp, Gg^Ve, Aa^Fpa, Aa^Fpa, Gg, Aa^Fpa, Aa^Fpa, Hh^Fp, Hh^Fp, Mm, Mm, Hh^Fp, Gll^Fp, Aa^Feta, Aa^Fpa, Aa, Gg^Fet, Aa^Feta, Gg, Aa, Ww^Ewl, Ai, Cva, Cva, Gg, Gg^Efm, Gg^Efm, Gg, Gg^Efm, Rra, Rra, Rra, Aa^Feta, Gg, Aa^Feta, Gg^Efm, Aa^Feta, Cva, Cva, Wwt, Ai, Gg, Aa, Gg^Fet, Gll^Fp, Hh^Fp, Mm, Mm, Mm, Mm, Mm, Mm, Mm
Gg, Gll^Fp, Gll^Fp, Aa, Gg^Fet, Gll^Fp, Gg^Fet, Aa, Gg^Fet, Gll^Fp, Aa, Hh, Hh^Fp, Mm, Mm, Hh, Aa^Fpa, Aa^Fpa, Gg, Gg, Aa^Fpa, Aa^Fpa, Aa, Aa, Ai, Kva, Gg, Gg, Aa^Feta, Gg^Efm, Gg, Aa^Feta, Aa^Vea, Rra, Aa^Feta, Rra, Gg^Fet, Gg^Efm, Gg^Efm, Gg, Gg^Fet, Aa^Feta, Gg^Efm, Kva, Ww^Ewl, Gg, Gg, Aa, Aa^Feta, Hh^Fp, Hh^Fp, Mm, Hh^Fp, Mm, Hh^Fp, Mm, Mm
Gll, Gll, Aa, Aa^Fpa, Aa, Gll^Fp, Gll^Fp, Aa^Fpa, Aa^Fpa, Gg^Fet, Gll^Fp, Gg, Aa^Fpa, Hh^Fp, Hh, Hh, Aa, Gll^Fp, Gg, Gg^Fet, Gll^Fp, Gg^Fet, Gg, Ai, Kva, Cva, Gg^Efm, Aa^Feta, Cva, Kva, Cva, Aa^Feta, Gg^Fet, Rra, Rra, Rra, Aa^Vea, Gg, Cva, 5 Kva, Cva, Gg^Fet, Gg^Efm, Cva, Kva, Ai, Gg, Aa, Gll^Fp, Aa, Gll^Fp, Hh^Fp, Gg, Hh^Fp, Gll, Hh^Fp, Mm
Wwt, Gll, Gll, Gll, Gg, Gll, Gll, Gll, Aa, Aa, Gll, Gll^Fp, Aa^Fpa, Gg, Gll^Fp, Aa, Gg, Gll^Fp, Aa^Vea, Aa^Fpa, Gg, Aa^Fpa, Gll^Fp, Wwt, Cva, Gg^Efm, Aa^Feta, Cva, Aa, Cva, Aa, Aa^Feta, Gg^Efm, Rra, Aa^Feta, Rra, Gg^Efm, Gg^Fet, Gg, Cva, Gg^Efm, Cva, Gg, Aa^Feta, Cva, Ai, Gg^Fet, Gll, Gg^Ve, Gg, Aa^Feta, Aa^Fpa, Gg^Fet, Gll, Gll^Fp, Hh^Fp, Hh^Fp
Wwt, Ww^Ewl, Ww^Ewl, Wwt, Wwt, Wwt, Wwt, Gg^Ve, Wwt, Wwt, Ww^Ewl, Gg^Fet, Gg, Aa^Fpa, Gg^Fet, Aa, Aa^Fpa, Gg^Fet, Gll^Fp, Aa^Fpa, Gll^Fp, Gg, Wwt, Ww^Ewl, Cva, Gg^Fet, Gg^Fet, Cva, Cva, Gg^Efm, Aa^Feta, Gg^Fet, Gg^Efm, Rra, Rra, Rra, Gg, Gg^Efm, Aa^Feta, Gg^Efm, Cva, Cva, Gg^Fet, Gg^Fet, Cva, Wwt, Ww^Ewl, Aa, Gll^Fp, Gg^Fet, Gll^Fp, Gg, Gll, Gg^Fet, Gll^Fp, Gll^Fp, Gg
Gg, Wwt, Wwt, Wwt, Wwt, Wwt, Wwt, Wwt, Wwt, Wwt, Ww^Ewl, Wwt, Gll, Gll^Fp, Gg, Aa^Fpa, Gll^Fp, Gg, Aa^Fpa, Gg, Gll^Fp, Gg, Wwt, Kva, Gg, Gg, Aa^Feta, Gg, Gg^Fet, Gg^Efm, Aa^Vea, Gg, Kva, Kva, Kva, Kva, Kva, Gg^Efm, Aa, Aa^Feta, Aa, Aa, Gg^Efm, Gg^Efm, Gg, Kva, Ww^Ewl, Gll^Fp, Aa, Aa, Aa^Fpa, Aa^Fpa, Aa^Fpa, Gg^Ve, Gg^Fet, Gll^Fp, Gg^Fet
Gg^Fet, Aa, Gll, Aa, Aa^Feta, Aa, Aa, Ww^Ewl, Aa, Aa^Feta, Wwt, Ww^Ewl, Wwt, Aa^Fpa, Gll^Fp, Gg, Gg^Fet, Aa^Feta, Gg, Aa^Fpa, Rp, Ww^Ewl, Kva, Cva, Gg^Efm, Gg^Fet, Aa^Vea, Gg^Fet, Gg^Efm, Aa, Aa, Gg, Kva, Gg^Fet, Cv, Gg^Fet, Kva, Gg, Gg^Fet, Gg^Fet, Aa^Vea, Aa^Feta, Gg^Fet, Aa^Vea, Gg^Fet, Cva, Kva, Ai, Rp, Gll, Aa^Fpa, Aa, Gll^Fp, Gll^Fp, Aa^Fpa, Gg^Fet, Gll
Gg^Fet, Gll^Fp, Gg^Ve, Gll^Fp, Gll, Gg^Fet, Aa^Feta, Gll^Fp, Gll^Fp, Gg, Aa^Fpa, Ww^Ewl, Wwt, Wwt, Rp, Rp, Rp, Rp, Rp, Rp, Aa^Feta, Wwt^Bsa\, Rp, Rra, Rra, Rra, Rp, Rra, Rra, Rra, Rra, Kva, Gg^Fet, Cv, 3 Kva, Cv, Gg^Fet, Kva, Rra, Gg^Efm, Rra, Gg^Efm, Rra, Aa^Feta, Rra, Gg^Efm, Rra, Wwt^Bsa/, Gg^Fet, Rp, Rp, Rp, Rp, Rp, Rp, Rp, Rp
Gg, Gg, Gll^Fp, Gll^Fp, Gll, Gll^Fp, Gg, Aa^Vea, Gll^Fp, Gg^Fet, Gll^Fp, Gll, Ww^Bsb/, Wwt^Bsb/, Rp, Rp, Rp, Rp, Rp, Rp, Gg^Fet, Ai, Rp, Rp, Rra, Rp, Rra, Rp, Rra, Rp, Rp, Kva, Kva, Cv, Cv, Cv, Kva, Kva, Rp, Rra, Rp, Rra, Rp, Rra, Rp, Rra, Rp, Ww^Ewl, Gg^Fet, Rp, Rp, Rp, Rp, Rp, Rp, Rp, Rp
Gll^Fp, Gg^Fet, Aa^Feta, Aa, Cva, Cva, Cva, Gll^Fp, Gll, Gg, Rp, Rp, Wwt^Bsb/, Wwt^Bsb/, Wwt, Aa^Feta, Hh, Gg, Gg^Fet, Rp, Rp, Wwt^Bsa/, Kva, Gg^Efm, Aa^Feta, Gg^Efm, Aa^Vea, Aa, Aa^Feta, Gg^Efm, Gg^Efm, Gg, Kva, Gg^Fet, Kva, Gg^Fet, Kva, Gg, Aa, Rra, Gg^Efm, Rra, Aa, Rra, Gg^Efm, Rra, Kva, Wwt^Bsb\, Rp, Rp, Gg, Aa^Fpa, Aa^Fpa, Gll^Fp, Aa, Aa^Fpa, Gg
Gll^Fp, Gll, Gg^Fet, Aa, Cv, Kv, Cv, Gll, Rp, Rp, Rp, Rp, Gg^Ve, Wwt, Ww^Ewl, Hh^Fpa, Hh^Fpa, Hh, Gll^Fp, Aa^Fpa, Aa^Feta, Ai, Wwt, Cva, Gg, Gg^Fet, Gg^Fet, Gg^Efm, Gg^Efm, Aa^Vea, Gg^Fet, Gg, Gg^Efm, Kva, Rra, Kva, Gg, Gg^Fet, Aa, Aa^Vea, Gg^Efm, Gg^Fet, Aa^Vea, Gg^Efm, Aa^Feta, Cv, Ww^Ewl, Wwt, Gll, Aa^Fpa, Gg^Fet, Aa, Gll^Fp, Gg^Fet, Gll^Fp, Gg^Fet, Gg^Fet
Rp, Gg, Aa^Fpa, Gg, Kv, Cv, Gg^Fet, Cv, Kva, Rp, Gg, Gg^Fet, Gg, Wwt, Wwt, Hh, Hh, Hh^Fp, Ww^Ewl, Wwt, Wwt, Gg^Fet, Wwt, Kva, Cva, Gg^Efm, Aa, Aa, Gg^Fet, Gg, Gg^Fet, Gg^Efm, Gg^Efm, Rra, Aa^Feta, Rra, Gg^Efm, Aa, Aa^Feta, Aa^Feta, Aa^Feta, Gg^Efm, Gg^Fet, Gg^Fet, Cva, Kva, Ww^Ewl, Gg, Gll, Aa^Fpa, Gll^Fp, Gll, Aa, Gll^Fp, Gg^Ve, Gll^Fp, Gg^Fet
Rp, Rp, Rp, Gll, Rp, Cv, Cv, Cv, Cv, Gg, Gg^Fet, Aa^Fpa, Gll^Fp, Wwt, Wwt, Hh^Fp, Hh, Wwt, Wwt, Wwt, Ww^Ewl, Wwt, Ww^Ewl, Wwt, Cva, Gg^Efm, Aa^Feta, Cva, Gg, Gg^Fet, Aa, Cva, Gg^Fet, Rra, Rp, Rra, Gg^Efm, Cva, Gg^Efm, Gg^Fet, Gg^Efm, Cva, Gg^Efm, Gg^Efm, Cva, Wwt, Gll, Gg, Aa^Fpa, Gg, Gg^Fet, Gg, Aa^Fpa, Gg^Fet, Gll^Fp, Aa^Feta, Gg^Fet
Gll^Fp, Rp, Rp, Rp, Rp, Rp, Cv, Kv, Cv, Gg, Gg^Fet, Gg, Aa^Fpa, Ww^Ewl, Wwt, Hh, Hh^Fp, Wwt, Ww^Ewl, Gll^Fp, Gll^Fp, Wwt, Aa^Vea, Ww^Ewl, Kva, Gg, Gg^Fet, Cva, Cva, Cva, Cva, Cva, Gg^Fet, Rra, Gg^Fet, Rra, Gg^Fet, Cva, Cva, Cva, Cva, Cva, Gg^Fet, Aa, Kva, Wwt, Gll^Fp, Aa^Fpa, Aa, Aa, Gll, Aa^Fpa, Gll^Fp, Gg, Gll^Fp, Gg^Fet, Gg
Gg, Gll, Aa^Fpa, Rp, Aa^Fpa, Gg, Gg, Cv, Gg, Gll^Fp, Aa, Aa, Hh^Fpa, Wwt, Wwt, Wwt, Wwt, Ww^Ewl, Wwt, Gg^Fet, Aa^Feta, Gll, Gll^Fp, Ai, Wwt, Cva, Gg, Gg^Fet, Gg^Fet, 4 Kva, Gg, Aa, Gg^Efm, Rp, Rp, Rp, Aa^Vea, Gg^Fet, Gg^Efm, Kva, Gg^Fet, Gg^Fet, Gg^Efm, Cva, Ww^Ewl, Ww^Ewl, Gll^Fp, Aa^Feta, Gll^Fp, Gll^Fp, Gll^Fp, Gg^Fet, Aa^Feta, Gll^Fp, Gll, Gll, Hh
Hh, Gg^Fet, Gg, Aa, Gll^Fp, Gg, Gll^Fp, Gg, Aa^Fpa, Aa^Fpa, Gg, Hh^Fp, Hh^Fpa, Gll^Fp, Gg^Fet, Ww^Ewl, Wwt, Wwt, Gll, Gg, Aa, Aa^Fpa, Gll, Gg^Fet, Ww^Ewl, Kva, Cva, Gg^Efm, Gg^Efm, Gg^Efm, Gg^Fet, Gg^Fet, Gg^Efm, Rp, Gg^Fet, Rra, Gg^Efm, Gg^Efm, Gg^Fet, Gg^Fet, Gg^Fet, Gg^Efm, Cva, Kva, Wwt, Gll^Fp, Gg, Gll^Fp, Gg^Fet, Gg^Ve, Gll^Fp, Aa, Aa, Aa^Fpa, Gg, Hh, Mm
Hh^Fp, Hh, Hh^Fp, Gg^Ve, Aa^Fpa, Aa, Gg^Fet, Gg, Gll^Fp, Gll^Fp, Aa, Hh, Hh, Aa^Fpa, Hh, Aa^Fpa, Hh, Hh, Aa^Fpa, Aa^Fpa, Hh, Aa, Hh^Fpa, Aa^Fpa, Aa, Ai, Wwt, Cva, Cva, Gg, Cva, Aa, Kva, Rp, Rp, Rp, Kva, Gg^Fet, Cva, Gg^Efm, Cva, Cva, Ww^Ewl, Wwt, Gll^Fp, Aa, Gll^Fp, Aa^Fpa, Aa^Fpa, Gll^Fp, Gg^Fet, Gll^Fp, Gll, Aa^Fpa, Hh^Fp, Hh^Fp, Mm
Mm, Hh^Fp, Hh, Gll, Gll^Fp, Aa^Fpa, Aa, Gg^Fet, Gg^Fet, Aa^Fpa, Gll^Fp, Hh^Fp, Hh, Hh^Fp, Hh, Hh^Fpa, Hh, Gll^Fp, Aa, Gll^Fp, Hh^Fp, Hh, Hh^Fp, Gll^Fp, Aa, Gg, Aa, Ww^Ewl, Ai, Kva, Ww^Ewl, Cva, Ai, Wwt^Bsa|, Wwt^Bsb|, Wwt^Bsa|, Ai, Cva, Ww^Ewl, Kva, Wwt, Ww^Ewl, Gll, Gll, Aa^Feta, Gll, Gg, Aa, Gll^Fp, Gll^Fp, Aa, Gg, Hh^Fp, Hh^Fp, Hh^Fp, Mm, Mm
Mm, Mm, Hh^Fp, Hh, 1 Gg, Gg, Gll, Gg^Ve, Gll^Fp, Gg, Aa^Fpa, Aa, Gg, Hh^Fp, Gll, Hh^Fp, Gll^Fp, Gg, Hh, Hh^Fp, Mm, Mm, Mm, Hh, Gg, Gg^Ve, Gll^Fp, Gll^Fp, Gll^Fp, Ai, Aa, Ww^Ewl, Gg, Rp, Rp, Rp, Aa, Ai, Aa, Wwt, Gll, Aa, Gg^Fet, Gll^Fp, Aa^Vea, Gll^Fp, Gg^Fet, Gg^Fet, Gg^Ve, Aa, Hh, Hh^Fp, Hh, Hh, Mm, Mm, Mm
Mm, Mm, Mm, Hh^Fp, Hh, Gll^Fp, Hh, Gll, Gg, Gg^Fet, Gll^Fp, Gll, Gll^Fp, Gll, Gll^Fp, Gll^Fp, Gll, Gg^Fet, Hh, Hh^Fp, Mm, Mm, Mm, Hh, Hh^Fp, Gll^Fp, Gll^Fp, Aa^Feta, Gll^Fp, Gg, Gll^Fp, Aa, Gll^Fp, Rp, Aa^Feta, Rp, Gll^Fp, Gll, Gll, Gg, Gll^Fp, Gll, Gll^Fp, Gll^Fp, Aa, Aa, Gg^Fet, Gll^Fp, Gll^Fp, Gg, Hh, Hh^Fp, Mm, Hh^Fp, Mm, Mm, Mm
Mm, Mm, Mm, Hh^Fp, Hh^Fp, Hh^Fp, Hh^Fp, Hh, Gll, Gll^Fp, Gg, Gll, Gg, Gg^Fet, Gg^Fet, Gll, Gg, Hh, Hh^Fp, Mm, Mm, Mm, Mm, Mm, Hh, Gll^Fp, Gg^Fet, Gll^Fp, Gll^Fp, Gg^Ve, Gg^Fet, Gll^Fp, Gll^Fp, Rp, Aa^Feta, Rp, Gll^Fp, Gll^Fp, Gll^Fp, Gll^Fp, Gg, Gll^Fp, Gll^Fp, Gll^Fp, Gg^Fet, Gll^Fp, Gg, Gll, Hh^Fp, Hh^Fp, Mm, Mm, Mm, Mm, Mm, Mm, Mm
Mm, Mm, Mm, Mm, Mm, Mm, Mm, Hh^Fp, Gg, Gll, Gll^Fp, Gg^Fet, Gg, Gll^Fp, Gll^Fp, Gll, Gg, Hh^Fp, Mm, Mm, Mm, Mm, Mm, Mm, Mm, Hh^Fp, Gg, Gg^Fet, Gg^Fet, Gll, Gg, Gg^Fet, Gg, Rp, Rp, Rp, Gg, Gg^Ve, Gll^Fp, Gg^Fet, Gg^Fet, Gll^Fp, Gll^Fp, Gll^Fp, Gg^Fet, Gll^Fp, Gg, Hh^Fp, Hh^Fp, Mm, Mm, Mm, Mm, Mm, Mm, Mm, Mm
