border_size=1
usage=map

Gll^Fp, Gll^Fp, Gll^Fp, Gg, Gg, Gg, Gg, Gg, Gll, Gg, Gll^Fp, Gg, Gg, Gg, Gg, Gg, Gll, Gll, Gg^Fet, Gg, Gg^Fet, Gg, Gg^Fet, Gg, Gll^Fp, Rp, Rp, Rp, Gll^Fp, Gg, Gll, Gg, Gll^Fp, Gd^Fetd, Gd, Gll^Fp, Gd^Fetd, Gll, Rb, Rb, Rb, Gd, Gd^Fetd, Gd^Fetd, Gd, Gd, Gll^Fp, Hh^Fp, Hh^Fp, Mm, Mm, Mm, Mm, Mm, Mm, Mm, Mm
Gg^Fet, Gg, Gll, Gll^Fp, Gg^Fet, Gg^Fet, Gg^Fet, Gg^Fet, Gll, Gg^Fet, Gg^Fet, Gll^Fp, Gll^Fp, Gg, Gll^Fp, Gg^Fet, Gll, Gg, Gll^Fp, Gg^Fet, Gg^Fet, Gll^Fp, Gll^Fp, Gll^Fp, Gll, Rp, Gg^Fet, Rp, Gll, Gg, Gll^Fp, Gd, Gll^Fp, Gd, Gd^Fetd, Gd^Fetd, Gd^Fetd, Wwb^Cov, Rb, Wwb^Cov, Rb, Wwb^Cov, Gd, Gd^Fetd, Gd^Fetd, Gd, Gll^Fp, Hh^Fp, Hh^Fp, Mm, Mm, Mm, Mm, Mm, Mm, Mm, Mm
Gg^Fet, Gll^Fp, Gll^Fp, Gg^Ve, Gll^Fp, Gll^Fp, Gll, Gg^Fet, Gll^Fp, Gll^Fp, Gg^Fet, Gg^Fet, Gg^Fet, Gg^Fet, Gll^Fp, Gll^Fp, Gll^Fp, Gg, Hh^Fp, Gll, Gll^Fp, Gg^Fet, Gg^Fet, Gll^Fp, Gll^Fp, Rp, Gg^Fet, Rp, Gg, Gg, Gll^Fp, Gll, Gg, Gd, Gd^Fetd, Gd^Fetd, Gd^Fetd, Wwb^Cov, Wwb^Cov, 2 Rb^Kov, Wwb^Cov, Wwb^Cov, Gd, Gd^Fetd, Gd^Fetd, Gd, Gd, Hh^Fp, Hh^Fp, Mm, Mm, Mm, Mm, Mm, Mm, Mm, Mm
Gll^Fp, Gll^Fp, Gll, Gll^Fp, Hh^Fp, Gll, Hh^Fp, Gg, Hh^Fp, Gg, Gll, Gll^Fp, Gll, Gg^Fet, Gg^Fet, Gll^Fp, Gll^Fp, Hh^Fp, Mm, Hh^Fp, Hh^Fp, Gll^Fp, Hh^Fp, Gg, Gll, Rp, Rp, Rp, Gll^Fp, Gg, Gll^Fp, Gll, Gd, Gll, Gd, Gd, Gd^Cov, Rb^Cov, Rb, Rb^Cov, Rb, Rb^Cov, Gd^Fetd, Gd^Fetd, Gd^Fetd, Gd, Gg, Hh^Fp, Hh^Fp, Mm, Mm, Mm, Mm, Mm, Mm, Mm, Mm
Hh^Fp, Hh^Fp, Hh^Fp, Hh^Fp, Hh^Fp, Hh^Fp, Hh^Fp, Hh^Fp, Hh^Fp, Hh^Fp, Hh^Fp, Gll^Fp, Gll^Fp, Gll, Gg^Fet, Gll^Fp, Gll, Hh^Fp, Mm, Mm, Mm, Hh^Fp, Hh^Fp, Gll, Gll^Fp, Rp, Gg^Fet, Rp, Gll^Fp, Gg^Ve, Gll^Fp, Gll^Fp, Gg^Fet, Gd, Gd, Gd^Fetd, Gd^Fetd, Gd^Fetd, Gd^Fetd, Wwb^Cov, Gd^Fetd, Gd^Cov, Gd^Fetd, Gd^Fetd, Gll, Gd, Gd, Gll, Gll^Fp, Hh^Fp, Hh^Fp, Mm, Mm, Mm, Mm, Mm, Mm
Hh^Fp, Hh^Fp, Mm, Mm, Mm, Mm, Mm, Mm, Mm, Hh^Fp, Hh^Fp, Gll, Gll^Fp, Gg, Gg^Fet, Gll^Fp, Gll^Fp, Hh^Fp, Hh^Fp, Mm, Mm, Mm, Hh^Fp, Gg, Gll^Fp, Rp, Gg^Fet, Rp, Rp, Gll^Fp, Gll, Gg^Fet, Gg, Gd, Gd, Gll^Fp, Gd, Gd^Fetd, Gd^Fetd, Gd, Gd^Fetd, Gd^Fetd, Gd^Fetd, Gd^Fetd, Gd, Gd, Gg, Gll^Fp, Gg^Fet, Hh^Fp, Hh^Fp, Hh^Fp, Hh^Fp, Mm, Hh^Fp, Mm, Hh^Fp
Mm, Mm, Mm, Mm, Mm, Mm, Mm, Mm, Mm, Mm, Mm, Hh^Fp, Hh^Fp, Gg^Ve, Gll^Fp, Gll, Gll, Gll^Fp, Hh^Fp, Mm, Mm, Mm, Hh^Fp, Gg^Ve, Gll^Fp, Rp, Rp, Rp, Gg^Fet, Rp, Rp, Gg^Fet, Gg, Gg^Fet, Gll^Fp, Gd, Gd, Gd, Gd, Gd^Fetd, Gd, Gd, Gll^Fp, Gd, Gg, Gll^Fp, Gg^Ve, Gll, Gg, Gll, Gll, Gg, Gll, Hh^Fp, Hh^Fp, Hh^Fp, Gll^Fp
Mm, Mm, Mm, Mm, Hh^Fp, Mm, Hh^Fp, Mm, Hh^Fp, Mm, Mm, Mm, Mm, Hh^Fp, Gll, Gll^Fp, Gg^Fet, Hh^Fp, Mm, Mm, Mm, Mm, Hh^Fp, Hh^Fp, Gll^Fp, Gll^Fp, Gg, Rp, Rp, Gg^Fet, Rp, Rp, Rp, Gll, Gll^Fp, Gll, Gll, Gd, Gd, Gd, Gll^Fp, Gd, Gg, Gg^Fet, Gll^Fp, Gll^Fp, Gll, Gll^Fp, Gll^Fp, Gg, Gg, Gg^Fet, Gll^Fp, Gll, Gg^Fet, Gg^Fet, Gg
Mm, Mm, Hh^Fp, Hh^Fp, Gg^Fet, Hh^Fp, Ww^Ewf, Hh^Fp, Gg^Fet, Hh^Fp, Hh^Fp, Mm, Mm, Hh^Fp, Hh^Fp, Gll, Gg^Fet, Hh^Fp, Hh^Fp, Mm, Mm, Mm, Hh^Fp, Gll, Gll^Fp, Gll^Fp, Gg, Gll, Gg, Rp, Rp, Gg^Fet, Gg^Fet, Rp, Rp, Gg, Gll^Fp, Gg^Fet, Gll^Fp, Gd, Gll, Gg^Fet, Gll^Fp, Gll^Fp, Gg, Gll, Gll^Fp, Gll, Gg, Gll^Fp, Gg, Gll^Fp, Gg, Gll^Fp, Gll, Gll^Fp, Ww^Ewl
Mm, Mm, Hh^Fp, Hh^Fp, Wwt, Wwt, Wwt, Ww^Ewf, Ww^Ewf, Hh^Fp, Hh^Fp, Mm, Mm, Mm, Hh^Fp, Hh^Fp, Gg^Fet, Gg, Gll^Fp, Hh^Fp, Hh^Fp, Hh^Fp, Gll, Gg, Gll^Fp, Gll, Gg, Gg, Gll^Fp, Gll, Gll^Fp, Rp, Rp, Rp, Rp, Gll, Gg, Gg, Gll, Gll^Fp, Gg^Ve, Gg^Fet, Gll^Fp, Gll^Fp, Gg^Fet, Gg, Gll^Fp, Gg^Fet, Gll^Fp, Gll^Fp, Gg^Ve, Gll^Fp, Gg, Gll, Wwt, Wwt, Gg
Mm, Mm, Hh^Fp, Gg^Fet, Ww^Ewf, Ww^Ewf, Ww^Ewf, Wwt, Ww^Ewf, Gg^Fet, Hh^Fp, Hh^Fp, Mm, Mm, Hh^Fp, Gll^Fp, Gll^Fp, Gg^Fet, Gg, Gll^Fp, Gg, Gg, Gg, Gll^Fp, Gll^Fp, Gg, Gg^Fet, Gg^Fet, Gll^Fp, Gg, Hh^Fp, Gll^Fp, Rp, Gg^Fet, Rp, Gg, Gg, Gll, Gg, Gg, Gg, Gll^Fp, Gg, Gg, Gg^Fet, Gll^Fp, Gg^Fet, Gll^Fp, Gll^Fp, Gg^Fet, Gll^Fp, Gll^Fp, Gg, Ww^Ewl, Gg^Fet, Gg^Fet, Gll^Fp
Mm, Mm, Hh^Fp, Hh^Fp, Ww^Ewf, Wwt, Wot, Wot, Ww^Ewf, Wwt, Hh^Fp, Mm, Mm, Mm, Hh^Fp, Gll^Fp, Gll^Fp, Gg, Gll, Gll^Fp, Gll^Fp, Gll, Gll^Fp, Gg, Gll^Fp, Gll, Gll, Gll^Fp, Gg, Hh, Hh, Hh^Fp, Rp, Rp, Rp, Gll^Fp, Wwt, Wwt, Ww^Ewl, Ww^Ewl, Wwt, Gg, Ww^Ewl, Gg^Fet, Gll, Gll^Fp, Gll, Gll^Fp, Gll, Gll^Fp, Gll, Gll, Ww^Ewl, Wwt, Gll^Fp, Gg, Gll
Mm, Mm, Hh^Fp, Gg^Fet, Wwt, Wwt, Ww^Ewf, Wwt, Ww^Ewf, Wwt, Gg^Fet, Hh^Fp, Hh^Fp, Hh^Fp, Gll, Gll, Gll^Fp, Gg^Fet, Gg, Gll, Gg, Gg^Fet, Gll, Gg^Fet, Gll^Fp, Gg, Gll, Gll^Fp, Gll^Fp, Hh^Fp, Hh^Fp, Hh^Fp, Rp, Gg^Fet, Rp, Ww^Ewl, Gg^Fet, Gg^Fet, Gg, Gll^Fp, Gll^Fp, Wwt, Gg, Ww^Ewl, Wwt, Gg, Gg, Gll^Fp, Gg, Gg, Wwt, Ww^Ewl, Gll, Gll, Gll^Fp, Gll, Gg
Mm, Mm, Mm, Hh^Fp, Gg^Fet, Ww^Ewf, Wwt, Wwt, Gg^Fet, Wwt, Wwt, Gll^Fp, Gll^Fp, Gll^Fp, Gg, Gg^Ve, Gll^Fp, Gll, Gll^Fp, Gg, Gll^Fp, Gll, Gll^Fp, Gll, Gll^Fp, Gg, Gg, Gg, Gll^Fp, Gll^Fp, Gg, Gll^Fp, Rp, Rp, Wwt^Bsb|, Wwt, Gg, Gg, Hh, Hh^Fp, Hh^Fp, Hh, Hh, Gg, Gg^Fet, Ww^Ewl, Wwt, Wwt, Ww^Ewl, Wwt, Gll, Gg, Gll^Fp, Gg, Gg^Fet, Gll^Fp, Gg
Mm, Mm, Mm, Hh^Fp, Hh^Fp, Hh^Fp, Hh^Fp, Gg^Fet, Hh^Fp, Gll^Fp, Gll^Fp, Wwt, Gll^Fp, Gg^Fet, Gll^Fp, Gll^Fp, Gll, Gll, Gg^Fet, Gg^Fet, Gg^Fet, Gg^Fet, Gg, Gll^Fp, Gg, Gll, Wwt, Gg, Wwt, Gg, Wwt, Gll^Fp, Wwt^Bsb|, Wwt^Bsb|, Rp, Gll^Fp, Gg, Gll^Fp, Hh^Fp, Hh, Hh, Hh^Fp, Hh, Gg^Fet, Gg, Gll^Fp, Gll^Fp, Gg^Ve, Gg, Gll, Gg^Fet, Gll^Fp, Hh^Fp, Gll, Hh, Gll^Fp, Gll^Fp
Mm, Mm, Mm, Mm, Mm, Mm, Mm, Hh^Fp, Mm, Hh^Fp, Gll^Fp, Wwt, Gg, Gll, Gg^Fet, Gg^Fet, Gll, Gg, Wwt, Gll, Gg, Gll, Gg, Gll, Ww^Ewl, Ww^Ewl, Gg, Wwt, Gg, Ww^Ewl, Gg, Wwt, Rp, Rp, Rp, Gll^Fp, Gll^Fp, Gll^Fp, Gll^Fp, Hh^Fp, Gg, Hh^Fp, Hh^Fp, Gll^Fp, Gg, Gg, Gll^Fp, Gg, Gg^Fet, Gg, Hh^Fp, Hh, Hh^Fp, Hh^Fp, Hh, Hh, Gg
Hh^Fp, Mm, Mm, Mm, Mm, Mm, Mm, Mm, Mm, Hh^Fp, Hh^Fp, Ww^Ewl, Wwt, Gll, Wwt, Ww^Ewl, Wwt, Ww^Ewl, Gll, Ww^Ewl, Wwt, Wwt, Wwt, Wwt, Gll^Fp, Gll^Fp, Gll^Fp, Gg, Gll^Fp, Gg, Gll^Fp, Gll^Fp, Rp, Rp, Rp, Gll^Fp, Gg^Fet, Gll^Fp, Gll^Fp, Gll^Fp, Gll, Gll^Fp, Gll^Fp, Gll^Fp, Gll^Fp, Gg^Fet, Gll^Fp, Gll, Gll^Fp, Gll^Fp, Hh^Fp, Hh, Hh, Hh^Fp, Hh^Fp, Hh^Fp, Gg
Hh^Fp, Hh^Fp, Hh^Fp, Mm, Mm, Mm, Mm, Mm, Hh^Fp, Hh^Fp, Gll^Fp, Gll^Fp, Gg, Wwt, Gll, Gg, Gll^Fp, Gg, Gll^Fp, Gll^Fp, Gg^Fet, Gg^Ve, Gg^Fet, Gg, Gll^Fp, Gg, Gll^Fp, Gll^Fp, Gll^Fp, Gll^Fp, Gg^Fet, Gg^Fet, Cv, Cv, Cv, Gg^Fet, Gg^Fet, Gll^Fp, Gll^Fp, Gg, Gll^Fp, Gg, Gg^Fet, Gg^Fet, Gll^Fp, Gll^Fp, Gg, Gll, Gg^Fet, Gll^Fp, Gll, Hh^Fp, Hh^Fp, Hh, Hh, Hh^Fp, Gg
Gll^Fp, Hh^Fp, Hh^Fp, Hh^Fp, Hh^Fp, Mm, Hh^Fp, Hh^Fp, Gg^Fet, Gll^Fp, Gg^Ve, Gll, Gg^Fet, Gll, Gll^Fp, Gg, Gg^Fet, Gll^Fp, Gll^Fp, Gg^Fet, Gll^Fp, Gll, Gll^Fp, Gll^Fp, Gll, Gg^Fet, Gg^Fet, Gg, Gg, Gg, Gg^Fet, Cv, Rp, Rp, Rp, Cv, Gg^Fet, Gll^Fp, Gll^Fp, Gll^Fp, Gg^Ve, Gg^Fet, Gll, Gll, Gg^Fet, Gll, Gg, Gll^Fp, Gg, Gg^Fet, Gg, Gll, Hh^Fp, Hh^Fp, Hh, Hh^Fp, Gg
Gll^Fp, Gll^Fp, Gll^Fp, Gll^Fp, Gll^Fp, Hh^Fp, Gll^Fp, Gll^Fp, Gll^Fp, Gll^Fp, Hh^Fp, Gll^Fp, Gll^Fp, Gll^Fp, Gg^Fet, Gll^Fp, Gll, Gll^Fp, Gll^Fp, Gll, Gll, Gg, Cv, Gg, Gg, Gg, Gll^Fp, Gg, Gg, Gll^Fp, Gg^Fet, Cv, Rp, Rp, Rp, Cv, Gg^Fet, Gll^Fp, Gll^Fp, Gll^Fp, Gll^Fp, Gg, Gll^Fp, Gll^Fp, Gg, Gg, Cv, Gll, Gll, Gg, Gll^Fp, Gll^Fp, Gg, Gll, Gll^Fp, Gll^Fp, Gll^Fp
Gg^Fet, Gll, Gll^Fp, Gll^Fp, Hh^Fp, Hh^Fp, Hh^Fp, Hh^Fp, Hh^Fp, Hh^Fp, Mm, Hh, Hh, Gll^Fp, Gll^Fp, Gg^Fet, Gll, Gg^Ve, Gll^Fp, Gll^Fp, Gg, Cv, Gg^Fet, Cv, Gg, Gg, Gll^Fp, Gg, Gll^Fp, Gll^Fp, Gg, Gg, Rp, Rp, Rp, Gg, Gg, Gll^Fp, Gll^Fp, Gg^Fet, Gg^Fet, Gll^Fp, Gll^Fp, Gg^Fet, Gg, Cv, Gg^Fet, Cv, Gg, Gg^Fet, Gll^Fp, Gll^Fp, Gll^Fp, Gg^Ve, Gg^Fet, Gll^Fp, Gg
Gg, Gg^Ve, Gll^Fp, Hh^Fp, Mm, Mm, Mm, Mm, Mm, Mm, Mm, Mm, Mm, Hh^Fp, Hh^Fp, Gg^Fet, Gg^Fet, Gll^Fp, Gll, Gg^Fet, Gg, Cv, Gg, Cv, Gll^Fp, Gg, Gg^Fet, Gll^Fp, Gg^Fet, Gg, Gg, Gll^Fp, Gll^Fp, Rp, Rp, Rp, Gll^Fp, Gll^Fp, Gg^Fet, Gll^Fp, Gll^Fp, Gll^Fp, Gg, Gll^Fp, Gg, Cv, Gg, Cv, Gg, Gll, Gll^Fp, Gll^Fp, Gll^Fp, Gll^Fp, Gll^Fp, Gg^Fet, Hh^Fp
Gg^Fet, Gll, Gll^Fp, Hh^Fp, Mm, Mm, Mm, Mm, Hh, Mm, Mm, Mm, Mm, Mm, Hh^Fp, Gll^Fp, Gg, Gll, Gll^Fp, Gg^Fet, Gg, Gg, Gg, Gll^Fp, Gg, Gll^Fp, Gg, Gg^Fet, Gg, Gg, Gg, Gg, Gg^Fet, Rp, Rp, Rp, Gg^Fet, Gg, Gll, Gll, Gg, Gg^Fet, Gll^Fp, Gg^Fet, Gll, Gll, Gg, Gll, Gg^Fet, Gll^Fp, Gll^Fp, Gg^Fet, Gll, Gll, Hh^Fp, Hh^Fp, Mm
Gg, Gll^Fp, Gg, Hh, Hh, Hh^Fp, Hh^Fp, Hh, Gg, Hh, Hh^Fp, Mm, Mm, Mm, Mm, Hh, Gg, Gll^Fp, Gg, Gg^Fet, Gll^Fp, Gg^Fet, Gll^Fp, Gg, Gll^Fp, Gll^Fp, Gg, Gg, Wwt, Ww^Ewl, Wwt, Wwt, Wwt, Rp, Wwt^Bsb|, Rp, Wwt, Wwt, Ww^Ewl, Wwt, Ww^Ewl, Gll, Gll, Gll^Fp, Gll^Fp, Gll^Fp, Gg^Ve, Gll^Fp, Gll^Fp, Gll, Hh^Fp, Hh^Fp, Hh^Fp, Hh^Fp, Mm, Mm, Mm
Gg, Gll, Gll^Fp, Gll, Gg, Hh^Fp, Gll^Fp, Gll^Fp, Gll, Gll^Fp, Gll, Hh^Fp, Mm, Mm, Mm, Hh, Gg, Gll^Fp, Gg, Gg, Gg, Gg, Gg^Fet, Gg^Fet, Gg, Gg, Ww^Ewl, Wwt, Cv, Kv, Cv, Cv, Kv, Wwt^Bsb|, Rp, Wwt^Bsb|, Kv, Cv, Cv, Kv, Cv, Ww^Ewl, Wwt, Gg, Gll, Gg, Gg^Fet, Gg^Fet, Gll^Fp, Hh^Fp, Mm, Mm, Mm, Mm, Mm, Mm, Mm
Gg^Fet, Gg, Gll^Fp, Gll^Fp, Gll^Fp, Gg^Ve, Gll^Fp, Gll^Fp, Gg, Gll^Fp, Gll^Fp, Hh^Fp, Hh^Fp, Mm, Mm, Hh^Fp, Gll^Fp, Gg^Fet, Gll^Fp, Gg, Gg^Fet, Gg^Fet, Gg, Gg, Ww^Ewl, Wwt, Cv, Cv, Gg, Gg^Efm, Gg^Efm, Gg, Gg^Efm, Rp, Rp, Rp, Gg^Fet, Gg, Gg^Fet, Gg^Efm, Gg^Fet, Cv, Cv, Wwt, Wwt, Gg, Gll, Gg^Fet, Gll^Fp, Hh^Fp, Mm, Mm, Mm, Mm, Mm, Mm, Mm
Gg, Gll^Fp, Gll^Fp, Gg, Gg^Fet, Gll^Fp, Gg^Fet, Gg, Gg^Fet, Gll^Fp, Gll, Hh, Hh^Fp, Mm, Mm, Hh, Gll^Fp, Gll^Fp, Gg, Gg, Gll^Fp, Gll^Fp, Gg, Gg, Ww^Ewl, Kv, Gg, Gg, Gg^Fet, Gg^Efm, Gg, Gg^Fet, Gg^Ve, Rp, Gg^Fet, Rp, Gg^Fet, Gg^Efm, Gg^Efm, Gg, Gg^Fet, Gg^Fet, Gg^Efm, Kv, Ww^Ewl, Gg, Gg, Gll, Gg^Fet, Hh^Fp, Hh^Fp, Mm, Hh^Fp, Mm, Hh^Fp, Mm, Mm
Gll, Gll, Gg, Gll^Fp, Gg, Gll^Fp, Gll^Fp, Gll^Fp, Gll^Fp, Gg^Fet, Gll^Fp, Gg, Gll^Fp, Hh^Fp, Hh, Hh, Gg, Gll^Fp, Gg, Gg^Fet, Gll^Fp, Gg^Fet, Gg, Wwt, Kv, Cv, Gg^Efm, Gg^Fet, Cv, Kv, Cv, Gg^Fet, Gg^Fet, Rp, Rp, Rp, Gg^Ve, Gg, Cv, 5 Kv, Cv, Gg^Fet, Gg^Efm, Cv, Kv, Wwt, Gg, Gll, Gll^Fp, Gg, Gll^Fp, Hh^Fp, Gg, Hh^Fp, Gll, Hh^Fp, Mm
Wwt, Gll, Gll, Gll, Gg, Gll, Gll, Gll, Gg, Gll, Gll, Gll^Fp, Gll^Fp, Gg, Gll^Fp, Gg, Gg, Gll^Fp, Gg^Ve, Gll^Fp, Gg, Gll^Fp, Gll^Fp, Wwt, Cv, Gg^Efm, Gg^Fet, Cv, Gg, Cv, Gg, Gg^Fet, Gg^Efm, Rp, Gg^Fet, Rp, Gg^Efm, Gg^Fet, Gg, Cv, Gg^Efm, Cv, Gg, Gg^Fet, Cv, Wwt, Gg^Fet, Gll, Gg^Ve, Gg, Gg^Fet, Gll^Fp, Gg^Fet, Gll, Gll^Fp, Hh^Fp, Hh^Fp
Wwt, Ww^Ewl, Ww^Ewl, Wwt, Wwt, Wwt, Wwt, Gg^Ve, Wwt, Wwt, Ww^Ewl, Gg^Fet, Gg, Gll^Fp, Gg^Fet, Gg, Gll^Fp, Gg^Fet, Gll^Fp, Gll^Fp, Gll^Fp, Gg, Wwt, Ww^Ewl, Cv, Gg^Fet, Gg^Fet, Cv, Cv, Gg^Efm, Gg^Fet, Gg^Fet, Gg^Efm, Rp, Rp, Rp, Gg, Gg^Efm, Gg^Fet, Gg^Efm, Cv, Cv, Gg^Fet, Gg^Fet, Cv, Wwt, Ww^Ewl, Gg, Gll^Fp, Gg^Fet, Gll^Fp, Gg, Gll, Gg^Fet, Gll^Fp, Gll^Fp, Gg
Gg, Wwt, Wwt, Wwt, Wwt, Wwt, Wwt, Wwt, Wwt, Wwt, Ww^Ewl, Wwt, Gll, Gll^Fp, Gg, Gll^Fp, Gll^Fp, Gg, Gll^Fp, Gg, Gll^Fp, Gg, Wwt, Kv, Gg, Gg, Gg^Fet, Gg, Gg^Fet, Gg^Efm, Gg^Ve, Gg, Kv, Kv, Kv, Kv, Kv, Gg^Efm, Gg, Gg^Fet, Gg, Gg, Gg^Efm, Gg^Efm, Gg, Kv, Ww^Ewl, Gll^Fp, Gg, Gll, Gll^Fp, Gll^Fp, Gll^Fp, Gg^Ve, Gg^Fet, Gll^Fp, Gg^Fet
Gg^Fet, Gll, Gll, Gg, Gg^Fet, Gg, Gll, Ww^Ewl, Gll, Gg^Fet, Wwt, Ww^Ewl, Wwt, Gll^Fp, Gll^Fp, Gg, Gg^Fet, Gg^Fet, Gg, Gll^Fp, Rp, Ww^Ewl, Kv, Cv, Gg^Efm, Gg^Fet, Gg^Ve, Gg^Fet, Gg^Efm, Gg, Gg, Gg, Kv, Gg^Fet, Cv, Gg^Fet, Kv, Gg, Gg^Fet, Gg^Fet, Gg^Ve, Gg^Fet, Gg^Fet, Gg^Ve, Gg^Fet, Cv, Kv, Wwt, Rp, Gll, Gll^Fp, Gg, Gll^Fp, Gll^Fp, Gll^Fp, Gg^Fet, Gll
Gg^Fet, Gll^Fp, Gg^Ve, Gll^Fp, Gll, Gg^Fet, Gg^Fet, Gll^Fp, Gll^Fp, Gg, Gll^Fp, Ww^Ewl, Wwt, Wwt, Rp, Rp, Rp, Rp, Rp, Rp, Gg^Fet, Wwt^Bsb\, Rp, Rp, Rp, Rp, Rp, Rp, Rp, Rp, Rp, Kv, Gg^Fet, Cv, 3 Kv, Cv, Gg^Fet, Kv, Rp, Gg^Efm, Rp, Gg^Efm, Rp, Gg^Fet, Rp, Gg^Efm, Rp, Wwt^Bsb/, Gg^Fet, Rp, Rp, Rp, Rp, Rp, Rp, Rp, Rp
Gg, Gg, Gll^Fp, Gll^Fp, Gll, Gll^Fp, Gg, Gg^Ve, Gll^Fp, Gg^Fet, Gll^Fp, Gll, Ww^Ewl, Wwt, Rp, Rp, Rp, Rp, Rp, Rp, Gg^Fet, Wwt, Rp, Rp, Rp, Rp, Rp, Rp, Rp, Rp, Rp, Kv, Kv, Cv, Cv, Cv, Kv, Kv, Rp, Rp, Rp, Rp, Rp, Rp, Rp, Rp, Rp, Ww^Ewl, Gg^Fet, Rp, Rp, Rp, Rp, Rp, Rp, Rp, Rp
Gll^Fp, Gg^Fet, Gg^Fet, Gg, Cv, Cv, Cv, Gll^Fp, Gll, Gg, Rp, Rp, Wwt, Wwt, Wwt, Gg^Fet, Hh, Gg, Gg^Fet, Rp, Rp, Wwt^Bsb/, Kv, Gg^Efm, Gg^Fet, Gg^Efm, Gg^Ve, Gg, Gg^Fet, Gg^Efm, Gg^Efm, Gg, Kv, Gg^Fet, Kv, Gg^Fet, Kv, Gg, Gg, Rp, Gg^Efm, Rp, Gg, Rp, Gg^Efm, Rp, Kv, Wwt^Bsb\, Rp, Rp, Gg, Gll^Fp, Gll^Fp, Gll^Fp, Gll, Gll^Fp, Gg
Gll^Fp, Gll, Gg^Fet, Gg, Cv, Kv, Cv, Gll, Rp, Rp, Rp, Rp, Gg^Ve, Wwt, Ww^Ewl, Hh^Fp, Hh^Fp, Hh, Gll^Fp, Gll^Fp, Gg^Fet, Wwt, Wwt, Cv, Gg, Gg^Fet, Gg^Fet, Gg^Efm, Gg^Efm, Gg^Ve, Gg^Fet, Gg, Gg^Efm, Kv, Rp, Kv, Gg, Gg^Fet, Gg, Gg^Ve, Gg^Efm, Gg^Fet, Gg^Ve, Gg^Efm, Gg^Fet, Cv, Ww^Ewl, Wwt, Gll, Gll^Fp, Gg^Fet, Gll, Gll^Fp, Gg^Fet, Gll^Fp, Gg^Fet, Gg^Fet
Rp, Gg, Gll^Fp, Gg, Kv, Cv, Gg^Fet, Cv, Kv, Rp, Gg, Gg^Fet, Gg, Wwt, Wwt, Hh, Hh, Hh^Fp, Ww^Ewl, Wwt, Wwt, Gg^Fet, Wwt, Kv, Cv, Gg^Efm, Gg, Gg, Gg^Fet, Gg, Gg^Fet, Gg^Efm, Gg^Efm, Rp, Gg^Fet, Rp, Gg^Efm, Gg, Gg^Fet, Gg^Fet, Gg^Fet, Gg^Efm, Gg^Fet, Gg^Fet, Cv, Kv, Ww^Ewl, Gg, Gll, Gll^Fp, Gll^Fp, Gll, Gg, Gll^Fp, Gg^Ve, Gll^Fp, Gg^Fet
Rp, Rp, Rp, Gll, Rp, Cv, Cv, Cv, Cv, Gg, Gg^Fet, Gll^Fp, Gll^Fp, Wwt, Wwt, Hh^Fp, Hh, Wwt, Wwt, Wwt, Ww^Ewl, Wwt, Ww^Ewl, Wwt, Cv, Gg^Efm, Gg^Fet, Cv, Gg, Gg^Fet, Gg, Cv, Gg^Fet, Rp, Rp, Rp, Gg^Efm, Cv, Gg^Efm, Gg^Fet, Gg^Efm, Cv, Gg^Efm, Gg^Efm, Cv, Wwt, Gll, Gg, Gll^Fp, Gg, Gg^Fet, Gg, Gll^Fp, Gg^Fet, Gll^Fp, Gg^Fet, Gg^Fet
Gll^Fp, Rp, Rp, Rp, Rp, Rp, Cv, Kv, Cv, Gg, Gg^Fet, Gg, Gll^Fp, Ww^Ewl, Wwt, Hh, Hh^Fp, Wwt, Ww^Ewl, Gll^Fp, Gll^Fp, Wwt, Gg^Ve, Ww^Ewl, Kv, Gg, Gg^Fet, Cv, Cv, Cv, Cv, Cv, Gg^Fet, Rp, Gg^Fet, Rp, Gg^Fet, Cv, Cv, Cv, Cv, Cv, Gg^Fet, Gg, Kv, Wwt, Gll^Fp, Gll^Fp, Gg, Gll, Gll, Gll^Fp, Gll^Fp, Gg, Gll^Fp, Gg^Fet, Gg
Gg, Gll, Gll^Fp, Rp, Gll^Fp, Gg, Gg, Cv, Gg, Gll^Fp, Gll, Gll, Hh^Fp, Wwt, Wwt, Wwt, Wwt, Ww^Ewl, Wwt, Gg^Fet, Gg^Fet, Gll, Gll^Fp, Wwt, Wwt, Cv, Gg, Gg^Fet, Gg^Fet, 4 Kv, Gg, Gg, Gg^Efm, Rp, Rp, Rp, Gg^Ve, Gg^Fet, Gg^Efm, Kv, Gg^Fet, Gg^Fet, Gg^Efm, Cv, Ww^Ewl, Ww^Ewl, Gll^Fp, Gg^Fet, Gll^Fp, Gll^Fp, Gll^Fp, Gg^Fet, Gg^Fet, Gll^Fp, Gll, Gll, Hh
Hh, Gg^Fet, Gg, Gll, Gll^Fp, Gg, Gll^Fp, Gg, Gll^Fp, Gll^Fp, Gg, Hh^Fp, Hh^Fp, Gll^Fp, Gg^Fet, Ww^Ewl, Wwt, Wwt, Gll, Gg, Gg, Gll^Fp, Gll, Gg^Fet, Ww^Ewl, Kv, Cv, Gg^Efm, Gg^Efm, Gg^Efm, Gg^Fet, Gg^Fet, Gg^Efm, Rp, Gg^Fet, Rp, Gg^Efm, Gg^Efm, Gg^Fet, Gg^Fet, Gg^Fet, Gg^Efm, Cv, Kv, Wwt, Gll^Fp, Gg, Gll^Fp, Gg^Fet, Gg^Ve, Gll^Fp, Gg, Gll, Gll^Fp, Gg, Hh, Mm
Hh^Fp, Hh, Hh^Fp, Gg^Ve, Gll^Fp, Gg, Gg^Fet, Gg, Gll^Fp, Gll^Fp, Gll, Hh, Hh, Gll^Fp, Hh, Gll^Fp, Hh, Hh, Gll^Fp, Gll^Fp, Hh, Gll, Hh^Fp, Gll^Fp, Gll, Wwt, Wwt, Cv, Cv, Gg, Cv, Gg, Kv, Rp, Rp, Rp, Kv, Gg^Fet, Cv, Gg^Efm, Cv, Cv, Ww^Ewl, Wwt, Gll^Fp, Gg, Gll^Fp, Gll^Fp, Gll^Fp, Gll^Fp, Gg^Fet, Gll^Fp, Gll, Gll^Fp, Hh^Fp, Hh^Fp, Mm
Mm, Hh^Fp, Hh, Gll, Gll^Fp, Gll^Fp, Gll, Gg^Fet, Gg^Fet, Gll^Fp, Gll^Fp, Hh^Fp, Hh, Hh^Fp, Hh, Hh^Fp, Hh, Gll^Fp, Gg, Gll^Fp, Hh^Fp, Hh, Hh^Fp, Gll^Fp, Gll, Gg, Gll, Ww^Ewl, Wwt, Kv, Ww^Ewl, Cv, Wwt, Wwt^Bsb|, Wwt^Bsb|, Wwt^Bsb|, Wwt, Cv, Ww^Ewl, Kv, Wwt, Ww^Ewl, Gll, Gll, Gg^Fet, Gll, Gg, Gg, Gll^Fp, Gll^Fp, Gll, Gg, Hh^Fp, Hh^Fp, Hh^Fp, Mm, Mm
Mm, Mm, Hh^Fp, Hh, 1 Gg, Gg, Gll, Gg^Ve, Gll^Fp, Gg, Gll^Fp, Gg, Gg, Hh^Fp, Gll, Hh^Fp, Gll^Fp, Gg, Hh, Hh^Fp, Mm, Mm, Mm, Hh, Gg, Gg^Ve, Gll^Fp, Gll^Fp, Gll^Fp, Wwt, Gll, Ww^Ewl, Gg, Rp, Rp, Rp, Gg, Wwt, Gg, Wwt, Gll, Gg, Gg^Fet, Gll^Fp, Gg^Ve, Gll^Fp, Gg^Fet, Gg^Fet, Gg^Ve, Gll, Hh, Hh^Fp, Hh, Hh, Mm, Mm, Mm
Mm, Mm, Mm, Hh^Fp, Hh, Gll^Fp, Hh, Gll, Gg, Gg^Fet, Gll^Fp, Gll, Gll^Fp, Gll, Gll^Fp, Gll^Fp, Gll, Gg^Fet, Hh, Hh^Fp, Mm, Mm, Mm, Hh, Hh^Fp, Gll^Fp, Gll^Fp, Gg^Fet, Gll^Fp, Gg, Gll^Fp, Gll, Gll^Fp, Rp, Gg^Fet, Rp, Gll^Fp, Gll, Gll, Gg, Gll^Fp, Gll, Gll^Fp, Gll^Fp, Gg, Gll, Gg^Fet, Gll^Fp, Gll^Fp, Gg, Hh, Hh^Fp, Mm, Hh^Fp, Mm, Mm, Mm
Mm, Mm, Mm, Hh^Fp, Hh^Fp, Hh^Fp, Hh^Fp, Hh, Gll, Gll^Fp, Gg, Gll, Gg, Gg^Fet, Gg^Fet, Gll, Gg, Hh, Hh^Fp, Mm, Mm, Mm, Mm, Mm, Hh, Gll^Fp, Gg^Fet, Gll^Fp, Gll^Fp, Gg^Ve, Gg^Fet, Gll^Fp, Gll^Fp, Rp, Gg^Fet, Rp, Gll^Fp, Gll^Fp, Gll^Fp, Gll^Fp, Gg, Gll^Fp, Gll^Fp, Gll^Fp, Gg^Fet, Gll^Fp, Gg, Gll, Hh^Fp, Hh^Fp, Mm, Mm, Mm, Mm, Mm, Mm, Mm
Mm, Mm, Mm, Mm, Mm, Mm, Mm, Hh^Fp, Gg, Gll, Gll^Fp, Gg^Fet, Gg, Gll^Fp, Gll^Fp, Gll, Gg, Hh^Fp, Mm, Mm, Mm, Mm, Mm, Mm, Mm, Hh^Fp, Gg, Gg^Fet, Gg^Fet, Gll, Gg, Gg^Fet, Gg, Rp, Rp, Rp, Gg, Gg^Ve, Gll^Fp, Gg^Fet, Gg^Fet, Gll^Fp, Gll^Fp, Gll^Fp, Gg^Fet, Gll^Fp, Gg, Hh^Fp, Hh^Fp, Mm, Mm, Mm, Mm, Mm, Mm, Mm, Mm
