Mm, Mm, Mm, Mm, Mm, Mm, Mm, Mm, Hh^Fp, Hh, Hh, Hh, Ha^Fpa, Hh, Hh, Ha^Fpa, Ms^Xm, Ms^Xm, Ms^Xm, Hh, Mm, Mm, Ms^Xm, Ms^Xm, Ms^Xm, Hh^Fp, Mm, Hh, Hh, Mm, Mm, Mm, Mm, Mm, Mm, Mm, Ms, Mm, Mm, Mm, Ms^Xm, Mm, Ms^Xm, Mm, Mm, Mm, Ms^Xm
Ms^Xm, Mm, Mm, Mm, Mm, Mm, Hh, Ha^Fpa, Hh, Hh^Fp, Ha^Fpa, Ha^Fpa, Hh, Ha^Fpa, Hh^Fp, Ha^Fpa, Ms, Ms^Xm, Ms, Hh, Mm, Ms^Xm, Ms^Xm, Ms, Mm, Hh^Fp, Mm, Hh, Hh^Fp, Mm, Mm, Mm, Mm, Mm, Ms, Ms, Mm, Ms, Ms, Mm, Ms, Mm, Ms, Ms^Xm, Ms^Xm, Ms^Xm, Mm
Mm, Mm, Mm, Mm, Mm, Mm, Ha^Fpa, Ha^Fpa, Hh^Fp, Hh, Hh^Fp, Hh^Fp, Hh^Fp, Hh^Fp, Hh, Hh, Mm, Hh^Fp, Mm, Hh^Fp, Mm, Mm, Xu, Ms, Ms, Hh, Hh, Hh^Fp, Gll^Fp, Hh, Hh^Fp, Mm, Mm, Ha^Fpa, Ha^Fpa, Hh^Fp, Ha^Fpa, Ms, Mm, Mm, Mm, Ms, Ms, Ms^Xm, Ms, Mm, Ms
Mm, Mm, Ms^Xm, Mm, Mm, Mm, Mm, Hh^Fp, Hh, Hh^Fp, Hh, Ha^Fpa, Ms, Mm, Hh, Hh^Fp, Hh^Fp, Hh, Hh^Fp, Hh, Xu, Xu, Uu, Xu, Xu, Mm, Hh^Fp, Mm, Gll^Fp, Gll^Fp, Hh^Fp, Mm, Mm, Ms, Ms, Ha^Fpa, Hh, Ms, Mm, Mm, Mm, Mm, Mm, Mm, Mm, Ms, Mm
Mm, Mm, Ms^Xm, Ms^Xm, Mm, Mm, Mm, Mm, Mm, Mm, Mm, Ms, Ms, Mm, Mm, Hh, Hh, Hh^Fp, Mm, Hh, Xu, Uu, Uu, Uu, Xu, Mm, Mm, Mm, Cud, Gll^Fp, Gll^Fp, Hh^Fp, Hh^Fp, Mm, Hh, Mm, Hh^Fp, Mm, Mm, Mm, Ms, Mm, Mm, Mm, Hh, Mm, Mm
Ms^Xm, Mm, Ms^Xm, Mm, Mm, Ms^Xm, Mm, Mm, Mm, Mm, Hh, Ms, Ms, Ms, Mm, Mm, Mm, Mm, Mm, Mm, Hh^Fp, Gg, Rr, Gg, Hh^Fp, Mm, Mm, Hh^Fp, Gll, Cud, Gll, Gll^Fp, Hh, Hh, Mm, Ms, Ha^Fpa, Mm, Ms, Ms, Mm, Mm, Mm, Hh^Fp, Hh, Mm, Mm
Mm, Mm, Mm, Mm, Ms^Xm, Mm, Mm, Mm, Mm, Mm, Hh^Fp, Ha, Ha, Mm, Hh^Fp, Mm, Hh, Hh, Mm, Mm, Mm, Rr^Vhc, Rr, Rr^Vhc, Mm, Mm, Hh^Fp, Hh^Fp, Gll, Cud, Gll^Fp, Gll^Fp, Gll^Es, Hh^Fp, Ha^Fpa, Hh^Fp, Hh, Ms, Mm, Mm, Mm, Mm, Hh^Fp, Hh, Hh, Mm, Mm
Ms^Xm, Mm, Ms^Xm, Mm, Mm, Mm, Mm, Mm, Ha, Hh, Ha, Hh, Hh^Fp, Hh^Fp, Cud, Cud, Hh, Hh, Hh^Vhh, Hh, Mm, Hh, Rr, Hh, Mm, Mm, Hh^Fp, Gll, Cud, Cud, Gll, Gll^Fp, Gll^Es, Ha^Vhha, Aa^Fma, Hh, Aa^Fma, Ha, Hh^Fp, Ha^Fpa, Ha^Fpa, Ha, Hh, Hh, Ms, Mm, Mm
Ms, Mm, Mm, Mm, Mm, Mm, Ha^Fpa, Ha^Fpa, Ms, Mm, Mm, Ha, Hh^Fp, Hh, Cud, Hh, Mm, Mm, Hh, Hh, Mm, Cud, Rr, Cud, Mm, Hh^Fp, Gll, Cud, Kud, Cud, Gll^Fp, Gs, Gll^Fp, Gs, Aa, Gll^Fp, Gll^Fp, Gll^Fp, Gll^Fp, Hh, Aa^Fma, Hh, Ha, Ms, Ms, Ms, Ms
Mm, Mm, Mm, Mm, Mm, Hh, Hh^Fp, Hh, Mm, Mm, Mm, Mm, Hh, Hh, Cud, Mm, 4 Kud, Mm, Mm, Hh, Gg, Hh, Rr, Hh, Hh, Hh, Gg, Cud, Cud, Cud, Wwg, Cud, Cud, Gg, Gg^Es, Gll^Es, Wwg, Wwg, Wwg, Gll^Fp, Wwg, Gll^Fp, Ha, Ms, Ms, Ms, Mm
Mm, Mm, Mm, Ms, Ms, Mm, Mm, Mm, Mm, Mm, Mm, Mm, Mm, Hh^Fp, Gll, Cud, Mm, Hh, Hh, Hh, Rr^Vhc, Gg, Rr, Hh, Cud, Cud, Cud, Ds, Wwg, Wwg, Gll^Fp, Wwg, Cud, Wwg, Wwg, Wwg, Gll^Fp, Wwg, Wog, Wwg, Wwg, Aa^Fma, Hh, Ha^Fpa, Ms, Ms, Ms
Mm, Mm, Mm, Ha, Hh^Fp, Mm, Hh, Mm, Ha, Ha, Hh, Mm, Gll, Gll^Fp, Gll, Hh, Mm, Hh^Vhh, Wwg, Wwg, Wwg, Gg, Rr, Gg, Cud, 3 Kud, Cud, Cud, Cud, Cud, Gll^Fp, Cud, Gs, Gg, Gll^Fp, Gll^Fp, Gll^Fp, Wwg, Wog, Wog, Wwg, Gll^Fp, Aa^Fma, Hh^Fp, Ha^Fpa, Ms, Ms
Mm, Mm, Hh, Ha, Ha^Fpa, Hh, Ha^Fpa, Hh, Ha^Fpa, Ha^Fpa, Aa^Vla, Gll^Fp, Hh, Hh, Hh^Fp, Hh^Fp, Mm, Mm, Mm, Wo, Wo, Wwg, Rr, Rr, Rr, Cud, Wwg, Wwg, Cud, Cud, Gg^Es, Gg^Es, Gs, Gg^Es, Gll, Gll^Fp, Gll^Fp, Wwg, Wwg, Wwg, Gll^Fp, Aa^Fma, Hh^Fp, Hh^Fp, Ha^Fpa, Ha^Fpa, Ha^Fpa
Hh^Fp, Ha, Ha^Fpa, Hh^Fp, Hh, Ha^Fpa, Hh, Hh^Fp, Hh, Hh^Fp, Hh^Fp, Gll^Fp, Hh, Hh, Hh, Hh^Fp, Hh^Fp, Mm, Mm, Wo, Wo, Wwg, Wwg, Wwg^Bsb|, Wwg^Bsb|, Cud, Cud, Cud, Gg, Gg^Es, Gs, Gs, Gll^Fp, Gg, Gll^Fp, Gll^Fp, Gll^Fp, Gll^Fp, Aa^Fma, Aa^Vla, Ha^Fpa, Hh, Mm, Ms, Ms, Hh, Hh
Hh, Ha, Ms, Ha, Mm, Mm, Hh, Mm, Mm, Mm, Hh^Fp, Gll, Gll^Fp, Hh, Gll^Fp, Gll^Fp, Hh, Hh^Fp, Mm, Mm, Wwg, Wwg, Cud, Wwg^Bsb|, Wwg^Bsb|, Wwg, Cud, Cud, Gs, Gg, Gll^Fp, Gll^Fp, Gll^Es, Gg, Gs, Gll^Fp, Gll, Gll^Fp, Aa^Fma, Ha^Fpa, Ms, Mm, Mm, Mm, Mm, Mm, Hh
Ms, Ms, Ms, Ms, Mm, Mm, Hh^Fp, Mm, Hh, Hh, Gll, Gll^Fp, Gll^Fp, Gll^Fp, Gll^Fp, Gll, Gll, Hh^Fp, Hh, Mm, Hh, Hh, Cud, Rr, Rr, Gg, Cud, Hh, Hh, Gs^Es, Gll^Fp, Gll, Gll^Es, Gll^Es, Gll^Fp, Gs, Gg^Es, Gll, Aa, Ha, Mm, Mm, Ms, Ms, Ms, Mm, Hh
Mm, Mm, Mm, Ms, Ms, Mm, Hh, Hh, Hh^Fp, Hh, Hh^Fp, Gll^Fp, Gll^Fp, Gll^Fp, Gll^Fp, Gll, Gll^Fp, Hh, Hh^Fp, Mm, Hh^Fp, Hh, Gll^Fp, Rr, Rr, Gs, Gs, Hh, Gg, Gs, Gg^Es, Gll^Fp, Gll^Fp, Gll^Fp, Gll^Fp, Gll^Fp, Gs^Es, Aa, Ha^Fpa, Ha^Fpa, Cha, Cha, Mm, Mm, Ha^Fpa, Hh^Fp, Hh
Mm, Ms, Ms, Mm, Mm, Ms, Cha, Ha, Ha^Fpa, Hh^Fp, Hh^Fp, Hh, Gs, Gll^Fp, Gs^Eff, Gg, Gs, Hh, Gs, Hh^Fp, Hh^Fp, Hh^Fp, Gll^Fp, Rr, Rr, Gll^Fp, Gll^Fp, Gs, Ha, Gg, Gs, Gll^Fp, Gg, Gll, Gll^Es, Gll^Fp, Gll^Fp, Aa, Ha^Fpa, Ms, Cha, Kha, Mm, Ms, Ha^Fpa, Hh, Gll^Fp
Ms, Mm, Ms, Mm, Mm, Mm, Cha, Ha^Fpa, Hh, Aa, Gg, Hh, Gg^Eff, Gs^Eff, Gs^Vl, Gg^Eff, Gg^Eff, Gg, Gll, Gll^Fp, Ha^Fpa, Ha^Fpa, Gll^Fp, Rr, Rr, Gll^Fp, Gll^Fp, Hh, Ha^Fpa, Gll^Fp, Ha^Fpa, Gs, Hh, Gll^Fp, Hh^Fp, Hh^Fp, Hh, Gs^Es, Ha, Hh, Ch, Ms, Cha, Ms, Ha, Gll^Fp, Gll^Fp
Mm, Ms, Mm, Ms, Mm, Kha, Ch, Hh^Fp, Gs, Gs, Gg^Eff, Gg^Eff, Rb^Gvs, Rb^Gvs, Rb^Gvs, Rb^Gvs, Rb^Gvs, Gs^Eff, Gll^Fp, Gll^Fp, Gll^Fp, Ha^Fpa, Rr, Rr, Rr, Gs, Gg, Gll^Fp, Gll^Fp, Gll^Fp, Aa, Gll^Fp, Ha, Hh, Ms, Mm, Hh, Aa, Aa^Fma, Hh^Fp, Hh^Fp, Cha, Ms, Mm, Ha, Gs, Gs
Ms, Ms, Ms, Mm, Cha, Cha, Ha, Hh^Fp, Gg^Eff, Gg^Eff, Gs^Vl, Gg^Eff, Gg, Rb^Gvs, Rb^Gvs, Rb^Gvs, Gg, Gll^Fp, Gll^Fp, Gll^Fp, Gll^Fp, Ch, Kh, Rr, Kh, Ch, Gg, Gs, Gs, Gs, Gg, Ha, Ms, Ms, Ha, Ha, Ha^Fpa, Hh^Fp, Ha^Fpa, Aa^Fma, Gll^Fp, Ha, Hh^Fp, Hh^Fp, Aa^Fma, Gll^Fp, Gg
Hh^Fp, Ha^Fpa, Ha^Fpa, Hh^Fp, Ha^Fpa, Ha^Fpa, Hh, Hh, Rb^Gvs, Rb^Gvs, Rb^Gvs, Rb^Gvs, Rb^Gvs, Gg^Eff, Gg^Eff, Gg^Eff, Gs^Eff, Gll^Fp, Gll^Fp, Gll^Fp, Gll^Fp, Ch, Rr, Rr, Rr, Ch, Gg, Gs, Rp^Vhcr, Gg, Gs, Ha^Fpa, Ha^Fpa, Hh^Fp, Gll, Aa, Gll^Fp, Ha^Fpa, Gll^Fp, Gll^Fp, Gs^Vl, Gll, Gll^Fp, Aa^Fma, Gll^Fp, Gll^Es, Gg^Es
Ha^Fpa, Ha^Fpa, Hh^Fp, Hh^Fp, Hh, Hh, Rb^Gvs, Gg^Eff, Gg, Rb^Gvs, Rb^Gvs, Rb^Gvs, Gg, Gg^Eff, Rb^Gvs, Gs^Vl, Rb^Gvs, Gll^Eff, Gll^Fp, Gll^Fp, Gll^Fp, Gs, Rr, Rr, Gg, Gs^Es, Gg, Gg, Gs, Gs, Gs, Gs, Gg, Aa^Fma, Gll^Fp, Gll, Gll, Aa^Fma, Gll^Fp, Gll, Gll^Fp, Gg, Gs, Gll, Gs, Gs, Gg^Es
Hh^Fp, Hh^Fp, Gll, Hh, Gs^Vl, Rb^Gvs, Rb^Gvs, Rb^Gvs, Rb^Gvs, Gg^Eff, Gg^Eff, Gg^Eff, Gg^Eff, Rb^Gvs, Rb^Gvs, Rb^Gvs, Rb^Gvs, Rb^Gvs, Rp, Gll^Fp, Gs, Gs, Rr, Rr, Gg, Gg, Gs, Gs, Gg^Es, Gg^Es, Gg^Es, Gg, Gg, Gs, Gs, Gs, Gs^Efm, Gll^Fp, Gs, Gll, Gs, Ce, Ce, Ce, Ce, Gg^Es, Gs
Hh, Hh, Gll^Fp, Gg^Eff, Gs^Eff, Rb^Gvs, Rb^Gvs, Rb^Gvs, Gg^Eff, Gg^Es, Rb^Gvs, Rb^Gvs, Rb^Gvs, Gg, Gg^Eff, Rb^Gvs, Rp, Rp, Gll^Fp, Rp, Rp, Rp, Rr, Rr, Gs, Gg^Es, Gg, Gs, Gg, Gg, Gll^Fp, Gg, Gs, Aa^Fma, Gs, Gg^Efm, Gg^Efm, Gs, Gg, Gg^Es, Gs, Gg, Ce, 1 Ke, Ce, Gs, Hh^Fp
Gg, Gll^Fp, Aa^Fpa, Gll^Fp, Gll^Fp, Gg^Eff, Gs^Eff, Gs^Eff, Gll^Fp, Gd^Vhr, Rb^Gvs, Rb^Gvs, Rb^Gvs, Rb^Gvs, Gg^Eff, Rp^Eff, Gll^Fp, Gll^Fp, Chr, Gg, Chr, Gs, Rr, Rr, Gg, Gg, Rp^Vhcr, Gs, Gg, Gs, Hh^Fp, Gs, Gg, Gll^Fp, Gs, Gs^Efm, Gg^Efm, Gs, Gll^Fp, Gs^Es, Gg, Ce, Gg, Ce, Gs, Ha, Hh
Gll^Fp, Aa, Ha^Fpa, Aa^Fpa, Aa, Gg, Hh, Hh^Fp, Aa^Fpa, Gll^Fp, Gll^Fp, Rb^Gvs, Gg^Eff, Gg, Gs, Gg^Es, Gg, Chr, Khr, Rp^Vhcr, Chr, Gs, Rr, Rr, Gs, Gs, Gs, Gg, Gs, Hh^Vhh, Hh, Hh, Gg^Efm, Gs, Gg, Gll^Fp, Gll^Fp, Gll^Fp, Gll^Fp, Gs, Ce, Gg^Es, Gs, Ce, Ha^Fpa, Ha^Fpa, Ms
Hh, Hh, Ha^Fpa, Hh^Fp, Cha, Hh, Ms, Ha^Fpa, Ha^Fpa, Aa, Gs^Eff, Gs^Eff, Rb^Gvs, Gg^Eff, Gg, Gs, Chr, Rp^Vhcr, Chr, Chr, Gg, Gg, Rr, Rr, Gg, Aa^Fma, Gll^Fp, Gg, Gg^Es, Gs, Gg, Gg, Gg^Efm, Gg^Efm, Gll, Gll^Fp, Gll^Fp, Gll^Fp, Gll^Fp, Ce, 5 Ke, Ce, Hh^Fp, Hh, Ms, Ms, Mm
Ha, Hh, Hh, Ms, Kha, Cha, Cha, Hh, Ha^Fpa, Hh, Gd^Vhr, Rb^Gvs, Rb^Gvs, Rb^Gvs, Rb^Gvs, Gg^Eff, Gg^Eff, Chr, Gg, Gg, Gll^Fp, Gg^Es, Rr, Rr, Gs, Aa^Fma, Aa^Fma, Gll^Es, Gg^Es, Gg, Gs, Gg^Efm, Gg^Efm, Gs, Gll^Fp, Gll^Fp, Gll^Fp, Gll, Gg, Ce, Ce, Ce, Ha^Fpa, Ha, Ms, Ms, Mm
Hh, Hh^Fp, Ha^Fpa, Ms, Cha, Cha, Mm, Mm, Hh^Fp, Hh, Gg^Eff, Rb^Gvs, Rb^Gvs, Rb^Gvs, Gg, Gg^Eff, Gg^Eff, Gg, Hh^Fp, Gll^Fp, Gll^Fp, Gs^Es, Rr, Rr, Gll^Fp, Gll, Ha^Fpa, Gll^Fp, Gs, Gs^Es, Ha^Fpa, Gg, Gg, Gs, Gll^Fp, Gll^Fp, Gll^Fp, Gs, Gg, Gs, Ha^Fpa, Gs, Ha^Fpa, Ha, Ms, Mm, Mm
Gll^Fp, Hh, Ha^Fpa, Ha, Hh^Fp, Mm, Ms, Ha^Fpa, Hh^Fp, Gs, Gg^Eff, Gg^Eff, Gg^Eff, Gg^Eff, Rb^Gvs, Rb^Gvs, Rb^Gvs, Gg^Eff, Hh^Fp, Ko, Co, Gs^Es, Rr, Rr, Co, Ko, Ms, Hh, Hh^Fp, Ha^Fpa, Ms, Ha, Gs, Gg, Gs, Gll, Aa^Fma, Gs, Hh^Fp, Ha^Fpa, Hh, Hh^Fp, Mm, Ms, Mm, Mm, Mm
Gg, Gll, Hh, Ha^Fpa, Hh^Fp, Ms, Ha, Ha^Fpa, Hh, Gg, Rb^Gvs, Gg^Es, Gg, Rb^Gvs, Rb^Gvs, Rb^Gvs, Rb^Gvs, Rb^Gvs, Gll^Fp, Co, Gll^Fp, Gg, Rr, Rr, Gg, Co, Mm, Mm^Xm, Mm, Ha, Ms, Hh^Fp, Hh, Ha^Vhha, Gs, Gg, Aa^Fma, Gg, Ha^Fpa, Ha, Ms, Ms, Ms, Mm, Ms, Ms, Mm
Gll^Fp, Gll^Fp, Gs, Hh, Hh, Ha, Hh^Fp, Hh, Rb^Gvs, Rb^Gvs, Rb^Gvs, Rb^Gvs, Rb^Gvs, Gg^Eff, Gg^Eff, Gd^Vhr, Hh^Fp, Hh, Hh, Gll^Fp, Aa^Fma, Gll^Fp, Rr, Rr, Rr, Hh, Hh, Ms, Ms, Mm^Xm, Mm^Xm, Ha^Fpa, Ha^Fpa, Hh^Fp, Hh^Fp, Ha, Ha^Fpa, Hh, Ha^Fpa, Mm, Ms, Ms, Ms, Ms, Mm, Ms, Ms
Hh^Fp, Aa, Aa^Fma, Aa, Gg, Aa, Gll, Gg, Gg, Rb^Gvs, Gd^Vhr, Rb^Gvs, Hh, Hh, Hh^Fp, Gs^Eff, Ha^Fpa, Mm, Ms^Xm, Ha, Hh^Fp, Gll^Fp, Gll^Fp, Rr, Rr, Hh, Hh, Ha^Fpa, Ha, Mm, Mm, Ms^Xm, Hh, Ha, Hh^Fp, Hh^Fp, Ms, Ha^Fpa, Ha, Ms, Mm, Mm, Ms, Ms, Mm, Ms, Mm
Hh, Hh, Hh, Aa, Aa, Gll^Fp, Gll^Fp, Gs, Gg, Gs, Gs, Gg, Ha^Fpa, Ha^Fpa, Hh, Gs, Aa, Ha^Fpa, Ms^Xm, Ha, Ha^Fpa, Hh^Fp, Aa^Fma, Rr, Rr, Ce, Gg, Hh, Ha^Fpa, Hh, Hh^Fp, Mm^Xm, Ms^Xm, Ha, Hh^Fp, Mm, Mm, Hh, Mm, Ms, Mm, Ms, Mm, Mm, Mm, Ms, Mm
Ms, Ha^Fpa, Ha^Fpa, Ha^Fpa, Ha, Aa^Fma, Gll^Fp, Gll^Fp, Gs, Gg, Gg, Aa, Hh^Fp, Hh, Hh^Fp, Gs, Gg, Ha, Mm^Xm, Hh, Hh, Hh, Ha^Fpa, Cea, Cea, Ce, Ce, Cea, Aa, Ha^Fpa, Hh, Mm, Mm, Ms^Xm, Ha^Fpa, Mm, Ms, Ms, Ms, Mm, Ms, Mm, Hh^Vhh, Mm, Hh, Mm, Mm
Mm, Ms, Hh, Hh^Fp, Hh^Fp, Ha, Hh^Fp, Gll^Fp, Gll, Gg, Aa^Fma, Aa, Aa, Gll, Gll, Gg, Gg, Hh^Fp, Hh, Mm^Xm, Ms, Mm, Hh, Ha, Cea, 2 Ke, Ce, Gg, Gs, Aa, Hh^Fp, Mm, Ms^Xm, Mm^Xm, Hh, Ha, Mm, Mm, Mm, Mm, Ms, Mm, Hh, Hh, Hh, Hh, Ms
Mm, Mm, Mm, Hh, Hh^Fp, Ha^Fpa, Ha^Fpa, Gll, Gll^Fp, Gll^Fp, Ha^Fpa, Ha^Fpa, Ha^Fpa, Aa^Fma, Aa^Fma, Aa, Rrc^Vhca, Gs, Hh, Ha, Ms^Xm, Ms^Xm, Ha^Fpa, Hh, Gs, Ce, Rr, Rr, Rr, Gs, Aa, Ha^Fpa, Ms^Xm, Mm, Ms, Ha^Fpa, Hh, Mm, Ms, Ms, Mm, Hh, Hh, Hh, Hh, Hh, Ms
Ms, Mm, Mm, Mm, Hh^Fp, Hh, Hh, Gll, Gll^Fp, Gll^Fp, Mm, Ms, Mm, Hh^Fp, Ha^Fpa, Aa, Gg, Aa, Hh^Fp, Ha^Fpa, Mm^Xm, Ms, Ha^Fpa, Hh^Fp, Aa, Kea, Gg, Rr, Rr, Gg, Gg, Hh, Mm, Mm^Xm, Ms^Xm, Ha^Fpa, Ha^Fpa, Mm, Mm, Mm, Ms, Mm, Mm, Hh, Mm, Mm, Mm
Ms, Mm, Mm, Mm, Mm, Ms, Ms, Hh, Ha^Fpa, Hh^Fp, Hh, Ha, Ha, Ha^Fpa, Mm, Gll^Fp, Gll, Aa, Ha, Ha^Fpa, Ms^Xm, Mm, Ha^Fpa, Ha, Gs, Gs, Gg, Rr, Rr, Gs, Hh^Fp, Hh^Fp, Mm, Ms^Xm, Hh^Fp, Hh^Fp, Hh, Mm, Mm, Mm, Mm, Ms, Ms, Ms, Ms, Ms, Mm
Ms, Ms, Ms, Mm, Mm, Ms, Mm, Ms, Hh, Ha^Fpa, Mm, Hh^Fp, Hh, Hh^Fp, Hh, Gll^Fp, Gg, Ha^Fpa, Hh, Hh^Fp, Ms, Ms, Hh^Fp, Hh, Hh, Gs, Gs, Rr, Rr, Gs, Hh^Fp, Hh, Mm, Mm, Mm, Hh^Fp, Mm, Mm, Mm, Mm, Mm, Mm, Mm, Mm, Mm, Ms, Mm
