Mm, Mm, Mm, Mm, Mm, Mm, Mm, Mm, Mm, Mm, Hh^Fms, Mm, Mm, Mm, Mm, Mm, Mm, Mm, Hh, Hh^Fms, Gs^Fms, Gs, Gg, Gg, Gg, Gg, Gs, Gg, Gs, Gg, Gs, Gg, Gg^Es, Gg, Gg, Gs, Gg, Gg, Gg, Gg, Rp, Rp, Rp, Gg, Gs, Gs, Gs, Gg, Gg, Gg, Gs, Gg, Gg, Gs, Gs^Fms, Gg, Gs^Fms, Gs^Fms, Gs^Fms, Gg, Gs^Fms, Gs^Fms, Gs^Fms
Mm, Mm, Hh^Fms, Hh, Ww, Hh, Hh^Fms, Hh^Fms, Ww, Ww, Ww, Ww, Hh, Mm, Mm, Mm, Mm, Mm, Hh, Hh^Fms, Gs, Gs, Gg, Gg, Gs, Gg, Gg, Gg^Es, Gg, Gs, Gg, Gs, Gg, Gg, Gg, Gg, Gs, Gs, Gg, Gg, Rp, Rp, Rp, Gg, Gs, Gg, Gg, Gs, Gs^Vh, Gg^Es, Gs, Gs^Es, Gg, Gs, Gs, Gg, Gs^Fms, Gs^Fms, Gs^Fms, Gs^Fms, Gs^Fms, Gs^Fms, Gs^Fms
Mm, Hh, Hh, Hh, Ww, Ww, Ww, Ww, Wo, Ww, Wo, Ww, Hh^Fms, Mm, Mm, Mm, Mm, Mm, Hh^Fms, Hh^Fms, Gs^Fms, Gs, Gs, Gs, Gs^Vh, Gg, Gg, Gg, Gg, Gs, Gg, Gg, Gg, Gs, Gs, Gg, Gg, Gg, Gg, Gg, Rp, Rp, Rp, Gg, Gg, Gs, Gg, Gs, Gg, Gg, Gs, Gg, Gs, Gg, Gg, Gs, Gs, Gs, Gs, Gg, Gg, Gs^Fms, Gs^Fms
Mm, Hh^Fms, Hh, Ww, Ww, 1 Wo, Wo, Wo, Ww, Wo, Ww, Ww, Gs^Fms, Hh^Fms, Hh^Vhh, Mm, Mm, Hh^Fms, Hh, Gll, Gs^Fms, Gs^Fms, Gs, Gs, Gg, Gs, Gg^Es, Gg, Gs, Gg, Gg, Gs, Gs, Gg^Es, Gs, Gg, Gg, Gg, Gg, Gg, Rp, Rp, Rp, Gg, Gg, Gs, Gg^Es, Gg, Gs, Gg, Gs, Gs, Gs, Gg^Es, Gg^Es, Gg, Gs, Gs, Gg, Gs^Fms, Gs^Fms, Gs^Fms, Gs
Mm, Mm, Hh, Hh, Ww, Wo, Wo, Ww, Gg^Fet, Ww, Ww, Ww, Ww, Gs^Fms, Hh, Hh^Fms, Hh^Fms, Hh, Hh^Fms, Gll, Gs, Gs, Gg, Gg, Gg, Gg, Gg, Gg^Es, Gs, Gs, Gg, Gg^Es, Gs, Gg, Gs, Gs, Gg, Gg, Rp, Rp, Rp, Rp, Rp, Gg, Gg, Gg, Gs^Es, Gs, Gs, Gg, Gg, Gg^Efm, Gg, Gs, Gg, Gg, Gg, Gs^Fms, Gs, Gg, Gs, Gs^Fms, Gs
Mm, Mm, Mm, Hh, Gs^Fms, Ww, Wo, Ww, Gg^Fet, Gg^Fet, Ww, Wo, Ww, Gg^Fet, Gll, Gs^Fms, Gll, Hh^Fms, Gs^Fms, Gs^Fms, Gs, Gg, Gg, Gg, Gg, Gs, Gs, Gg, Gg, Gg, Gg, Gg, Gg, Gg, Gg, Gg, Rp, Rp, Rp, Rp, Rp, Rp, Gg, Gg, Gs, Gs, Gg, Gg, Gg, Gg, Gs^Efm, Gg, Gs, Gs, Gg^Efm, Gg, Gg, Gg, Gs, Gs^Fms, Gg, Gs, Gg
Mm, Mm, Mm, Hh^Fms, Gs^Fms, Ww, Ww, Ww, Ww, Ww, Wo, Wo, Gs^Fms, Gs^Fms, Gs^Fms, Gs^Fms, Gs^Fms, Gs^Fms, Gs, Gs, Gg, Gg, Gg, Gg^Es, Gs, Gs, Gg, Gg, Gg, Gs, Gg, Gs, Gg, Gs, Gg, Rp, Rp, Rp, Rp, Rp, Gg, Gg, Gg, Gg, Gs, Gg, Gg^Es, Gs, Gs, Gg, Gg, Gs, Gg^Efm, Gs, Gg, Gs, Gg, Gg, Gg, Gg, Gs, Gg^Es, Gs^Es
Mm, Hh, Hh, Hh^Fms, Ww, Ww, Wo, Wo, Wo, Ww, Wo, Ww, Ww, Gs, Gs, Gs^Fms, Gs, Gs, Gg, Gg, Gs^Es, Gs^Es, Gg, Gg, Gg, Gg, Gg, Gg, Gs^Vh, Gg, Gg, Gg, Gg, Gg, Gg, Rp, Rp, Rp, Gg, Gg, Gg, Gs, Gg, Gg, Gg, Gs, Gs, Gg, Gg, Gg, Gs, Gs, Gs^Efm, Gs^Efm, Gg, Gs^Vh, Gg, Gs, Gs, Gg, Gs, Gg, Gg
Mm, Hh^Fms, Hh, Ww, Ww, Ww, Ww, Ww, Ww, Ww, Ww, Ww, Gg, Gg, Gg, Gs, Gs, Gg, Gg^Es, Gs, Gg, Gg, Gs, Gs^Vh, Gg, Gg, Gs, Gg, Gg, Gg, Gg, Gg, Gg, Gg, Rp, Rp, Rp, Rp, Gs, Gs, Gg, Gg, Gs, Gs, Gs, Gs, Gs^Fms, Gs, Gs, Gg, Gg, Gs, Gs, Gg, Gg^Efm, Gg, Gg, Gg^Efm, Gg^Efm, Gg, Gg, Gs, Gg
Mm, Hh^Fms, Hh^Fms, Ww, Hh, Gs^Fms, Gs^Fms, Ww, Ww, Ww, Ww, Ww, Ww, Gg, Gg, Gs, Gs, Gg, Gs^Es, Gg, Gg, Gs, Hh, Gg, Gs, Gg, Gs, Hh, Gs, Gg, Gg, Gg, Rp, Rp, Rp, Rp, Rp, Rp, Gg, Gg, Gg^Es, Gs, Gs^Fms, Gs^Fms, Hh, Gll, Hh, Gs^Fms, Gs, Gg, Gg^Es, Gs, Gg, Gs, Gs, Gs^Efm, Gg, Gs, Gg, Gg, Gg^Efm, Gs, Gg
Mm, Mm, Mm, Hh, Hh^Fms, Hh^Fms, Hh^Fms, Gs^Fms, Gll, Gs^Fms, Gs^Fms, Ww, Ww, Ww, Ww, Gg, Gg, Gg, Gg, Gs, Gs, Gs, Gg, Hh, Hh, Gs, Hh, Hh, Gs, Gg, Gg, Rp, Rp, Rp, Rp, Rp, Gg, Gg, Gg, Gs, Gs, Gs, Hh^Fms, Hh^Fms, Hh, Hh, Hh^Fms, Hh, Gs, Gg, Gg, Gg, Gs, Gg, Gg, Gg, Gg, Gs^Efm, Gg, Gg^Efm, Gg, Gs, Gg
Mm, Mm, Mm, Mm, Mm, Mm, Mm, Hh, Hh^Fms, Gll, Gll, Gs, Gs, Ww, Ww, Ww, Ww, Gg, Gs, Gg, Gg^Es, Gg, Gs, Hh, Hh^Fms, Hh^Fms, Hh^Fms, Hh, Gg, Gg, Gg, Rp, Rp, Rp, Gg, Gg, Gg, Gg, Gg, Gg, Gs, Hh, Gs, Hh, Gs^Fms, Hh^Fms, Hh^Fms, Hh, Gs, Gg, Gg, Gg, Gs, Gs, Gg, Gg, Gs, Gg^Efm, Gs, Gg, Gg, Gg, Gs
Mm, Mm, Mm, Mm, Mm, Mm, Mm, Mm, Hh^Fms, Hh, Gs^Fms, Gs^Fms, Gll, Gs^Fms, Gll, Ww, Ww, Gg, Gg, Gg, Gg, Gs^Es, Gg, Gs, Gs, Hh^Fms, Gs, Gg, Gs, Gg, Gg, Rp, Rp, Rp, Gg, Gg, Gs, Gs^Es, Gs^Vh, Gs, Gg, Gs, Gg, Gs, Gs, Gs^Fms, Hh, Hh, Gs^Fms, Gs, Gs, Gg, Gg, Gs^Vh, Gs^Es, Gs, Gs, Gg^Efm, Gg, Gs, Gg, Gg, Gs
Mm, Mm, Mm, Mm, Mm, Mm, Mm, Mm, Hh^Fms, Hh, Gs^Fms, Gs^Fms, Gll, Gs^Fms, Gll, Ww, Ww, Ww, Gg, Gg, Gs, Gs^Es, Gg, Gg, Gg, Gs, Gg, Gs, Gs^Es, Gg, Gg, Rp, Rp, Rp, Gg, Gs, Gg, Gg^Es, Gg, Gg, Gs, Gs, Gs, Gg, Gs, Gll, Hh, Hh, Gs^Fms, Gs^Fms, Gs, Gg, Gg^Es, Gg, Gg, Gg^Es, Gg, Gg, Gg, Gg, Gs, Gs, Gs
Mm, Mm, Mm, Mm, Mm, Mm, Mm, Mm, Hh, Hh, Gs^Fms, Gll, Gll, Gs^Fms, Gs^Fms, Gll, Ww, Ww, Gg, Gg, Gg, Gg, Gg, Gs, Gs, Gg, Gg, Gg, Gg, Gg, Gg, Rp, Rp, Rp, Gg, Gg, Gg, Gs, Gs, Gg^Es, Gg, Gg, Gg, Gs, Hh^Vhh, Hh, Gs, Gs^Fms, Gs, Gs^Fms, Gs, Gg^Es, Gg, Gg, Gg, Gg^Es, Gg, Gs, Gs^Fms, Gs, Gs, Gs^Fms, Gll
Mm, Mm, Mm, Mm, Mm, Mm, Hh^Fms, Hh^Fms, Hh, Gs^Fms, Gs^Fms, Gll, Gll, Gll, Gs, Gs, Ww, Ww, Gs, Gs, Gs, Gs, Gg, Gg, Gs^Es, Gg^Es, Gg, Gs^Vh, Gg, Gg, Gg, Rp, Rp, Rp, Gg, Gg, Gs, Gs, Gs, Gg, Gg, Gs, Gg, Gs, Gs, Gs, Gg, Gs, Gg, Gs, Gs, Gg, Gs, Gg, Gs, Gs, Gs, Gs, Gll, Gll, Gs^Fms, Gs^Fms, Gs^Fms
Mm, Mm, Mm, Mm, Mm, Hh^Fms, Hh^Vhh, Hh, Gll, Gs^Fms, Gs, Gll, Gll, Gs^Fms, Gs, Gg, Ww, Ww, Gg, Gs, Gg, Gg, Gg^Es, Gs, Gs, Gg, Gg, Gg, Gg, Gg, Wwg, Rp, Wwg^Bsb|, Rp, Wwg, Gg, Gg, Gs, Gg, Gg, Gs, Gg, Gg, Gs, Gg, Gg^Es, Gs, Gs, Gs, Gs, Gs^Fms, Gs, Gs^Fms, Gs, Gs^Fms, Gs^Fms, Gs^Fms, Gll, Gs^Fms, Gs, Gs, Gll, Gs^Fms
Mm, Mm, Mm, Mm, Hh, Hh^Fms, Gll, Gll, Gll, Gg^Fet, Gll, Gs, Gs^Fms, Gs, Gg, Gg, Ww, Ww, Ww, Gg, Gg, Gs, Gg, Gg^Es, Gg, Gg, Gg, Gg, Wwg, Wwg, Kh, Wwg^Bsb|, Rr, Wwg^Bsb|, Kh, Wwg, Wwg, Gg, Gg, Gg, Gg, Gg, Gs, Gs^Es, Gs, Gg, Gs, Gs^Fms, Gs^Fms, Gll, Gs^Fms, Gll, Hh, Gll, Hh, Gs^Fms, Gg, Gs^Fms, Gll, Gll, Gs^Fms, Gll, Gs^Fms
Mm, Mm, Mm, Hh^Fms, Hh^Fms, Hh^Fms, Gs^Fms, Gs^Fms, Gll, Gll, Gs^Fms, Gs^Fms, Gs, Gs, Gs, Gg, Gg, Ww, Ww, Gs^Vh, Gg, Gs, Gs, Gg, Wwg, Wwg, Wwg, Wwg, Ch, Wwg, Ch, Rr, Rr, Rr, Ch, Wwg, Ch, Wwg, Wwg, Wwg, Wwg, Gg, Gg, Gs, Gg, Gg, Gs, Gs^Fms, Gs^Fms, Gll, Gs^Fms, Gll, Hh, Hh, Hh, Gs^Fms, Gs^Fms, Gs^Fms, Gll, Gll, Gs^Fms, Gs^Fms, Gll
Mm, Mm, Mm, Hh^Fms, Hh, Gll, Gs^Fms, Gll, Gs^Fms, Gll, Gll, Gs^Fms, Gs, Gg, Gg, Gs, Gg, Ww, Ww, Ww, Gg, Gg, Gg, Wwg, Ch, Ch, Ch, Ch, Kh, Ch, Gg, Rr, Rr, Rr, Gg, Ch, Kh, Ch, Ch, Ch, Ch, Wwg, Gg, Gg, Gs, Gs, Gs^Fms, Gs^Fms, Gs^Fms, Gll, Gs^Fms, Hh^Vhh, Hh, Hh^Fms, Hh^Fms, Hh, Hh^Fms, Gs^Fms, Gg^Fet, Gs^Fms, Gs^Fms, Gll, Gs^Fms
Mm, Mm, Hh, Hh, Gll, Gll, Gll, Gs^Fms, Gll, Gll, Gll, Gs^Fms, Gs, Gg, Gg, Gs, Gs, Gg, Ww, Ww, Ww, Gg, Wwg, Wwg, Kh, Kh, Gg, Gg, Rr, Gg, Gs, Rr, Rr, Rr, Gs, Gs, Rr, Gg, Gg, Kh, Ch, Wwg, Wwg, Gg, Gs, Gs, Gs^Fms, Gll, Gs^Fms, Gll, Gs^Fms, Gll, Gs^Fms, Hh^Fms, Hh, Hh, Hh^Fms, Hh^Fms, Gs^Fms, Gs^Fms, Gll, Gs^Fms, Gll
Hh^Fms, Hh^Fms, Hh^Fms, Hh^Fms, Gs^Fms, Gs^Fms, Gs^Fms, Gll, Gll, Gll, Gs^Fms, Gs, Gg, Gg, Gg, Gg^Es, Gs, Gg, Gg, Ww, Ww, Ww, Wwg, Wwg, Wwg, Gg, Gs, Gs, Rr, Gg, Rr, Rr, Rr, Rr, Rr, Rr^Vhc, Rr, Gs, Gs, Rr, Gg, Ch, Wwg, Gg, Gs, Gs, Gs^Fms, Gll, Gll, Gs^Fms, Gs^Fms, Gll, Gll, Gll, Hh^Fms, Hh^Fms, Hh^Fms, Gs^Fms, Gll, Gs^Fms, Gs^Fms, Gll, Gll
Hh, Hh, Gs^Fms, Gs^Fms, Gll, Gll, Gs^Fms, Gs, Gg, Gs, Gs, Gs, Gg, Gg, Gg, Gg, Gg, Gs, Gs, Gg, Gg, Gg, Wwg, Kh, Gg, Wwg, Wwg^Bsb/, Rr, Gg, Rr, Rr^Vhc, Gg, Rr, Gs, Gg, Rr, Rr, Rr, Rr, Rr, Gg, Ch, Wwg, Gg, Gg, Gs, Gs, Gs^Fms, Gs, Gs^Fms, Gs^Fms, Gll, Gs^Fms, Gs^Fms, Gll, Hh^Fms, Gs^Fms, Gll, Gs^Fms, Gll, Gll, Gs^Fms, Gs^Fms
Gll, Gll, Gs^Fms, Gll, Gll, Gs^Fms, Gs^Fms, Gs, Gs, Gg, Gg, Gg, Gs, Gs^Vh, Gs^Es, Gg, Gs, Gs, Gg, Gg, Gg, Gg, Wwg, Ch, Gs, Rr, Gs, Wwg, Wwg, Gs, Gg, Gs, Rr, Gg, Gg, Rr^Vhc, Gg, Gg, Rr, Gg, Gs, Ch, Wwg, Gg, Gg, Gg, Gg, Gs, Gg, Gs, Gs, Gs^Fms, Gs^Fms, Gll, Gs^Fms, Gs^Fms, Gs^Fms, Gll, Gll, Gs^Fms, Gs^Fms, Gll, Gll
Gs^Fms, Gll, Gs^Fms, Gs^Fms, Gs^Fms, Gll, Gll, Gs^Fms, Gs, Gg, Gs, Gg, Gs, Gg, Gs, Gg, Gg, Gg^Es, Gg, Gg, Wwg, Wwg, Ch, Ch, Gg, Rr, Rr, Gg, Gg, Wwg, Wwg, Wwg, Wwg^Bsb|, Wwg, Wwg, Gg, Gs, Gg, Rr, Rr^Vhc, Gg, Ch, Ch, Wwg, Wwg, Gs, Gg, Gg, Gg, Gg, Gg, Gs, Gs^Fms, Gll, Gs^Fms, Gll, Gs^Fms, Gs^Fms, Gll, Gs^Fms, Gs^Fms, Gs^Fms, Gs^Fms
Gs^Fms, Gs^Fms, Gs^Fms, Gg^Fet, Gll, Gs^Fms, Gs^Fms, Gs^Fms, Gs, Gg, Gg, Gg, Gs, Gg, Gg, Gs^Es, Gg, Gg, Gg, Gg, Wwg, Ch, Gg, Gg, Gg, Rr^Vhc, Rr, Gg, Wwg, Wwg, Ch, Ch, Kh, Ch, Ch, Wwg, Wwg, Gg, Rr, Gg, Gs, Gg, Gg, Ch, Wwg, Gs, Gg, Gg^Es, Gs, Gs, Gg, Gs, Rp, Gll, Gs^Fms, Gll, Gs^Fms, Gll, Gs^Fms, Gs^Fms, Rp, Rp, Rp
Gs^Fms, Gll, Gs^Fms, Gll, Gs^Fms, Gs^Fms, Gll, Gs, Gg, Gs^Es, Gg, Gg, Gs, Gg, Gg, Gg, Gg, Gg, Rp, Rp, Wwg^Bsb\, Kh, Gg, Kh, Gg, Gs, Rr, Rr^Vhc, Wwg, Ch, Rrc, Rrc, Ch, Rrc, Rrc, Ch, Wwg, Rr^Vhc, Rr, Gg, Gg, Kh, Gg, Kh, Wwg^Bsb/, Rp, Rp, Gg, Rp, Rp, Rp, Rp, Rp, Rp, Rp, Rp, Rp, Rp, Rp, Rp, Rp, Rp, Rp
Gll, Gll, Gll, Gll, Gs^Fms, Gs^Fms, Gll, Gs, Gs, Gg, Gg^Es, Gg, Gg, Gg, Gg, Gg, Rp, Rp, Rp, Wwg, Wwg, Rr, Rr, Rr, Rr, Rr, Rr, Gs, Wwg, Kh, Ch, Rrc, 3 Kh, Rrc, Ch, Kh, Wwg, Gg, Rr, Rr, Rr, Rr, Rr, Rr, Wwg, Wwg, Rp, Rp, Rp, Rp, Rp, Rp, Gs^Fms, Rp, Rp, Rp, Rp, Rp, Rp, Rp, Gs^Fms, Gs^Fms, Gs^Fms
Hh, Gs^Fms, Gs^Fms, Gll, Gll, Gs^Fms, Gs^Fms, Gs^Fms, Gs, Gg, Gs, Gg, Gg, Gs, Rp, Rp, Rp, Rp, Rp, Wwg, Wwg^Bsb/, Rr, Gg, Rr, Gg, Gg, Rr, Gs, Rr^Vhc, Wwg, Wwg^Bsb|, Ch, Ch, Ch, Wwg^Bsb|, Wwg, Gs, Gs, Rr, Rr^Vhc, Gg, Rr, Gg, Rr, Wwg^Bsb\, Wwg, Rp, Rp, Gg, Gg, Gg, Gs, Gg, Gs^Fms, Gs^Fms, Gs, Gs^Fms, Gs^Fms, Gs, Gs, Gll, Gg^Fet, Gs^Fms
Hh, Hh, Hh^Fms, Hh, Hh, Gs^Fms, Gs^Fms, Gs^Fms, Gs, Gs, Gg, Gs, Rp, Rp, Rp, Rp, Gg, Gg, Gg, Rp, Wwg, Kh, Gg, Kh, Gg, Rr, Gg, Gg, Wwg, Wwg, Wwg^Bsb|, Wwg, Wwg^Bsb|, Wwg, Wwg^Bsb|, Wwg, Wwg, Gg, Gg, Rr, Gs, Kh, Gg, Kh, Wwg, Rp, Gg, Gg, Gg, Gg, Gs, Gs, Gs^Fms, Gs^Fms, Gs^Fms, Gll, Gs^Fms, Gll, Gll, Gs^Fms, Gll, Gll, Gll
Hh^Fms, Hh, Hh^Fms, Hh^Fms, Hh, Hh, Gs, Gs, Gg, Gg, Rp, Rp, Rp, Rp, Gs, Gg, Gg, Gg, Gs, Gg, Wwg, Ch, Ch, Gg, Gg, Rr, Rr^Vhc, Wwg, Ch, Ch, Ch, Wwg, Kh, Wwg, Ch, Ch, Ch, Wwg, Rr^Vhc, Rr, Gs, Gs, Ch, Ch, Wwg, Gg, Gs, Gs, Gg, Gs^Es, Gg, Gs, Gs, Gg, Gs^Fms, Gll, Gs^Fms, Gs^Fms, Gll, Gs^Fms, Gs^Fms, Gs^Fms, Gll
Hh, Hh^Fms, Hh, Hh, Hh, Hh, Gs, Gg, Gs, Gg, Rp, Rp, Gs, Gg, Gg, Gs, Gg, Gs, Gs, Gg, Gg, Wwg, Wwg, Ch, Gs, Rr, Gs, Wwg, Kh, Wwg, Wwg, Ch, Wwg^Bsb|, Ch, Wwg, Wwg, Kh, Wwg, Gs, Rr, Rr, Ch, Wwg, Wwg, Gg, Gg, Gg, Gs, Gg, Gg, Gg, Gs, Gs, Gg, Gs^Fms, Gs^Fms, Gll, Gll, Gg^Fet, Gs^Fms, Gll, Gs^Fms, Gs^Fms
Hh, Hh, Hh^Fms, Hh^Fms, Hh^Fms, Hh, Gs, Gs^Es, Gg, Gg, Rp, Rp, Gs, Gg, Gs, Gs, Gg, Gg, Gg, Gg, Gs, Gg, Wwg, Ch, Rr^Vhc, Rr, Gs, Wwg, Wwg, Wwg, Gg, Wwg, Rr, Wwg, Gs, Wwg, Wwg, Wwg, Wwg, Gs, Rr, Ch, Wwg, Gg, Gg, Gs, Gs, Gs, Gg, Gs, Gs, Gg, Gs, Gs^Fms, Gs^Fms, Gs^Fms, Gll, Gs^Fms, Gll, Gs^Fms, Gll, Gll, Hh^Fms
Hh, Hh^Fms, Hh, Hh, Hh, Gs, Gg, Gs, Gg, Gs, Rp, Rp, Gg, Gs, Gg, Gg, Gg, Gg, Gg, Gs^Es, Gg, Gg, Wwg, Ch, Gs, Rr, Rr, Rr^Vhc, Gg, Gs, Gg, Gs, Rr, Gg, Gs, Gg, Rr^Vhc, Gg, Rr, Wwg^Bsb/, Wwg, Kh, Wwg, Gg, Gg, Gs, Gg, Gg, Gs, Gg, Gg, Gs^Fms, Gs^Fms, Gll, Gll, Gs^Fms, Gll, Gll, Hh^Fms, Hh^Fms, Hh^Fms, Hh^Fms, Hh^Fms
Hh^Fms, Hh, Hh, Hh, Hh, Gs, Gs, Gg, Gs^Es, Gs, Rp, Rp, Gg, Gg, Gg, Gs^Es, Gs, Gg, Gs, Gg, Gs, Gg, Wwg, Ch, Ch, Rr, Gs, Rr, Rr, Rr, Rr, Rr^Vhc, Rr, Gs, Rr, Rr, Rr, Rr, Rr, Gg, Kh, Wwg, Wwg, Gs, Gs, Gg, Gs, Gg^Es, Gs, Gg, Gg, Gs, Gll, Gll, Gll, Gs^Fms, Gll, Gs^Fms, Hh, Hh, Hh^Fms, Hh^Fms, Hh
Hh, Hh^Fms, Hh, Hh^Fms, Hh^Fms, Hh, Hh^Vhh, Gs, Gg, Gg, Rp, Rp, Gg, Gg, Gs, Gg, Gg, Gg, Gs, Gs, Gg, Gg, Gg, Wwg, Ch, Kh, Ch, Gs, Kh, Gs, Gg, Rr, Rr, Rr, Gs, Gg, Kh, Gg, Ch, Kh, Ch, Wwg, Gg, Gg, Gg, Gg, Gs, Gg, Gg, Gg, Gs, Gs, Gs^Fms, Gs^Fms, Gll, Gll, Gs^Fms, Hh^Fms, Hh^Fms, Hh, Hh^Fms, Hh^Fms, Hh
Hh^Fms, Hh^Fms, Hh^Fms, Hh^Fms, Hh, Hh, Gs, Gs, Gs, Gg, Rp, Rp, Gg, Gs, Gs, Gg, Gg, Gg, Gs, Gs, Gg, Gs, Gs, Wwg, Wwg, Ch, Wwg, Ch, Ch, Ch, Ch, Rr, Rr, Rr, Ch, Ch, Ch, Ch, Wwg, Ch, Wwg, Wwg, Gg, Gg, Gg^Es, Gs, Gg, Gg, Gs, Gs, Gs^Fms, Gs^Fms, Gs^Fms, Gll, Gll, Gs^Fms, Gs^Fms, Gll, Gs^Fms, Hh^Fms, Gs^Fms, Hh^Fms, Hh^Fms
Hh, Hh, Hh, Hh, Hh, Gs, Gg, Gg, Gg, Gg, Rp, Rp, Gg, Gs, Gg, Gg, Gg, Gg, Gs^Vh, Gg, Gg, Gs, Gg, Gg, Gg, Wwg, Gg, Wwg, Wwg, Wwg, Kh, Rr, Rr, Rr, Kh, Wwg, Wwg, Wwg, Gg, Wwg, Gg, Gg, Gs, Gs, Gs, Gg, Gs, Gs, Gll, Gs^Fms, Gs^Fms, Gs^Fms, Gll, Gs^Fms, Gs^Fms, Gll, Gs^Fms, Gs^Fms, Gll, Gll, Gll, Gs^Fms, Gs^Fms
Hh, Hh, Hh, Hh, Gs, Gs, Gs^Es, Gs, Rp, Rp, Rp, Rp, Gs, Gg^Es, Gg, Gg, Re^Gvs, Re^Gvs, Re^Gvs, Re^Gvs, Re^Gvs, Gg, Gg, Gg, Gg, Gg, Gg, Gg, Gg, Wwg, Wwg, Wwg^Bsb|, Wwg^Bsb|, Wwg^Bsb|, Wwg, Wwg, Gg, Gg, Gg, Gg, Gg^Es, Gg, Gg, Gs, Gs, Gs, Gs, Gs^Fms, Gs^Fms, Gs^Fms, Gs^Fms, Gll, Hh^Fms, Gll, Hh^Fms, Gs^Fms, Gg^Fet, Gs^Fms, Gll, Gs^Fms, Gs^Fms, Gs^Fms, Gll
Gs, Gs, Gs, Gs, Gg, Gg, Rp, Rp, Rp, Rp, Gg, Gg, Gg, Gg, Re^Gvs, Re^Gvs, Re^Gvs, Re^Gvs, Re^Gvs, Re^Gvs, Re^Gvs, Re^Gvs, Re^Gvs, Gg, Gg, Gs, Gs, Gs, Gg, Gg, Gs, Rp, Rp, Rp, Gg, Gg, Gg^Es, Gg, Gs, Gg, Gs, Gs, Gs^Fms, Gs, Gll, Gs^Fms, Gll, Gll, Gll, Gll, Gs^Fms, Hh^Fms, Hh, Hh^Fms, Hh, Gs^Fms, Gll, Gs^Fms, Gll, Gs^Fms, Gll, Gll, Gs
Rp, Gg, Rp, Rp, Rp, Rp, Rp, Rp, Gs, Gs, Gg, Gg, Gg, Re^Gvs, Re^Gvs, Re^Gvs, Re^Gvs, Re^Gvs, Re^Gvs, Re^Gvs, Re^Gvs, Re^Gvs, Re^Gvs, Re^Gvs, Gg, Gg, Gg, Gg, Gs, Gg, Gs, Rp, Rp, Rp, Gs, Gs, Gs, Gg, Gs, Gs, Gs^Fms, Gll, Gll, Gs, Gll, Gs^Fms, Gs^Fms, Gs^Fms, Gs^Fms, Gs^Fms, Gs^Fms, Hh^Fms, Hh^Fms, Hh^Fms, Hh, Hh^Fms, Hh^Fms, Gll, Gll, Gs^Fms, Gs^Fms, Gs^Fms, Gll
Rp, Rp, Rp, Rp, Rp, Rp, Gs, Gg, Gg, Gg, Re^Gvs, Re^Gvs, Gs^Vh, Gg, Gg, Re^Gvs, Re^Gvs, Re^Gvs, Re^Gvs, Re^Gvs, Re^Gvs, Re^Gvs, Gg, Gg, Re^Gvs, Re^Gvs, Re^Gvs, Gg, Gg, Gs, Gg, Rp, Rp, Rp, Gs, Gg, Gs, Gg, Gs, Gs, Gs^Fms, Gs^Fms, Gs^Fms, Gll, Gs^Fms, Gs^Fms, Gll, Gll, Gs^Fms, Gll, Gs^Fms, Hh^Fms, Hh, Hh, Hh^Fms, Hh^Fms, Hh^Fms, Gs^Fms, Gs^Fms, Gll, Gs^Fms, Gll, Gll
Gs, Rp, Gg, Gg, Gg^Es, Gg^Es, Gg, Gg, Re^Gvs, Re^Gvs, Re^Gvs, Re^Gvs, Re^Gvs, Re^Gvs, Re^Gvs, Gg, Gg, Re^Gvs, Gs^Vh, Re^Gvs, Gg, Gg, Re^Gvs, Re^Gvs, Re^Gvs, Re^Gvs, Re^Gvs, Re^Gvs, Re^Gvs, Gg, Gg, Rp, Rp, Rp, Gg, Gg, Gs, Gg^Es, Gs, Gs, Gs, Gll, Gll, Gs^Fms, Gs^Fms, Gll, Gs, Gs^Fms, Gs^Fms, Gs^Fms, Gs^Fms, Hh^Fms, Gs^Fms, Hh^Fms, Hh^Fms, Gs^Fms, Gll, Gs^Fms, Gs^Fms, Gs^Fms, Gs^Fms, Gg^Fet, Gs^Fms
Gs^Fms, Gs, Gs, Gs, Gs, Gg, Re^Gvs, Re^Gvs, Re^Gvs, Re^Gvs, Re^Gvs, Re^Gvs, Re^Gvs, Re^Gvs, Re^Gvs, Re^Gvs, Re^Gvs, Gg, Gg, Re, Re^Gvs, Re^Gvs, Re^Gvs, Re^Gvs, Re^Gvs, Re^Gvs, Re^Gvs, Re^Gvs, Re^Gvs, Re^Gvs, Re^Gvs, Rp, Rp, Rp, Gg, Gg, Gs, Gg, Gs, Gg, Gs, Gs^Fms, Gs^Fms, Gll, Gll, Gll, Gll, Gs^Fms, Gs^Fms, Gll, Gll, Gs^Fms, Hh, Hh^Fms, Hh, Hh^Fms, Gs^Fms, Gll, Gs^Fms, Gs^Fms, Gs^Fms, Gs^Fms, Gs
Hh, Gs^Fms, Hh, Gs^Fms, Gs^Fms, Gs, Gg, Re^Gvs, Re^Gvs, Re^Gvs, Re^Gvs, Re^Gvs, Re^Gvs, Re^Gvs, Re^Gvs, Re^Gvs, Gg, Gg, Re^Gvs, Gg, Gg, Gs^Vh, Re^Gvs, Re^Gvs, Re^Gvs, Re^Gvs, Re^Gvs, Re^Gvs, Re^Gvs, Re^Gvs, Gg, Rp, Rp, Rp, Gg, Gg, Gs, Gg, Gg, Gs, Gg, Gs, Gs, Gs^Fms, Gs, Gs^Fms, Gs, Gs, Gs, Gs, Gs, Gs^Fms, Gll, Hh, Gs^Fms, Gs^Fms, Gs^Fms, Gs^Fms, Gll, Gs^Fms, Gs^Fms, Gs^Fms, Gs
Hh, Hh, Hh, Gs^Fms, Hh, Gs, Gs, Gg, Gg, Re^Gvs, Re^Gvs, Re^Gvs, Re^Gvs, Re^Gvs, Gg, Gg, Re^Gvs, Re^Gvs, Re^Gvs, Re^Gvs, Re^Gvs, Gg, Gg, Re^Gvs, Re^Gvs, Re^Gvs, Re^Gvs, Re^Gvs, Gg, Gg, Gg, Rp, Rp, Rp, Gs, Gs, Gg, Gg, Gg, Gs^Vh, Gs, Gg, Gg, Gs, Gg, Gs, Gg, Gg, Gg^Es, Gg, Gs, Gs^Fms, Gs, Gs, Gs, Gll, Gs, Gs, Gs, Gs^Fms, Gs^Fms, Gs, Gg
Hh, Hh^Fms, Hh, Hh^Fms, Hh, Gs, Gs, Gg, Gs, Gg, Gg, Gs^Vh, Gg, Gg, Re^Gvs, Re^Gvs, Re^Gvs, Re^Gvs, Re^Gvs, Re^Gvs, Re^Gvs, Re^Gvs, Re^Gvs, Gg, Gg, Re^Gvs, Gg, Gg, Gg, Gs, Gg, Rp, Rp, Rp, Gg, Gg, Gs^Fms, Gg^Fet, Gg, Gg, Gg, Gs^Es, Gs, Gg, Gs, Gg^Es, Gg, Gg, Gg, Gg, Gg, Gs, Gg^Es, Gg, Gs, Gs^Fms, Gg, Gg, Gg, Gs, Gs, Gs, Gg
Hh^Fms, Hh, Hh^Fms, Hh^Fms, Hh, Hh, Gs, Gg, Gs, Gs, Gg, Gg, Re^Gvs, Re^Gvs, Re^Gvs, Re^Gvs, Re^Gvs, Re^Gvs, Re^Gvs, Re^Gvs, Re^Gvs, Re^Gvs, Re^Gvs, Re^Gvs, Gg, Gg, Gs, Gs, Gg, Gs, Gg, Rp, Rp, Rp, Gs, Gg, Gs, Gs^Fms, Gg, Gs, Gg^Es, Gg, Gs, Gs, Gs, Gs, Gs, Gs, Gs, Gg, Gg, Gg, Gg, Gg^Es, Gg, Gs, Gg, Gg, Gg, Gg, Gg, Gg, Gg
Hh^Fms, Hh, Hh, Hh, Gs^Fms, Gs^Fms, Gs, Gs, Gg, Gg, Re^Gvs, Gg, Gg, Re^Gvs, Re^Gvs, Re^Gvs, Re^Gvs, Re^Gvs, Re^Gvs, Re^Gvs, Re^Gvs, Re^Gvs, Gg, Gg, Gg, Gg, Gs^Es, Gg, Gg, Gg, Gg, Rp, Rp, Rp, Gs, Gs, Gg, Gs, Gg, Gs, Gg, Gs, Hh, Hh, Hh, Hh^Vhh, Gs, Gg, Gg, Gs^Efm, Gg^Efm, Gg^Efm, Gg, Gs^Vh, Gg, Gg, Gs, Gs^Efm, Gg^Efm, Gs, Gg, Gg, Gg
Hh^Fms, Hh, Gs^Fms, Hh, Gs, Gs, Gg, Gg, Re^Gvs, Re^Gvs, Re^Gvs, Re^Gvs, Re^Gvs, Gg, Gg, Gs^Vh, Re^Gvs, Re^Gvs, Re^Gvs, Re^Gvs, Gg, Gg, Gs, Gg, Gs, Gg, Gs, Gs, Gs, Gs, Gg, Rp, Rp, Rp, Gg, Gg, Gg, Gg^Es, Gg, Gs, Gg, Gs, Hh, Hh, Hh, Hh, Gg, Gg, Gg, Gg, Gs, Gs^Efm, Gg, Gs, Gs, Gg, Gg, Gs^Efm, Gs, Gg, Gg^Efm, Gs, Gg
Hh, Hh, Gs^Fms, Gs, Gg, Gg, Re^Gvs, Re^Gvs, Re^Gvs, Re^Gvs, Re^Gvs, Re^Gvs, Re^Gvs, Re^Gvs, Re^Gvs, Gg, Gg, Re^Gvs, Gg, Gg, Gs, Gs, Gg, Gg^Es, Gs, Gg, Gg, Gs, Gg^Es, Gs, Gg, Rp, Rp, Rp, Gg, Gg^Es, Gg, Gs, Gg, Gg, Gg, Gs, Gs, Hh, Hh, Gs, Gg, Gg, Gs, Gg, Gg, Gs, Gg, Gs, Gg^Fet, Gs, Gg, Gg, Gg, Gg^Efm, Gg, Gg, Gs
Hh^Fms, Gs^Fms, Gll, Gs, Gg, Gs^Vh, Re^Gvs, Re^Gvs, Re^Gvs, Re^Gvs, Re^Gvs, Re^Gvs, Re^Gvs, Re^Gvs, Re^Gvs, Re^Gvs, Gg, Gg, Gg, Gg, Gg, Gg, Gg, Gs, Gs^Fms, Gs, Gg, Gg, Gg, Gg, Gg, Rp, Rp, Rp, Gg, Gg^Es, Gg, Gs, Gg, Gs, Gg, Gg, Gg, Hh, Gs, Gs, Gg, Gs, Gg^Es, Gg, Gs, Gg, Gs, Gg, Gg, Gs^Fms, Gs, Gg, Gg, Gs^Efm, Gg, Gg^Efm, Gg
Hh^Fms, Hh, Gs^Fms, Gs, Gg, Gs, Gg, Re^Gvs, Re^Gvs, Re^Gvs, Re^Gvs, Re^Gvs, Re^Gvs, Re^Gvs, Gg, Gg, Gs, Gg, Gg^Es, Gs, Gs, Gg, Gg, Gs^Fms, Gg, Gs^Fms, Gs, Gs, Gg, Gs, Gg, Rp, Rp, Rp, Gg, Gg, Gg, Gs, Gg, Gs, Gg, Gg, Gg, Gg, Gg^Es, Gg, Gg, Gg, Gg, Gg, Gg, Gg, Gs, Gs^Fms, Gs^Fms, Gs^Fms, Gs, Gg, Gg, Gg^Efm, Gg, Gg^Efm, Gs
Hh^Fms, Hh^Fms, Gs^Fms, Gs, Gs, Gg, Gg, Gg, Gg, Re^Gvs, Re^Gvs, Re^Gvs, Gg, Gg, Gg, Gs, Gs, Gg, Gg, Gs, Gg, Gg, Gs, Gg, Gg, Gg, Gs^Fms, Gs^Fms, Gg, Gs, Gg, Rp, Rp, Rp, Gs, Gg, Gs, Gs, Gs, Gg^Cov, Gg^Cov, Gg, Gs, Gg, Gs, Gg, Gg, Gg, Gs, Gg, Gg, Gg, Gg, Gs, Gg, Gs, Gg, Gs, Gg, Gg, Gg, Gs, Gg
Gs^Fms, Gs^Fms, Gll, Gs^Fms, Gs, Gg, Gg, Gg, Gs, Gg, Gg, Gg, Gs, Gg, Gs, Gg, Gg, Gg, Gg, Gs, Gg, Gs, Gs^Vh, Gs^Fms, Gg^Fet, Gg, Gg, Gs, Gg, Gg, Gs, Rp, Rp, Rp, Gs, Gg, Gs^Cov, Gg^Cov, Gg, Gs^Cov, Gg, Gg, Gs^Cov, Gg, Gg, Gs^Es, Gg, Gg, Gg, Gg, Gs, Gg^Es, Gg, Gg, Gg, Gg, Gs, Gg, Gs, Gs, Gs, Gg, Gg
Gs^Fms, Gll, Gll, Gll, Gs^Fms, Gs, Gg^Es, Gg, Gg, Gs, Gg, Gg, Gg, Gg, Gg^Efm, Gg, Gg^Efm, Gs^Efm, Gs, Gg, Gg, Gs^Fms, Gg, Gg, Gs, Gs, Gs^Fms, Gs, Gg, Gs, Gs, Rp, Rp, Rp, Gg, Gs, Gg, Gg^Cov, Gs^Cov, Gs^Cov, Gg^Cov, Gg^Cov, Gg^Cov, Gs, Gg, Gs^Es, Gs, Gs, Gg, Gg, Gg, Gs, Gs, Gs, Gs, Gs, Gg, Gg, Gg^Es, Gg, Gs^Es, Gg, Gg
Gs^Fms, Gs^Fms, Gll, Gs^Fms, Gs, Gs, Gg, Gg, Gs, Gg, Gs, Gg, Gs, Gg^Efm, Gs, Gg, Gg^Efm, Gs^Efm, Gg, Gs, Gg^Es, Gs, Gs, Gs^Fms, Gs^Fms, Gg, Gs, Gg, Gg, Gs, Gg, Rp, Rp, Rp, Gg, Gg, Gg, Gg, Gg^Cov, 2 Gg^Kov, Gg^Cov, Gg, Gs, Gs, Gs, Gg, Gg, Gg, Gg, Gs, Gg, Gg, Gg, Gs, Gg, Gg, Gs, Gg, Gs^Vh, Gg, Gs, Gg, Gs
Gs^Fms, Gs, Gs, Gs^Fms, Gs, Gg, Gg, Gs, Gg^Es, Gg^Es, Gg, Gs, Gs, Gg, Gg^Efm, Gg, Gs^Efm, Gg, Gs, Gg, Gs, Gg, Gg, Gs, Gg, Gs, Gg, Gg, Gg, Gg, Gg, Rp, Rp, Rp, Gg, Gg, Gs^Cov, Gs^Cov, Gg, Gs^Cov, Gg, Gg^Cov, Gg^Cov, Gg, Gg, Gg, Gg, Gg, Gg^Es, Gs, Gg, Gs, Gg, Gg, Gg, Gg, Gs^Es, Gs, Gg, Gg, Gg, Gg, Gg
Gs, Gs, Gs, Gs, Gs, Gs, Gg, Gg, Gg, Gs, Gs, Gs, Gg, Gg^Efm, Gg, Gg, Gg^Efm, Gs, Gs, Gg, Gg, Gg, Gs^Es, Gg, Gs, Gg, Gg, Gg, Gs, Gs, Gg, Rp, Rp, Rp, Gg, Gg, Gs, Gg^Cov, Gs, Gg^Cov, Gg, Gg^Cov, Gs, Gs, Gg, Gs, Gg, Gg, Gs, Gs, Gg^Es, Gs, Gg, Gg, Gs, Gs, Gs^Es, Gs, Gg, Gs, Gg, Gg, Gs^Es
Gg, Gs, Gs, Gg, Gs, Gg, Gg, Gg, Gs, Gg, Gg, Gg, Gg, Gs, Gg, Gg^Efm, Gs, Gg, Gs, Gg, Gs, Gs, Gg, Gg, Gg, Gs, Gg, Gs, Gg, Gg, Gg, Rp, Rp, Rp, Gg, Gg, Gg, Gs, Gg, Gg, Gs, Gs, Gg, Gg, Gg, Gg, Gs, Gg, Gg, Gg, Gg, Gg, Gg, Gg, Gg, Gg, Gg, Gg, Gg, Gs, Gs, Gg, Gg
