Mm, Mm, Mm, Mm, Mm, Mm, Mm, Mm, Mm, Mm, Mm, Mm, Mm, Mm, Mm, Mm, Mm, Mm, Mm, Mm, Mm, Mm, Mm, Mm, Mm, Mm, Mm, Mm, Mm, Mm, Mm, Mm, Mm, Mm, Mm, Mm, Mm, Mm, Mm, Mm, Mm, Mm, Mm, Mm, Mm, Mm, Mm, Mm, Mm, Mm, Mm
Mm, Mm, Mm, Mm, Mm, Mm, Mm, Mm, Mm, Mm, Mm, Mm, Mm, Mm, Mm, Mm, Mm, Mm, Mm, Mm, Ms^Xm, Mm, Mm, Mm, Ms^Xm, Mm, Ms^Xm, Ms^Xm, Ms^Xm, Ms^Xm, Ms^Xm, Ms^Xm, Ms^Xm, Mm, Ms^Xm, Mm, Mm, Mm, Ms^Xm, Ms^Xm, Ms^Xm, Mm, Ms^Xm, Mm, Ms^Xm, Mm, Mm, Mm, Mm, Mm, Mm
Mm, Mm, Mm, Mm, Mm, Mm, Mm, Mm, Mm, Mm, Mm, Mm, Mm, Mm, Mm, Mm, Ms^Xm, Ms^Xm, Ms^Xm, Ms^Xm, Ms^Xm, Ms^Xm, Ms^Xm, Ms^Xm, Ms, Ms^Xm, Ms, Ms, Ms, Ms, Ms, Ms, Ms, Ms^Xm, Ms^Xm, Ms^Xm, Ms^Xm, Ms^Xm, Ms, Ms, Ms, Ms^Xm, Ms, Ms^Xm, Ms, Ms^Xm, Ms^Xm, Ms^Xm, Ms^Xm, Mm, Mm
Mm, Mm, Mm, Mm, Mm, Mm, Mm, Mm, Mm, Mm, Mm, Mm, Mm, Mm, Mm, Mm, Ms^Xm, Ms^Xm, Ms, Ms, Ms, Ms, Ms, Ms, Ms, Ms, Ms, Ms, Ms, Ms, Ms, Ms, Ms, Ms, Ms, Ms, Ms, Ms, Ms, Ms, Ms, Ms, Ms, Ms, Ms, Ms, Ms, Ms^Xm, Ms^Xm, Mm, Mm
Mm, Mm, Mm, Mm, Mm, Mm, Ms^Xm, Ms^Xm, Ms^Xm, Ms^Xm, Ms^Xm, Mm, Mm, Mm, Mm, Ms^Xm, Ms, Ms, Ms, Ms, Ms, Ms, Ms, Ms, Ms, Ha, Ha^Fma, Ms, Ms, Ms, Ha^Fma, Ms, Ms, Ms, Ha, Ms, Ms, Ms, Ms, Ms, Ha^Fma, Ms, Ms, Ms, Ms, Ms, Ms, Ms, Ms, Ms^Xm, Mm
Mm, Mm, Mm, Mm, Ms^Xm, Ms^Xm, Ms, Ms^Xm, Ms, Ms, Ms^Xm, Mm, Mm, Mm, Ms^Xm, Ms^Xm, Ms, Ms, Ms, Ms, Ms, Ms, Ms, Ms, Ha, Ha^Fma, Ha^Fma, Ha^Fma, Ha^Fma, Ha, Ha^Fma, Ha^Fma, Ha^Fma, Ha^Fma, Ha^Fma, Ha^Fma, Ha^Fma, Ms, Ha^Fma, Ha^Fma, Ha, Ha, Ha^Fma, Ha^Fma, Ha, Ha^Fma, Ha^Fma, Ms, Ms, Ms^Xm, Ms^Xm
Mm, Mm, Mm, Mm, Ms^Xm, Ms^Xm, Ms, Ms, Ms, Ms, Ms, Ms^Xm, Ms^Xm, Ms^Xm, Ms, Ms, Ms, Ms, Ms, Ms, Ha^Fma, Ms, Ms, Ms, Ha^Fma, Ha^Fma, Aa, Ha, Aa^Fma, Ha^Fma, Aa^Fma, Aa^Fma, Aa, Ha, Aa^Fma, Ha, Ha, Ha^Fma, Ha^Fma, Ha, Aa, Ha^Fma, Aa^Fma, Ha, Ha, Ha^Fma, Ha^Fma, Ms, Ms, Ms^Xm, Mm
Mm, Mm, Mm, Mm, Ms^Xm, Ms, Ms, Ms, Ms, Ms, Ms, Ms, Ms, Ms, Ms, Ms, Ms, Ms, Ms, Ms, Ha^Fma, Ha^Fma, Ha^Fma, Ha^Fma, Ha, Aa, Aa, Aa^Fma, Aa^Fma, Aa^Fma, Aa^Fma, Aa^Fma, Aa^Fma, Aa, Aa^Fma, Aa, Aa^Fma, Aa^Fma, Aa^Fma, Aa^Fma, Aa^Fma, Aa^Fma, Aa, Aa^Fma, Aa^Fma, Ha^Fma, Ms, Ms, Ms, Ms^Xm, Mm
Mm, Mm, Mm, Ms^Xm, Ms^Xm, Ms, Ms, Ms, Ms, Ms, Ms, Ms, Ms, Ms, Ms, Ms, Ms, Ha, Ha, Ha^Fma, Ha, Aa^Fma, Aa^Fma, Aa^Fma, Aa^Fma, Aa, Aa^Fma, Aa, Aa, Aa, Aa, Aa^Fma, Aa, Aa^Fma, Aa, Aa^Fma, Aa, Aa^Fma, Aa^Fma, Aa^Fma, Aa, Aa^Fma, Aa, Aa^Fma, Ha, Ha^Fma, Ms, Ms, Ms, Ms^Xm, Ms^Xm
Mm, Mm, Ms^Xm, Ms^Xm, Ms, Ms, Ms, Ms, Ai, Ms, Ms, Ms, Ms, Ms, Ms, Ms, Ms, Ms, Ha^Fma, Ha^Fma, Aa, Aa^Fma, Aa^Fma, Aa^Fma, Aa, Aa^Fma, Aa, Aa, Aa, Aa, Qxua^Cov, Qxua^Cov, Qxua^Cov, Aa, Aa, Aa, Aa, Aa, Aa, Aa^Fma, Aa^Fma, Aa, Aa, Aa^Fma, Ha^Fma, Ha^Fma, Ha, Ms, Ms, Ms^Xm, Mm
Mm, Mm, Ms^Xm, Ms^Xm, Ms, Ms, Ms, Ai, Ai, Ha, Ms, Ms, Ms, Ms, Ms, Ms, Ms, Ms, Ha^Fma, Aa^Fma, Aa^Fma, Aa^Fma, Aa, Aa, Aa^Fma, Aa, Aa, Aa, Aa^Fma, Qxua^Cov, Aa, Qxua^Cov, Aa, Qxua^Cov, Aa^Fma, Aa, Aa, Aa, Aa, Aa, Aa, Aa, Aa^Fma, Ha, Ha^Fma, Ha, Ms, Ms, Ms^Xm, Ms^Xm, Mm
Mm, Mm, Mm, Ms^Xm, Ms, Ms, Ms, Ha^Fma, Ai, Ha, Ha^Fma, Ms, Ms, Ms, Ms, Ms, Ms, Ms, Ha, Aa, Aa^Fma, Aa^Fma, Aa, Aa^Fma, Aa^Fma, Aa, Aa, Aa, Aa, Qxua^Cov, Aa^Cov, 2 Aa^Kov, Aa^Cov, Qxua^Cov, Aa, Aa, Aa^Fma, Aa, Aa, Aa, Aa, Aa^Fma, Aa, Ha^Fma, Ha^Fma, Ms, Ms, Ms, Ms^Xm, Ms^Xm, Mm
Mm, Mm, Mm, Ms^Xm, Ms^Xm, Ms, Ms, Ha^Fma, Ha^Fma, Ai, Ha, Ha^Fma, Ha^Fma, Ms, Ms, Ms, Ms, Ms, Ha^Fma, Ha^Fma, Aa, Aa^Fma, Aa, Aa^Fma, Aa, Aa, Aa, Aa, Aa, Aa, Aa, Aa^Cov, Aa, Aa, Aa, Aa, Aa^Fma, Aa^Fma, Aa, Aa, Aa, Aa^Fma, Aa^Fma, Ha, Ha, Ms, Ms, Ms, Ms^Xm, Mm, Mm
Mm, Mm, Mm, Mm, Ms^Xm, Ms, Ms, Ms, Ha^Fma, Ai, Aa^Fma, Ha^Fma, Ha^Fma, Ms, Ha^Fma, Ms, Ms, Ms, Ha^Fma, Ha^Fma, Aa^Fma, Aa^Fma, Aa^Fma, Aa, Aa, Aa, Aa^Fma, Aa, Aa, Aa, Aa, Aa, Aa, Aa, Aa, Aa, Aa, Aa^Fma, Aa, Aa, Aa, Aa^Fma, Aa^Fma, Aa, Ha, Ha^Fma, Ha^Fma, Ms, Ms, Ms^Xm, Mm
Mm, Mm, Ms^Xm, Ms^Xm, Ms, Ms, Ms, Ha, Ha^Fma, Ai, Ai, Aa^Fma, Aa^Fma, Ha^Fma, Aa^Fma, Ha^Fma, Ha^Fma, Ha, Ha, Aa^Fma, Aa^Fma, Aa^Fma, Aa, Aa, Aa, Aa, Rrc, Aa, Rrc, Aa, Rrc, Aa, Aa, Aa, Aa, Aa, Aa^Fma, Aa^Fma, Aa, Aa, Aa, Aa, Aa, Aa^Fma, Aa^Fma, Ha^Fma, Ha^Fma, Ms, Ms, Ms^Xm, Mm
Mm, Mm, Ms^Xm, Ms, Ms, Ms, Ha^Fma, Ha, Aa^Fma, Aa^Fma, Ai, Aa^Fma, Aa, Aa^Fma, Aa, Ha^Fma, Aa^Fma, Ha^Fma, Aa, Aa^Fma, Aa, Aa, Aa, Aa, Rrc, Rrc, Aa, Rrc, Aa, Rrc, Aa, Rrc, Rrc, Aa, Aa^Fma, Aa, Aa, Aa^Fma, Aa, Aa, Aa, Aa, Aa, Aa^Fma, Ha, Ha^Fma, Ms, Ms, Ms^Xm, Ms^Xm, Mm
Mm, Mm, Mm, Ms^Xm, Ms, Ms, Ms, Ha^Fma, Ha, Aa^Fma, Aa, Ai, Ai, Aa^Fma, Aa^Fma, Aa, Aa^Fma, Aa^Fma, Aa^Fma, Aa^Fma, Aa, Aa, Aa^Fma, Rrc, Aa, Aa, Aa, Aa^Fma, Aa, Aa, Aa, Aa, Aa^Fma, Rrc, Rrc, Aa, Aa, Aa, Aa, Aa, Aa^Fma, Aa^Fma, Aa^Fma, Ha, Ha^Fma, Ha^Fma, Ms, Ms^Xm, Ms^Xm, Mm, Mm
Mm, Mm, Mm, Ms^Xm, Ms^Xm, Ms, Ms, Ms, Ha^Fma, Aa, Aa^Fma, Aa, Aa, Ai, Aa, Aa^Fma, Aa^Fma, Aa^Fma, Aa, Aa, Aa, Aa^Fma, Aa^Fma, Rrc, Aa, Aa, Aa, Aa, Aa, Aa, Aa, Aa, Aa, Aa, Aa, Rrc, Aa, Aa, Aa, Aa, Aa, Aa, Ha, Ha^Fma, Ha^Fma, Ms, Ms^Xm, Ms^Xm, Mm, Mm, Mm
Mm, Mm, Mm, Ms^Xm, Ms^Xm, Ms, Ms, Ha^Fma, Ha, Aa^Fma, Aa^Fma, Aa, Aa, Ai, Aa, Aa, Aa, Aa, Rrc, Aa, Aa, Aa^Fma, Rrc, Rrc, Aa, Aa, Aa, Aa, Aa, Aa, Aa, Aa, Aa, Aa, Rrc, Rrc, Aa, Aa, Aa, Aa, Aa^Fma, Aa, Ha^Fma, Ha^Fma, Ms, Ms, Ms, Ms^Xm, Ms^Xm, Mm, Mm
Mm, Mm, Mm, Mm, Ms^Xm, Ms, Ms, Ha^Fma, Ha, Aa, Aa^Fma, Aa, Aa, Ai, Ai, Aa, Rrc, Rrc, Aa, Rrc, Rrc, Rrc, Aa, Aa, Aa, Aa, Aa, Aa^Fma, Aa^Fma, Aa^Fma, Aa^Fma, Aa, Aa, Aa, Rrc, Aa, Aa, Aa, Aa, Aa, Aa^Fma, Aa^Fma, Ha^Fma, Ha, Ms, Ms, Ms, Ms, Ms^Xm, Mm, Mm
Mm, Mm, Ms^Xm, Ms^Xm, Ms, Ms, Ha, Ha^Fma, Aa^Fma, Aa^Fma, Aa, Aa, Aa, Aa, Rrc, Ai^Bsb/, Ai, Aa, Aa, Aa, Aa, Aa, Aa, Aa, Aa, Aa, Aa, Aa, Aa, Aa^Fma, Aa, Aa^Fma, Aa^Fma, Aa, Rrc, Aa, Aa^Fma, Aa^Fma, Aa, Aa, Aa^Fma, Aa, Ha, Ha^Fma, Ha^Fma, Ms, Ha, Ms, Ms, Ms^Xm, Mm
Mm, Mm, Ms^Xm, Ms, Ms, Ha, Ha^Fma, Ha^Fma, Aa, Aa^Fma, Aa, Aa, Aa, Aa, Rrc, Aa, Ai, Aa, Ai, Ai, Ai, Aa, Aa, Aa, Aa, Aa, Aa, Aa, Aa, Aa, Aa, Aa^Fma, Aa, Aa, Rrc, Aa, Aa, Aa^Fma, Aa, Aa, Aa, Aa^Fma, Aa^Fma, Ha, Ha^Fma, Ha^Fma, Ha^Fma, Ms, Ms, Ms^Xm, Mm
Mm, Ms^Xm, Ms, Ms, Ha^Fma, Ha^Fma, Ha, Aa^Fma, Aa^Fma, Aa^Fma, Aa, Aa, Aa, Aa, Rrc, Aa, Aa, Ai, Aa, Aa, Aa, Ai, Ai, Aa, Ai, Aa, Aa, Aa, Aa, Aa, Aa, Aa, Aa, Aa, Aa, Rrc, Aa, Aa^Fma, Aa, Aa, Aa, Aa^Fma, Aa^Fma, Aa, Aa^Fma, Ha, Ha^Fma, Ms, Ms, Ms^Xm, Mm
Ms^Xm, Ms^Xm, Ms, Ms, Ha^Fma, Ha, Aa^Fma, Aa, Aa^Fma, Aa, Aa, Aa, Aa, Aa, Rrc, Aa, Aa, Aa, Aa^Fma, Aa, Aa, Ai, Ai, Ai, Ai, Ai, Aa, Aa, Ai, Ai, Ai, Aa, Aa, Aa, Aa, Rrc, Rrc, Aa, Aa, Aa, Aa, Aa^Fma, Aa, Aa^Fma, Ha, Ha, Ha^Fma, Ms, Ms^Xm, Ms^Xm, Mm
Mm, Ms^Xm, Ms, Ha^Fma, Ha^Fma, Ha, Aa, Aa^Fma, Aa^Fma, Aa, Aa, Aa, Aa, Aa, Rrc, Aa, Aa, Aa^Fma, Aa^Fma, Aa, Ai, Ai, Ai, Ai, Ai, Ai, Ai, Ai, Ai, Ai, Ai, Ai, Aa, Aa, Aa, Aa, Aa, Rrc, Aa, Aa, Aa, Aa^Fma, Aa^Fma, Ha^Fma, Ha^Fma, Ha^Fma, Ms, Ms, Ms^Xm, Mm, Mm
Mm, Ms^Xm, Ms, Ha, Ha, Ha^Fma, Aa^Fma, Aa^Fma, Aa^Fma, Aa, Aa, Aa, Aa, Aa, Rrc, Aa, Aa, Aa^Fma, Aa, Aa, Ai, Ai, Ai, Ai, Ai, Ai, Ai, Ai, Ai, Ai, Ai, Ai, Aa, Aa, Aa, Aa, Aa, Rrc, Aa, Aa, Aa^Fma, Aa^Fma, Ha, Ha^Fma, Ms, Ms, Ms, Ms, Ms^Xm, Mm, Mm
Mm, Ms^Xm, Ms^Xm, Ms, Ms, Ha^Fma, Aa, Aa^Fma, Aa, Aa^Fma, Aa, Aa, Aa, Aa, Rrc, Aa, Aa, Aa, Aa, Aa, Ai, Ai, Ai, Ai, Ai, Ai, Ai, Ai, Ai, Ai, Ai, Ai, Aa, Aa, Aa^Fma, Aa, Aa, Rrc, Aa, Aa, Aa^Fma, Aa, Ha, Ha^Fma, Ms, Ms, Ms^Xm, Ms^Xm, Mm, Mm, Mm
Mm, Mm, Ms^Xm, Ms, Ms, Ha, Ha^Fma, Aa, Aa^Fma, Aa^Fma, Aa^Fma, Aa, Aa, Aa, Rrc, Aa, Aa, Aa, Aa^Fma, Aa, Ai, Ai, Ai, Ai, Aa^Fpa, Aa^Fpa, Aa^Fpa, Ai, Ai, Ai, Ai, Ai, Aa, Aa, Aa, Aa, Aa, Rrc, Aa, Aa^Fma, Aa^Fma, Ha, Ha^Fma, Ms, Ms, Ms, Ms^Xm, Mm, Mm, Mm, Mm
Mm, Mm, Ms^Xm, Ms, Ms, Ms, Ha^Fma, Ha^Fma, Aa, Aa^Fma, Aa^Fma, Aa, Aa, Aa, Rrc, Aa, Aa, Aa, Aa^Fma, Aa, Aa, Ai, Ai, Ai, Ai, Aa^Fpa, Ai, Ai, Ai, Ai, Ai, Aa, Aa, Aa, Aa, Aa, Aa, Rrc, Aa, Aa^Fma, Aa^Fma, Aa, Ha, Ha^Fma, Ms, Ms, Ms, Ms^Xm, Ms^Xm, Mm, Mm
Mm, Mm, Mm, Ms^Xm, Ms, Ms, Ha^Fma, Ha^Fma, Ha^Fma, Aa^Fma, Aa^Fma, Aa, Aa, Aa, Rrc, Aa, Aa, Aa, Aa, Aa^Fma, Aa, Ai, Ai, Ai, Ai, Ai, Ai, Ai, Ai, Ai, Aa, Aa, Aa, Aa, Aa, Aa, Aa, Rrc, Aa, Aa^Fma, Aa^Fma, Aa, Aa, Ha^Fma, Ha^Fma, Ms, Ms, Ms, Ms^Xm, Mm, Mm
Mm, Mm, Mm, Ms^Xm, Ms, Ms, Ms, Ha, Ha^Fma, Aa, Aa^Fma, Aa, Aa, Aa, Rrc, Aa, Aa, Aa, Aa, Aa, Aa^Fma, Aa, Ai, Ai, Ai, Ai, Ai, Ai, Ai, Aa, Aa^Fma, Aa, Aa, Aa, Aa, Aa, Aa, Rrc, Aa, Aa, Aa, Aa^Fma, Aa^Fma, Aa^Fma, Ha, Ha^Fma, Ha^Fma, Ms, Ms^Xm, Mm, Mm
Mm, Mm, Mm, Ms^Xm, Ms, Ms, Ha, Ha, Ha^Fma, Aa, Aa^Fma, Aa, Aa, Aa, Rrc, Aa, Aa, Aa, Aa, Aa, Aa, Aa, Aa, Ai, Ai, Ai, Ai, Ai, Aa, Aa, Aa, Aa, Aa, Aa, Aa, Aa, Aa, Rrc, Aa, Aa^Fma, Aa, Aa, Aa^Fma, Aa^Fma, Aa^Fma, Ha, Ha, Ms, Ms, Ms^Xm, Mm
Mm, Mm, Mm, Ms^Xm, Ms, Ha, Ha^Fma, Ha^Fma, Aa^Fma, Aa^Fma, Aa^Fma, Aa, Aa, Aa, Rrc, Aa, Aa, Aa, Aa, Aa^Fma, Aa^Fma, Aa^Fma, Aa, Ai, Ai, Ai, Ai, Aa, Aa, Aa, Aa, Aa, Aa, Aa, Aa, Aa, Aa, Rrc, Aa, Aa^Fma, Aa^Fma, Aa^Fma, Aa, Aa, Ha, Ha^Fma, Ha^Fma, Ms, Ms, Ms^Xm, Mm
Mm, Mm, Ms^Xm, Ms^Xm, Ms, Ha, Aa, Aa^Fma, Aa^Fma, Aa, Aa, Aa, Aa, Aa, Aa, Rrc, Rrc, Aa, Aa, Aa, Aa, Aa^Fma, Aa, Ai, Ai, Ai, Aa, Aa, Aa, Aa, Aa, Aa, Aa, Aa, Aa, Aa, Aa, Rrc, Aa, Aa, Aa^Fma, Aa^Fma, Aa, Ha, Ha^Fma, Ha^Fma, Ms, Ms, Ms^Xm, Ms^Xm, Mm
Mm, Mm, Ms^Xm, Ms, Ms, Ha^Fma, Aa, Aa^Fma, Aa^Fma, Aa, Aa, Aa, Aa, Aa, Aa, Aa, Rrc, Aa, Aa, Aa, Aa, Aa, Aa, Ai, Ai, Ai, Aa^Fma, Aa, Aa, Aa, Aa, Aa, Aa, Aa, Aa, Aa^Fma, Aa, Rrc, Aa, Aa^Fma, Aa^Fma, Aa^Fma, Aa^Fma, Ha^Fma, Ms, Ms, Ms, Ms^Xm, Mm, Mm, Mm
Mm, Ms^Xm, Ms, Ms, Ha, Ha^Fma, Aa^Fma, Aa^Fma, Aa^Fma, Aa, Aa, Aa, Aa, Aa, Aa^Fma, Aa, Rrc, Aa, Aa, Aa, Aa, Aa, Aa, Aa, Ai, Aa, Aa^Fma, Aa^Fma, Aa, Aa, Aa, Aa, Rrc, Aa, Aa, Aa, Rrc, Rrc, Aa, Aa^Fma, Aa, Aa, Ha, Ha^Fma, Ms, Ms, Ms^Xm, Ms^Xm, Mm, Mm, Mm
Mm, Ms^Xm, Ms, Ms, Ha^Fma, Ha^Fma, Ha, Aa^Fma, Aa^Fma, Aa, Aa, Aa, Aa, Aa, Aa, Aa, Rrc, Aa, Aa, Aa, Aa, Aa, Aa, Aa, Ai, Aa, Aa, Aa, Aa, Aa, Rrc, Rrc, Aa, Rrc, Rrc, Rrc, Aa, Aa, Aa, Aa^Fma, Aa^Fma, Aa^Fma, Ha^Fma, Ms, Ms, Ms^Xm, Ms^Xm, Mm, Mm, Mm, Mm
Mm, Ms^Xm, Ms^Xm, Ms, Ha, Ha^Fma, Aa, Aa, Aa^Fma, Aa, Aa, Aa, Aa, Aa^Fma, Aa, Rrc, Aa, Aa, Aa, Aa, Aa, Aa, Aa, Aa, Aa, Ai, Ai, Aa, Rrc, Rrc, Aa^Fma, Aa^Fma, Aa, Aa, Aa, Aa, Aa, Aa, Aa, Aa^Fma, Aa^Fma, Aa, Aa^Fma, Ha^Fma, Ms, Ms, Ms^Xm, Mm, Mm, Mm, Mm
Mm, Ms^Xm, Ms^Xm, Ms, Ha, Ha^Fma, Ha^Fma, Aa^Fma, Aa^Fma, Aa^Fma, Aa, Aa, Aa, Aa, Rrc, Rrc, Aa, Aa, Aa, Aa, Aa, Aa, Aa, Aa, Aa, Aa^Fma, Ai, Aa, Rrc, Aa, Aa, Aa^Fma, Aa, Aa, Aa, Aa, Aa, Aa^Fma, Aa^Fma, Aa, Aa^Fma, Aa^Fma, Ha, Ha^Fma, Ms, Ms, Ms^Xm, Mm, Mm, Mm, Mm
Mm, Ms^Xm, Ms^Xm, Ms, Ms, Ha, Ha, Ha^Fma, Aa, Aa^Fma, Aa, Aa, Aa, Aa, Rrc, Aa, Aa, Aa, Aa, Aa, Aa, Aa, Aa, Aa, Aa, Aa, Rrc, Ai^Bsb/, Ai, Ai, Ai, Ai, Ai, Aa, Aa, Aa, Aa, Aa^Fma, Aa, Aa, Aa^Fma, Aa, Ha^Fma, Ha, Ms, Ms, Ms, Ms^Xm, Mm, Mm, Mm
Mm, Ms^Xm, Ms^Xm, Ms, Ms, Ms, Ms, Ha^Fma, Ha^Fma, Aa^Fma, Aa^Fma, Aa, Aa, Aa, Rrc, Aa, Aa, Aa, Aa, Aa, Aa, Aa, Aa, Aa, Rrc, Rrc, Aa, Aa, Aa, Aa, Aa, Aa, Aa, Ai, Ai, Aa, Aa, Aa, Aa, Aa, Aa^Fma, Ha, Ha, Ms, Ms, Ms, Ms, Ms^Xm, Mm, Mm, Mm
Mm, Mm, Ms^Xm, Ms, Ms, Ms, Ms, Ms, Ha^Fma, Ha^Fma, Aa^Fma, Aa^Fma, Aa, Aa, Rrc, Aa, Aa, Aa, Aa, Aa, Aa, Aa, Aa, Rrc, Aa^Fma, Aa, Aa, Aa, Aa, Aa, Aa, Aa, Aa^Fma, Aa, Aa, Ai, Ai, Aa, Aa, Aa^Fma, Aa, Ha, Ha^Fma, Ms, Ms, Ms, Ms, Ms^Xm, Mm, Mm, Mm
Mm, Mm, Mm, Ms^Xm, Ms, Ms, Ms, Ms, Ha^Fma, Aa^Fma, Aa^Fma, Aa, Aa, Aa, Rrc, Aa, Aa, Aa, Aa, Aa, Aa, Aa, Rrc, Rrc, Aa, Aa, Aa, Aa, Aa, Aa, Aa^Fma, Aa^Fma, Aa^Fma, Aa, Aa^Fma, Aa, Aa, Ai, Aa, Aa, Aa^Fma, Aa^Fma, Ha^Fma, Ms, Ms, Ms, Ms, Ms^Xm, Ms^Xm, Mm, Mm
Mm, Mm, Mm, Ms^Xm, Ms, Ms, Ms, Ms, Ha, Cha, Aa, Aa, Aa, Aa, Rrc, Aa, Aa, Aa, Rrc, Aa, Rrc, Rrc, Aa^Fma, Aa, Aa, Aa, Aa^Fma, Aa^Fma, Aa^Fma, Aa^Fma, Aa, Aa, Ha^Fma, Aa, Aa^Fma, Aa, Aa, Ai, Ai, Aa, Aa, Aa^Fma, Aa^Fma, Ha^Fma, Ha^Fma, Ms, Ms, Ms, Ms^Xm, Mm, Mm
Mm, Mm, Ms^Xm, Ms^Xm, Ms, Ms, Ms, Ha^Fma, Kha, Cha, Aa, Aa, Rrc, Rrc, Aa, Rrc, Rrc, Rrc, Aa, Rrc, Aa, Aa^Fma, Aa, Aa, Aa^Fma, Aa^Fma, Aa, Aa, Aa^Fma, Aa^Fma, Ha^Fma, Ha^Fma, Ha^Fma, Ha^Fma, Ha, Aa^Fma, Aa^Fma, Aa^Fma, Aa^Fma, Ai, Ai, Aa^Fma, Aa^Fma, Ha, Ha^Fma, Ms, Ms, Ms, Ms, Ms^Xm, Ms^Xm
Ms^Xm, Ms^Xm, Ms, Ms, Ha^Fma, Ms, Ha^Fma, Ha^Fma, Aa^Fma, Aa, Rrc, Rrc, Aa, Aa, Aa, Aa^Fma, Aa^Fma, Aa, Aa^Fma, Aa, Aa^Fma, Aa, Aa, Aa, Aa^Fma, Aa^Fma, Aa^Fma, Aa, Ha^Fma, Ha, Ha^Fma, Ha^Fma, Ms, Ha, Ha^Fma, Aa, Aa, Aa, Aa^Fma, Aa^Fma, Aa^Fma, Ai, Ai, Aa^Fma, Ai, Ha^Fma, Ha^Fma, Ms, Ms, Ms, Ms
Ms, Ms, Ms, Ms, Ha^Fma, Ha^Fma, Aa^Fma, Aa^Fma, Cea, Aa, Rrc, Aa, Kha, Cha, Cha, Aa^Fma, Aa^Fma, Aa^Fma, Aa^Fma, Aa^Fma, Aa^Fma, Aa, Aa^Fma, Aa^Fma, Aa, Aa, Ha, Ha^Fma, Ha, Ha^Fma, Ms, Ms, Ms, Ms, Ha, Ha^Fma, Ha, Aa^Fma, Aa^Fma, Aa, Ha^Fma, Aa^Fma, Aa^Fma, Ai, Ha, Ai, Ai, Ai, Ms, Ms, Ms
Ha^Fma, Ha^Fma, Ha, Ha, Aa^Fma, Aa^Fma, Cea, Cea, Cea, Rrc, Aa, Aa, Ha^Fma, Ha, Ha, Aa^Fma, Aa^Fma, Aa^Fma, Aa^Fma, Aa^Fma, Aa, Aa^Fma, Ha^Fma, Ha, Ha^Fma, Ha, Ha^Fma, Ha^Fma, Ms, Ms, Ms, Ms, Ms, Ms, Ms, Ha^Fma, Ha, Ha, Ha^Fma, Ha, Ha^Fma, Ha, Ha^Fma, Ha, Ha^Fma, Ha^Fma, Ms, Ai, Ms, Ms, Ms
Aa^Fma, Ha^Fma, Aa^Fma, Aa^Fma, Aa, Cea, Cea, Ke, Cea, Cea, Ha, Ha^Fma, Ha, Ha^Fma, Ha^Fma, Ha^Fma, Ha^Fma, Ha^Fma, Ha^Fma, Ha^Fma, Ha^Fma, Ha, Ha^Fma, Ha^Fma, Ha^Fma, Ha^Fma, Ha^Fma, Ha, Ms, Ms, Ms, Ms, Ms, Ms, Ms, Ms, Ms, Ha^Fma, Ha^Fma, Ha^Fma, Ms, Ms, Ms, Ha^Fma, Ha^Fma, Ms, Ms, Ms, Ms, Ms, Ms^Xm
Aa, Aa^Fma, Aa, Aa, Rrc, Rrc, Cea, Cea, Aa^Fma, Aa^Fma, Ha^Fma, Ha^Fma, Ms, Ms, Ms, Ha, Ms, Ha, Ms, Ha, Ha^Fma, Ha^Fma, Ms, Ms, Ms, Ms, Ms, Ms, Ms, Ms, Ms, Ms, Ms^Xm, Ms, Ms, Ms, Ms, Ms, Ms, Ms, Ms, Ms, Ms, Ms, Ha^Fma, Ms, Ms, Ms, Ms, Ms^Xm, Mm
Aa, Aa, Rrc, 1 Rrc, Aa, Aa, Aa^Fma, Aa^Fma, Ha^Fma, Ha^Fma, Ms, Ms, Ms, Ms, Ms, Ms, Ms, Ms, Ms, Ms, Ha^Fma, Ms, Ms, Ms, Ms, Ms, Ms, Ms, Ms, Ms, Ms^Xm, Ms^Xm, Mm, Ms^Xm, Ms^Xm, Ms^Xm, Ms^Xm, Ms, Ms^Xm, Ms, Ms, Ms, Ms, Ms, Ms, Ms, Ms, Ms, Ms^Xm, Ms^Xm, Mm
Rrc, Rrc, Aa, Aa, Aa^Fma, Aa^Fma, Ha^Fma, Ha, Ha^Fma, Ms, Ms, Ms, Ms^Xm, Ms, Ms^Xm, Ms, Ms^Xm, Ms, Ms, Ms, Ms, Ms, Ms, Ms, Ms^Xm, Ms^Xm, Ms^Xm, Ms^Xm, Ms^Xm, Ms^Xm, Mm, Mm, Mm, Mm, Mm, Mm, Mm, Ms^Xm, Mm, Ms^Xm, Ms^Xm, Ms, Ms^Xm, Ms, Ms, Ms, Ms, Ms, Ms^Xm, Mm, Mm
Aa, Aa, Aa, Aa^Fma, Ha, Ha^Fma, Ms, Ha, Ms, Ms, Ms^Xm, Ms^Xm, Mm, Ms^Xm, Mm, Ms^Xm, Mm, Ms^Xm, Ms, Ms, Ms, Ms, Ms^Xm, Ms^Xm, Mm, Mm, Mm, Mm, Mm, Mm, Mm, Mm, Mm, Mm, Mm, Mm, Mm, Mm, Mm, Mm, Mm, Ms^Xm, Ms^Xm, Ms^Xm, Ms^Xm, Ms^Xm, Ms, Ms^Xm, Mm, Mm, Mm
