border_size=1
usage=map

Ms, Ms, Ms, Aa, Aa, Aa, Aa, Ms, Ms, Ms, Ms^Xm, Ms, Ms, Aa, Tyb, Aa, Ms, Ms, Ms^Xm, Ms, Aa, Aa, Aa, Aa, Tyb, Aa, Aa, Aa, Ms, Ms, Ms, Aa, Qxua, Aa, Aa, Aa, Aa, Aa, Tyb, Aa, Aa, Aa, Aa, Aa, Aa, Aa, Ms, Aa, Aa, Aa, Aa, Aa, Aa, Ms, Ms, Ms, Ms, Ms, Aa, Tyb, Aa, Tyb, Aa, Ms, Ms, Ms, Ms, Aa, Aa, Qxua, Aa, Aa
Ms, Ms^Xm, Ms, Aa, Tyb, Aa, Aa, Ms, Ms, Ms, Ms, Ms, Aa, Aa, Aa, Ms, Ms^Xm, Ms^Xm, Ms, Ms, Aa, Tyb, Aa, Aa, Aa, Aa, Ms, Ms, Ms, Ms, Ms, Aa, Qxua, Aa, Ms, Aa, Tyb, Tyb, Tyb, 3 Aa, Aa, Tyb, Tyb, Aa, Aa, Aa, Ms, Ms, Ms^Xm, Aa, Aa, Aa, Aa, Ms, Ms, Ms, Ms, Ms, Aa, Aa, Tyb, Tyb, Aa, Ms, Ms, Ms, Ms, Aa, Aa, Qxua, Aa, Aa
Ms, Ms^Xm, Ms, Aa, Aa, Aa, Aa, Aa, Aa, Ms, Ms, Ms, Aa, Tyb, Ms, Ms, Ms^Xm, Ms, Aa, Aa, Tyb, Tyb, Tyb, Tyb, Aa, Ms, Ms, Ms, Ms, Ms, Aa, Qxua, Aa, Aa, Ms, Aa, Tyb, Aa, Aa, Aa, Aa, Aa, Tyb, Tyb, Aa, Aa, Aa, Ms, Ms, Ms, Aa, Aa, Aa, Aa, Ms, Ms^Xm, Ms, Aa, Aa, Aa, Aa, Tyb, Ms, Ms, Ms, Ms, Aa, Aa, Qxua, Qxua, Aa, Aa
Ms, Ms, Ms, Aa, Aa, Ms, Ms, Aa, Tyb, Tyb, Aa, Aa, Aa, Aa, Ms, Ms^Xm, Ms, Ms, Aa, Aa, Tyb, Aa, Aa, Aa, Ms, Ms, Ms, Ms, Ms, Ms, Qxua, Qxua, Aa, Aa, Ms, Ms, Aa, Aa, Aa, Tyb, Aa, Aa, Aa, Tyb, Aa, Aa, Ms, Ms^Xm, Ms, Ms, Aa, Aa, Ms, Ms, Ms, Ms, Ms, Aa, Tyb, Tyb, Aa, Ms, Ms, Ms, Ms, Ms, Ms, Aa, Qxua, Qxua, Ms, Aa
Ms, Ms, Ms, Aa, Aa, Ms, Aa, Tyb, Aa, Aa, Aa, Aa, Tyb, Aa, Ms, Ms, Ms, Aa, Tyb, Aa, Tyb, Aa, Ms, Aa, Ms^Xm, Ms, Ms, Ms, Aa, Aa, Qxua, Aa, Ms, Ms, Ms, Aa, Aa, Aa, Aa, Tyb, Tyb, Aa, Aa, Aa, Aa, Ms, Ms^Xm, Ms, Ms, Aa, Aa, Aa, Ms, Ms^Xm, Ms, Ms, Aa, Aa, Tyb, Tyb, Ms^Xm, Ms, Ms, Ms^Xm, Ms, Ms, Ms, Aa, Qxua, Ms, Ms, Ms
Ms^Xm, Ms, Aa, Tyb, Aa, Aa, Tyb, Aa, Ms, Ms, Ms, Aa, Aa, Tyb, Aa, Ms, Aa, Aa, Aa, Aa, Aa, Ms, Ms^Xm, Ms, Ms, Ms, Ms, Tyb, Aa, Qxua, Aa, Aa, Ms, Ms, Ms, Aa, Aa, Aa, Tyb, Tyb, Tyb, Tyb, Aa, Aa, Aa, Ms, Ms, Ms, Aa, Aa, Aa, Aa, Ms, Ms, Ms^Xm, Ms, Aa, Tyb, Aa, Ms, Ms, Ms, Ms, Ms, Ms, Ms, Aa, Qxua, Aa, Ms, Ms, Ms
Ms^Xm, Ms, Aa, Aa, Tyb, Tyb, Aa, Ms, Ms, Ms^Xm, Ms^Xm, Ms, Ms, Tyb, Aa, Aa, Aa, Aa, Ms, Aa, Aa, Ms, Ms^Xm, Ms, Ms, Ms^Xm, Ms, Aa, Qxua, Aa, Ms, Ms, Ms, Ms^Xm, Ms, Aa, Tyb, Aa, Aa, Aa, Tyb, Aa, Aa, Aa, Aa, Aa, Ms, Ms, Aa, Aa, Aa, Aa, Ms, Ms, Ms, Ms, Aa, Tyb, Tyb, Ms, Ms, Ms, Ms, Ms^Xm, Ms, Ms, Aa, Qxua, Ms, Ms, Ms, Ms
Ms^Xm, Ms, Tyb, Tyb, Aa, Aa, Aa, Ms, Ms, Ms, Ms, Ms^Xm, Ms, Ms, Tyb, Aa, Ms, Ms, Aa, Aa, Ms, Ms^Xm, Ms, Ms, Ms, Ms, Aa, Aa, Qxua, Aa, Ms, Ms, Ms, Ms, Aa, Aa, Tyb, Tyb, Aa, Aa, Aa, Tyb, Tyb, Aa, Aa, Aa, Ms, Ms, Aa, Aa, Aa, Aa, Aa, Ms, Ms, Ms, Ms, Aa, Tyb, Aa, Aa, Ms, Ms, Ms, Aa, Aa, Qxua, Qxua, Ms, Ms, Ms, Ms
Ms, Ms^Xm, Ms, Aa, Aa, Tyb, Tyb, Aa, Aa, Aa, Aa, Ms^Xm, Ms^Xm, Ms, Aa, Aa, Aa, Ms, Aa, Aa, Ms, Ms, Ms, Ms, Aa, Aa, Tyb, Aa, Qxua, Aa, Aa, Ms, Ms, Aa, Aa, Aa, Tyb, Aa, Tyb, Tyb, Tyb, Aa, Tyb, Tyb, Aa, Aa, Aa, Aa, Aa, Aa, Aa, Aa, Aa, Ms, Ms, Ms, Ms, Aa, Tyb, Aa, Aa, Aa, Aa, Aa, Qxua, Aa, Qxua, Aa, Aa, Ms, Ms, Ms
Ms, Ms^Xm, Ms, Ms, Ms, Aa, Aa, Aa, Aa, Tyb, Aa, Ms, Ms, Ms, Ms, Tyb, Tyb, Aa, Aa, Aa, Aa, Ms, Aa, Aa, Aa, Tyb, Aa, Aa, Aa, Qxua, Qxua, Aa, Aa, Aa, Tyb, Aa, Aa, Aa, Aa, Aa, Tyb, Aa, Aa, Tyb, Aa, Aa, Aa, Tyb, Aa, Aa, Aa, Tyb, Tyb, Aa, Aa, Ms, Tyb, Tyb, Aa, Aa, Qxua, Qxua, Aa, Qxua, Aa, Qxua, Aa, Qxua, Qxua, Aa, Qxua, Aa
Ms, Ms, Aa, Ms^Xm, Ms, Aa, Tyb, Aa, Ms, Aa, Tyb, Ms, Ms, Ms, Ms^Xm, Aa, Aa, Aa, Ms, Tyb, Tyb, Aa, Aa, Aa, Aa, Tyb, Aa, Aa, Ms^Xm, Aa, Aa, Aa, Aa, Aa, Aa, Tyb, Aa, Aa^Vaa, Aa, Tyb, Aa, Aa, Aa, Tyb, Aa, Aa, Aa, Aa, Aa^Vaa, Aa, Aa, Aa, Aa, Aa, Aa, Aa, Tyb, Aa, Qxua, Qxua, Aa, Aa, Ms, Aa, Ms, Ms^Xm, Ms, Ms, Ms, Qxua, Aa, Qxua
Aa, Aa, Ms, Ms, Ms, Aa, Aa, Ms, Ms, Ms, Aa, Tyb, Ms, Ms, Ms^Xm, Ms, Ms, Ms^Xm, Ms, Ms, Aa, Tyb, Tyb, Tyb, Aa, Aa, Ms, Ms, Ms^Xm, Ms, Aa, Aa, Qxua, Qxua, Aa, Aa, Tyb, Aa, Aa, Aa, Tyb, Aa, Aa, Tyb, Aa, Aa, Aa, Aa, Aa, Aa, Aa, Aa, Tyb, Aa, Tyb, Aa, Aa, Aa, Aa, Aa, Ms, Ms, Ms, Ms, Ms, Ms, Ms, Ms^Xm, Ms, Ms, Ms, Aa
Aa, Aa, Aa, Ms, Aa, Aa, Aa, Ms, Ms^Xm, Ms, Ms, Tyb, Aa, Ms, Ms, Ms, Ms^Xm, Ms, Ms, Ms, Aa, Aa, Aa, Aa, Aa, Aa, Ms, Ms^Xm, Ms, Ms, Aa, Aa, Qxua, Aa, Aa, Aa, Aa, Aa, Aa, Tyb, Tyb, Aa, Tyb, Aa, Tyb, Aa, Aa, Aa, Aa, Aa, Tyb, Tyb, Aa, Aa, Aa, Aa, Qxua, Tyb, Aa, Aa, Ms, Ms, Ms, Ms, Ms, Ms, Ms, Ms, Ms^Xm, Ms, Ms, Aa
Tyb, Aa, Aa, Aa, Tyb, Tyb, Aa, Ms, Ms^Xm, Ms, Ms, Aa, Tyb, Aa, Aa, Ms, Ms, Ms, Ms, Ms, Aa, Aa, Aa, Aa, Tyb, Aa, Ms, Ms, Aa, Aa, Aa, Aa, Qxua, Aa, Aa, Aa, Aa, Tyb, Aa, Tyb, Aa, Aa, Aa, Aa, Aa, Aa, Tyb, Aa, Tyb, Aa, Tyb, Aa, Aa, Aa, Aa, Aa, Qxua, Aa, Tyb, Aa, Aa, Ms, Ms, Ms, Aa, Aa, Aa, Ms, Ms, Ms, Ms, Ms
Aa, Aa, Aa, Tyb, Aa, Aa, Ms, Ms, Ms, Ms, Ms, Aa, Aa, Aa, Aa, Aa, Aa, Aa, Aa, Aa, Aa, Aa, Aa, Aa, Aa, Aa, Ms, Ms, Aa, Aa, Aa, Qxua, Aa, Aa, Aa, Aa, Aa, Aa, Aa, Aa, Tyb, Aa, Aa, Tyb, Aa, Tyb, Aa, Aa, Aa, Aa, Aa, Tyb, Tyb, Aa, Aa, Aa, Qxua, Aa, Aa, Aa, Aa, Aa, Aa, Aa, Tyb, Tyb, Aa, Aa, Aa, Ms, Ms, Ms
Ms, Ms, Ms, Aa, Ms, Ms, Ms, Ms^Xm, Ms, Ms, Aa, Aa, Tyb, Aa, Ms, Aa, Aa, Tyb, Aa, Aa, Aa, Aa, Aa, Tyb, Aa, Aa, Aa, Aa, Aa, Aa, Aa, Qxua, Qxua, Aa, Aa, Aa, Aa, Aa, Aa, Tyb, Aa, Aa, Tyb, Aa, Aa, Aa, Aa, Aa, Tyb, Aa, Aa, Aa, Tyb, Aa, Aa, Qxua, Aa, Aa, Tyb, Tyb, Aa, Tyb, Aa, Aa, Aa, Tyb, Tyb, Tyb, Tyb, Ms, Ms, Ms
Ms, Ms, Ms, Aa, Ms, Ms, Ms^Xm, Ms^Xm, Ms, Ms, Aa, Aa, Tyb, Aa, Aa, Ms, Aa, Aa, Tyb, Tyb, Tyb, Tyb, Aa, Aa, Aa, Aa^Vaa, Aa, Aa, Aa, Aa, Aa, Aa, Aa, Aa, Qxua, Aa, Aa, Aa, Tyb, Aa, Aa, Aa, Aa, Aa, Tyb, Aa, Aa, Aa, Aa, Aa, Aa, Aa, Tyb, Aa, Aa, Aa, Aa, Aa, Aa, Aa, Ms, Ms, Ms, Ms, Ms, Tyb, Aa, Aa, Tyb, Ms, Ms, Ms
Ms, Ms, Aa, Aa, Aa, Ms, Ms^Xm, Ms, Ms, Aa, Aa, Aa, Aa, Ms, Ms, Ms, Aa, Aa, Aa, Aa, Aa, Aa, Tyb, Aa, Aa, Aa, Aa, Aa, Aa, Tyb, Aa, Aa, Aa, Aa, Aa, Qxua, Qxua, Aa, Aa, Aa, Aa, Tyb, Tyb, Aa, Aa, Tyb, Aa, Tyb, Aa, Aa, Tyb, Tyb, Aa, Aa, Qxua, Aa, Aa, Tyb, Aa, Aa, Ms, Ms, Ms^Xm, Ms, Ms, Ms, Ms, Aa, Aa, Tyb, Aa, Aa
Ms, Ms, Aa, Aa, Ms, Ms, Ms, Ms, Ms, Aa, Tyb, Tyb, Aa, Aa, Ms, Ms, Aa, Tyb, Aa, Aa^Vaa, Aa, Aa, Tyb, Tyb, Aa, Aa, Aa, Aa, Aa, Tyb, Aa, Aa, Aa, Aa, Aa, Aa, Qxua, Aa, Aa, Tyb, Aa, Aa, Aa, Aa, Aa, Tyb, Tyb, Tyb, Tyb, Aa, Aa, Aa, Aa, Qxua, Aa, Aa, Aa, Tyb, Tyb, Aa, Ms, Ms, Ms^Xm, Ms^Xm, Ms^Xm, Ms, Ms, Ms, Aa, Aa, Tyb, Aa
Ms, Ms, Ms, Ms, Ms, Ms, Ms, Ms, Aa, Aa, Tyb, Aa, Aa, Aa, Ms, Ms, Aa, Tyb, Aa, Aa, Tyb, Aa, Aa, Aa, Aa, Tyb, Tyb, Aa, Aa, Aa, Aa, Aa^Vaa, Aa, Aa, Qxua, Qxua, Aa, Aa, Aa, Aa, Aa, Tyb, Aa, Aa, Tyb, Tyb, Aa, Aa, Aa, Tyb, Aa, Aa, Aa, Qxua, Aa, Aa, Aa, Aa, Aa, Aa, Aa, Ms, Ms, Ms, Ms, Ms, Ms, Ms, Aa, Aa, Tyb, Tyb
Ms, Ms, Ms, Ms, Ms, Ms, Ms, Aa, Aa, Aa, Tyb, Aa, Aa, Ms, Ms, Ms, Aa, Tyb, Tyb, Tyb, Tyb, Aa, Aa, Aa, Aa, Aa, Tyb, Aa, Aa, Aa, Aa, Aa, Aa, Aa, Qxua, Aa, Aa, Aa, Aa, Qxu, Qxu, Aa, Aa, Aa, Aa, Tyb, Aa, Aa, Aa, Tyb, Aa, Aa, Aa, Aa, Aa, Aa, Aa, Aa^Vaa, Aa, Tyb, Aa, Aa, Aa, Ms, Aa, Ms, Aa, Aa, Aa, Aa, Aa, Tyb
Ms, Ms, Ms, Ms, Ms, Ms, Aa, Aa, Aa, Tyb, Aa, Aa, Ms, Ms, Ms, Aa, Aa, Aa, Aa, Aa, Aa, Aa, Aa, Aa, Aa, Aa, Aa, Aa, Aa, Aa, Qxua, Qxua, Aa, Aa, Aa, Aa, Aa, Aa, Aa, Qxu, Aa, Aa, Qxu, Aa, Aa, Aa, Tyb, Tyb, Aa, Aa, Aa, Aa, Qxua, Aa, Aa, Aa, Tyb, Tyb, Tyb, Tyb, Aa, Aa, Tyb, Aa, Tyb, Aa, Aa, Aa, Aa, Tyb, Tyb, Tyb
Aa, Aa, Aa, Ms, Aa, Aa, Tyb, Tyb, Aa, Aa, Aa, Ms, Aa, Aa, Aa, Aa, Aa, Qxua, Qxua, Aa, Qxua, Aa, Aa, Tyb, Aa, Tyb, Aa, Aa, Qxua, Aa, Ai, Ai, Ai, Aa, Aa, Aa^Vha, Aa, Aa, Aa, Aa, Aa, Aa, Qxu, Aa, Aa, Aa, Aa, Aa, Aa, Aa, Aa, Aa, Qxua, Aa, Aa, Tyb, Aa, Aa, Tyb, Tyb, Aa, Tyb, Aa, Tyb, Aa, Aa, Aa, Tyb, Aa, Tyb, Tyb, Aa
Aa, Aa, Aa, Aa, Tyb, Tyb, Aa, Aa, Aa, Aa, Qxua, Aa, Qxua, Aa, Aa, Aa, Qxua, Qxua, Aa, Aa, Aa, Qxua, Aa, Aa, Aa, Aa, Aa, Aa, Qxua, Ai, Wwg^Ii, Wwg^Ii, Wwg^Ii, Ai, Aa, Aa, Aa, Aa, Aa, Aa, Aa, Aa, Aa, Qxu, Qxu, Aa, Aa, Aa, Qxua, Qxua, Qxua, Qxua, Aa, Aa, Qxua, Aa, Aa, Aa, Aa, Aa, Aa, Aa, Aa, Aa, Aa, Aa, Aa, Aa, Aa, Aa, Aa, Aa
Qxua, Aa, Aa, Aa, Aa, Aa, Qxua, Qxua, Qxua, Aa, Aa, Qxua, Aa, Qxua, Aa, Aa, Aa, Aa, Tyb, Tyb, Aa, Aa, Aa, Qxua, Qxua, Aa, Aa, Qxua, Aa, Ai, Wwg^Ii, Wwg^Ii, Wwg^Ii, Ai, Wwg, Wwg, Wwg, Wwg, Wwg, Wwg, Wwg, Aa, Aa, Aa, Aa, Aa, Aa, Aa, Aa, Aa, Ai, Ai, Ai, Qxua, Qxua, Qxua, Qxua, Aa, Aa, Aa, Aa, Qxua, Qxua, Aa, Qxua, Qxua, Aa, Aa, Qxua, Aa, Qxua, Qxua
Aa, Qxua, Qxua, Qxua, Aa, Qxua, Aa, Aa, Aa, Aa, Aa, Aa, Ms, Ms^Xm, Ms, Aa, Aa, Tyb, Aa, Aa, Aa, Tyb, Tyb, Aa, Aa, Aa, Qxua, Qxua, Aa, Ai, Wwg, Wwg^Ii, Wwg, Wwg, Wwg, Wwg, Wwg, Wwg, Wwg, Wwg, Wwg, Wwg, Wwg, Aa, Aa, Aa, Aa^Vha, Aa, Aa, Ai, Wwg^Ii, Wwg^Ii, Wwg^Ii, Ai, Aa, Aa, Aa, Aa, Qxua, Qxua, Aa, Aa, Aa, Qxua, Aa, Aa, Aa, Qxua, Aa, Qxua, Aa, Aa
Aa, Aa, Aa, Aa, Aa, Aa, Aa, Aa, Aa, Aa, Ms, Ms^Xm, Ms, Ms, Ms, Aa, Tyb, Aa, Aa, Qxua, Aa, Aa, Aa, Aa, Aa^Vha, Aa, Aa, Aa, Wwg, Wwg, Wwg, Wwg, Wwg, Wwg, Cwr, Kwr, Uue, Wwg, Uue, Kwr, Cwr, Wwg, Wwg, Wwg, Wwg, Aa, Aa, Aa, Aa, Ai, Wwg^Ii, Wwg^Ii, Wwg^Ii, Ai, Aa, Aa, Qxua, Qxua, Aa, Aa, Aa, Aa, Tyb, Aa, Tyb, Aa, Aa, Aa, Tyb, Aa, Tyb, Aa
Ms, Aa, Aa, Tyb, Tyb, Aa, Tyb, Tyb, Aa, Aa, Ms, Ms, Ms, Ms, Aa, Aa, Tyb, Aa, Qxua, Qxua, Aa, Aa, Ai, Aa, Aa, Aa, Aa, Wwg, Wwg, Wwg, Uue, Wwg, Cwr, Wwg, Qxe, Qxe, Uue, Qxe, Uue, Uue, Uue, Wwg, Qxe, Wwg, Cwr, Wwg, Wwg, Aa, Aa, Ai, Wwg, Wwg^Ii, Ai, Ai, Aa, Aa, Qxua, Aa, Aa, Aa, Aa, Tyb, Aa, Aa, Aa, Aa, Tyb, Aa, Tyb, Aa, Aa, Tyb
Ms, Ms, Ms, Aa, Aa, Aa, Tyb, Tyb, Aa, Ms, Ms, Ms^Xm, Ms, Aa, Aa, Aa, Tyb, Aa, Aa, Qxua, Ai, Ai, Wwg^Ii, Ai, Wwg, Wwg, Wwg, Wwg, Wwg, Cwr, Qxe, Qxe, Uue, Qxe, Qxe, Uue, Qxe, Uue, Qxe, Qxe, Qxe, Uue, Qxe, Qxe, Uue, Cwr, Wwg, Wwg, Wwg, Aa, Wwg, Ai, Aa, Aa, Aa, Aa, Aa, Aa, Aa, Aa, Aa, Aa, Aa, Aa^Vaa, Tyb, Aa, Tyb, Aa, Tyb, Tyb, Tyb, Tyb
Ms, Ms, Ms, Aa, Aa, Tyb, Aa, Aa, Aa, Ms, Ms, Ms, Ms, Aa, Tyb, Aa, Tyb, Aa, Aa, Aa, Ai, Wwg^Ii, Wwg^Ii, Wwg^Ii, Ai, Aa, Wwg, Wwg, Kwr, Qxe, Uue, Qxe, Qxe, Qxe, Qxe, Qxe, Uue, Qxe, Qxe, Qxe, Uue^Dr, Qxe, Qxe, Uue, Qxe, Wwg, Kwr, Wwg, Wwg, Wwg, Aa, Aa, Aa, Aa, Aa, Aa, Aa, Tyb, Aa, Aa, Aa, Aa, Tyb, Aa, Tyb, Aa, Tyb, Tyb, Aa, Aa, Aa, Aa
Ms, Ms, Ms, Aa, Aa, Tyb, Aa, Aa^Vaa, Aa, Ms, Ms, Ms, Ms, Tyb, Aa, Tyb, Aa, Aa, Aa, Aa, Ai, Wwg^Ii, Wwg^Ii, Wwg^Ii, Ai, Aa, Wwg, Wwg, Qxe, Uue, Qxe, Qxe, Qxe, Qxe, Qxe, Qxe, Qxe, Qxe, Qxe, Qxe, Qxe, Qxe, Uue^Dr, Uue^Dr, Uue^Dr, Uue, Cwr, Wwg, Wwg, Wwg, Wwg, Aa, Aa, Aa, Qxua, Aa, Aa, Aa, Tyb, Aa, Aa, Aa, Aa, Tyb, Tyb, Aa, Aa, Aa, Aa, Aa, Ms, Ms
Ms, Ms, Ms, Ms, Ms, Aa, Tyb, Aa, Tyb, Aa, Ms, Ms, Ms, Aa, Aa, Aa, Aa, Aa, Qxua, Qxua, Aa, Ai, Ai, Ai, Aa, Aa, Wwg, Wwg, Qxe, Qxe, Qxe, Uue, Qxe, Qxe, Qxe, Uue^Dr, Qxe, 2 Qxe, Qxe, Qxe, Uue^Dr, Qxe, Qxe, Qxe, Qxe, Qxe, Qxe, Wwg, Wwg, Aa, Wwg, Aa, Aa, Aa, Aa, Qxua, Aa, Aa, Aa, Tyb, Aa, Aa, Aa, Aa, Aa, Aa, Aa, Aa, Aa, Ms, Ms, Ms
Ms, Ms, Ms, Ms, Ms, Ms, Aa, Tyb, Aa, Aa, Aa, Ms, Aa, Aa, Qxua, Qxua, Aa, Aa, Qxua, Aa, Aa, Aa, Aa, Aa, Aa, Aa, Wwg, Wwg, Cwr, Qxe, Uue, Qxe, Qxe, Uue^Dr, Qxe, Qxe, Qxe, Qxe, Qxe, Qxe, Qxe, Uue^Dr, Qxe, Uue, Qxe, Qxe, Cwr, Wwg, Wwg, Aa, Ai, Wwg, Ai, Aa, Aa, Qxua, Aa, Aa, Aa, Aa, Tyb, Tyb, Aa, Aa, Aa, Aa, Ms, Aa, Ms, Ms, Ms, Ms
Ms, Ms, Ms, Ms, Ms, Ms, Aa, Aa, Qxua, Aa, Aa, Aa, Aa, Aa, Aa, Aa, Tyb, Aa, Qxua, Aa, Aa, Aa, Aa, Aa, Aa, Wwg, Wwg, Cwr, Uue, Qxe, Qxe, Qxe, Uue^Dr, Qxe, Qxe, Qxe, Qxe, Qxe, Qxe, Qxe, Qxe, Qxe, Qxe, Qxe, Qxe, Qxe, Uue, Cwr, Wwg, Wwg, Wwg^Ii, Wwg^Ii, Wwg^Ii, Ai, Aa, Qxua, Qxua, Aa, Aa, Tyb, Aa, Tyb, Aa, Aa, Aa, Ms, Ms, Ms, Ms, Ms, Ms, Ms
Ms, Ms, Aa, Ms, Qxua, Aa, Qxua, Qxua, Aa, Aa, Qxua, Aa, Qxua, Qxua, Qxua, Aa, Tyb, Aa, Aa, Qxua, Qxua, Aa, Aa, Aa, Aa, Wwg, Wwg, Uue, Uue, Qxe, Qxe, Qxe, Qxe, Qxe, Qxe, Qxe, Qxe, Qxe, Qxua, Qxe, Qxe, Qxe, Qxe, 1 Uue^Dr, Qxe, Uue^Dr, Uue, Cwr, Wwg, Wwg, Wwg^Ii, Wwg^Ii, Wwg^Ii, Ai, Aa, Aa, Aa, Qxua, Aa, Aa, Aa, Tyb, Aa, Aa, Ms, Ms, Ms^Xm, Ms^Xm, Ms^Xm, Ms^Xm, Ms, Ms
Aa, Aa, Qxua, Qxua, Aa, Aa, Aa, Aa, Aa, Aa, Aa, Qxua, Aa, Aa, Aa, Aa, Aa, Aa, Aa, Aa, Aa, Aa, Aa, Aa, Aa, Wwg, Wwg, Uue, Uue, Qxe, Uue^Dr, Qxe, Qxe, Qxe, Qxe, Qxe, Qxe, Qxe, Qxe, Qxe, Qxe, Qxe, Qxe, Uue^Dr, Qxe, Qxe, Qxe, Cwr, Wwg, Ai, Ai, Wwg^Ii, Ai, Ai, Aa, Aa, Aa, Qxua, Aa, Aa, Aa, Tyb, Aa, Aa, Ms, Ms, Ms, Ms^Xm, Ms^Xm, Ms, Ms, Ms
Qxua, Qxua, Aa, Aa, Ms, Ms, Ms, Aa, Qxua, Qxua, Aa, Aa, Aa, Aa, Aa, Aa, Aa, Tyb, Aa, Aa, Aa, Aa, Aa, Aa, Aa, Aa, Wwg, Wwg, Uue, Qxe, Qxe, Qxe, Qxe, Qxe, Qxe, Qxe, Qxe, Qxe, Qxe, Qxe, Qxe, Qxe, Qxe, Uue, Qxe, Qxe, Qxe, Wwg, Wwg, Aa, Aa, Ai, Aa, Aa, Aa, Aa, Aa, Aa, Tyb, Aa, Tyb, Aa, Aa, Aa, Ms, Ms, Ms, Ms, Ms, Ms^Xm, Ms, Ms
Aa, Aa, Aa, Tyb, Ms, Ms, Ms, Aa, Aa, Aa, Aa, Tyb, Aa, Aa, Tyb, Aa, Aa, Tyb, Aa, Aa, Aa, Aa, Qxua, Aa, Aa, Aa, Wwg, Wwg, Uue, Qxe, Qxe, Uue^Dr, Qxe, Qxe, Uue^Dr, Qxe, Qxe, Qxe, Qxe, Qxe, Uue^Dr, Qxe, Qxe, Qxe, Qxe, Qxe, Cwr, Wwg, Aa, Aa, Aa^Vha, Aa, Aa, Aa, Aa, Aa, Qxua, Aa, Aa, Aa, Aa, Aa, Tyb, Aa, Aa, Ms, Ms, Ms, Ms, Ms^Xm, Ms, Ms
Aa, Qxua, Qxua, Aa, Aa, Ms, Qxua, Qxua, Ms, Ms, Ms, Aa, Aa, Aa, Tyb, Tyb, Aa, Tyb, Aa, Aa, Aa, Aa, Qxua, Aa, Aa, Aa, Wwg, Wwg, Kwr, Uue, Qxe, Qxe, Qxe, Qxe, Qxe, Qxe, Qxe, Uue^Dr, Uue^Dr, Qxe, Qxe, Uue^Dr, Uue, Qxe, Qxe, Uue, Kwr, Wwg, Aa, Aa, Aa, Aa, Aa, Aa, Aa, Aa, Qxua, Aa, Aa, Aa, Tyb, Aa, Aa, Aa, Aa, Aa, Aa, Ms, Ms, Ms, Ms, Ms
Aa, Aa, Ms, Qxua, Qxua, Qxua, Aa, Aa, Ms, Ms, Ms^Xm, Ms, Ms, Aa, Aa, Tyb, Tyb, Aa, Tyb, Tyb, Tyb, Aa, Qxua, Aa, Aa, Aa^Vha, Wwg, Wwg, Wwg, Uue, Uue, Uue, Qxe, Uue, Qxe, Qxe, Qxe, Qxe, Qxe, Qxe, Uue^Dr, Qxe, Qxe, Uue, Uue, Uue, Wwg, Wwg, Ai, Ai, Ai, Aa, Aa, Aa, Qxua, Qxua, Aa, Aa, Tyb, Tyb, Aa, Aa, Aa, Tyb, Tyb, Aa, Aa, Aa, Ms, Ms, Ms, Ms
Ms, Ms, Ms, Ms, Ms, Aa, Tyb, Aa, Aa, Ms, Ms, Ms^Xm, Ms, Ms, Aa, Aa, Aa, Aa, Aa, Aa, Aa, Aa, Qxua, Aa, Aa, Aa, Aa, Wwg, Wwg, Wwg, Wwg, Uue, Uue, Qxe, Qxe, Uue, Qxe, Qxe, Qxe, Uue^Dr, Uue, Qxe, Uue, Uue, Uue, Wwg, Wwg, Wwg, Wwg^Ii, Wwg^Ii, Wwg^Ii, Ai, Aa, Aa, Qxua, Aa, Aa, Aa, Tyb, Aa, Aa, Aa, Aa, Aa, Tyb, Aa, Tyb, Aa, Aa, Ms, Ms, Ms
Ms, Ms, Ms, Ms, Ms, Aa, Aa, Aa, Aa, Ms, Ms, Ms^Xm, Ms^Xm, Ms, Ms, Aa, Aa, Tyb, Aa, Qxua, Qxua, Qxua, Aa, Aa, Aa, Aa, Aa, Aa, Aa, Wwg, Wwg, Cwr, Wwg, Uue, Wwg, Cwr, Uue, Qxe, Uue, Cwr, Wwg, Uue, Wwg, Wwg, Wwg, Wwg, Aa, Ai, Wwg^Ii, Wwg^Ii, Wwg^Ii, Ai, Aa, Aa, Aa, Aa, Aa, Aa, Aa, Aa, Aa, Aa^Vaa, Aa, Aa, Aa, Aa, Aa, Aa, Aa, Ms, Ms, Ms
Ms^Xm, Ms, Ms^Xm, Ms, Ms, Ms, Aa, Aa, Tyb, Aa, Aa, Ms, Ms, Ms, Ms, Aa, Aa, Tyb, Aa, Aa, Aa, Aa, Aa, Aa, Aa, Aa^Vha, Aa, Aa, Wwg, Wwg, Wwg, Wwg, Aa, Wwg, Wwg, Kwr, Wwg, Uue, Wwg, Kwr, Wwg, Wwg, Wwg, Wwg, Wwg, Aa, Aa, Ai, Ai, Wwg^Ii, Ai, Ai, Qxua, Aa, Aa, Aa, Aa, Tyb, Tyb, Aa, Aa, Aa, Tyb, Tyb, Aa, Aa, Tyb, Tyb, Aa, Ms, Ms, Ms
Ms^Xm, Ms, Ms, Ms^Xm, Ms, Ms, Aa, Aa, Tyb, Tyb, Aa, Ms, Ms, Ms, Aa, Aa, Aa, Aa, Aa, Aa, Aa, Aa, Aa, Aa, Aa, Aa, Wwg, Wwg, Aa, Aa, Aa, Aa, Aa^Vha, Aa, Wwg, Wwg, Wwg, Wwg, Wwg, Wwg, Aa, Wwg, Wwg, Aa, Wwg, Aa, Aa, Aa, Wwg, Wwg, Aa, Aa, Qxua, Aa, Aa, Tyb, Aa, Aa, Aa, Tyb, Tyb, Aa, Aa, Aa, Aa, Tyb, Aa, Aa, Ms, Ms, Ms, Ms
Ms^Xm, Ms, Ms, Ms, Ms, Ms, Aa, Tyb, Aa, Aa, Aa, Ms, Ms, Ms, Aa, Aa, Tyb, Aa, Aa, Qxua, Aa, Aa, Ai, Ai, Ai, Wwg, Ai, Wwg, Wwg, Ai, Ai, Aa, Aa, Aa, Aa, Aa, Aa, Aa, Aa, Aa, Ai, Ai, Ai, Aa, Aa, Wwg, Wwg, Wwg, Aa, Aa, Aa, Aa, Qxua, Aa, Aa, Aa, Aa, Tyb, Tyb, Aa, Aa, Aa, Tyb, Aa, Tyb, Aa, Aa, Ms, Ms, Ms, Ms, Ms
Ms^Xm, Ms^Xm, Ms, Ms, Aa, Aa, Aa, Tyb, Aa, Aa, Aa, Aa, Aa, Aa, Aa, Tyb, Aa, Aa, Aa, Qxua, Aa, Ai, Wwg^Ii, Wwg^Ii, Wwg^Ii, Wwg, Aa, Ai, Wwg^Ii, Wwg^Ii, Wwg^Ii, Ai, Aa, Aa, Aa, Aa, Aa, Aa, Aa, Ai, Wwg^Ii, Wwg^Ii, Wwg^Ii, Ai, Wwg, Wwg, Aa, Aa, Aa, Aa^Vha, Aa, Aa, Aa, Qxua, Qxua, Aa, Aa, Aa, Aa, Tyb, Aa, Aa, Aa, Aa, Tyb, Aa, Aa, Ms, Ms, Ms, Ms, Ms
Ms^Xm, Ms, Ms, Aa, Aa, Aa, Ms, Ms, Ms, Aa, Tyb, Aa, Tyb, Aa, Tyb, Aa, Aa, Aa, Aa, Qxua, Aa, Ai, Wwg^Ii, Wwg^Ii, Wwg^Ii, Ai, Aa, Ai, Wwg^Ii, Wwg^Ii, Wwg^Ii, Ai, Aa, Aa^Vha, Aa, Aa, Aa, Aa, Aa, Ai, Wwg^Ii, Wwg^Ii, Wwg^Ii, Wwg, Ai, Aa, Aa, Aa, Aa, Aa, Tyb, Aa, Aa, Aa, Aa, Qxua, Qxua, Aa, Aa, Aa, Aa, Aa, Aa, Aa, Aa, Aa, Aa, Ms, Ms, Ms, Ms, Ms
Ms, Ms, Aa, Aa, Aa, Tyb, Ms, Ms, Ms^Xm, Ms, Aa, Aa, Aa, Tyb, Aa, Aa, Aa, Aa, Aa, Qxua, Qxua, Ai, Ai, Wwg^Ii, Ai, Ai, Aa, Ai, Ai, Wwg^Ii, Ai, Ai, Aa, Aa, Aa, Aa, Aa, Aa, Aa, Ai, Ai, Wwg^Ii, Ai, Ai, Aa, Aa, Aa, Aa, Qxu, Qxu, Aa, Tyb, Aa, Aa, Aa, Aa, Aa, Aa, Aa, Qxua, Qxua, Qxua, Aa, Aa, Aa, Tyb, Aa, Ms, Ms, Ms, Ms, Ms
Ms, Ms, Aa, Aa, Aa, Aa, Ms, Ms, Ms^Xm, Ms, Aa, Tyb, Aa, Aa, Aa, Aa, Tyb, Aa, Aa, Aa, Aa, Qxua, Aa, Ai, Aa, Aa, Aa, Aa, Aa, Ai, Qxua, Aa, Aa, Aa, Aa, Aa, Aa, Aa, Aa, Aa, Aa, Ai, Aa, Aa, Aa, Aa, Qxu, Qxu, Aa, Aa, Aa, Aa, Tyb, Aa, Aa, Aa, Aa, Aa, Aa, Aa, Aa, Qxua, Qxua, Aa, Aa, Tyb, Tyb, Aa, Ms, Ms, Ms, Ms
Ms, Ms, Aa, Tyb, Aa, Aa, Ms, Ms^Xm, Ms, Aa, Aa, Tyb, Aa, Ms, Ms, Aa, Aa, Aa, Tyb, Aa, Aa, Aa, Aa, Aa, Qxua, Qxua, Qxua, Qxua, Qxua, Qxua, Aa, Aa, Aa, Aa, Qxu, Qxu, Qxu, Aa, Aa, Aa, Qxu, Qxu, Aa, Qxu, Qxu, Qxu, Aa, Aa, Aa, Aa, Aa, Aa, Aa, Tyb, Aa, Tyb, Aa, Aa, Tyb, Aa, Aa, Aa, Qxua, Aa, Aa, Aa, Tyb, Aa, Ms, Ms, Ms, Ms
Ms, Ms, Aa, Tyb, Aa, Aa, Aa, Ms, Aa, Aa, Aa, Tyb, Aa, Ms, Ms, Ms, Aa, Aa, Aa, Tyb, Aa, Aa, Aa, Aa, Aa, Aa, Aa, Aa, Aa, Aa, Aa, Aa, Aa, Aa, Aa, Aa, Aa, Qxu, Qxu, Qxu, Aa, Aa, Aa, Aa, Aa, Aa, Aa, Aa, Tyb, Tyb, Aa, Tyb, Tyb, Aa, Tyb, Aa, Tyb, Aa, Aa, Aa, Aa, Aa, Aa, Aa, Aa, Aa, Tyb, Aa, Aa, Ms, Ms, Ms
Aa, Aa, Aa, Aa, Tyb, Aa, Aa, Aa, Aa, Aa, Tyb, Aa, Aa, Aa, Ms, Ms, Ms^Xm, Aa, Aa, Aa, Aa, Tyb, Aa, Aa, Aa, Aa, Aa, Aa, Aa^Vaa, Aa, Aa, Aa, Aa, Aa, Aa, Aa, Aa, Aa, Aa, Aa, Aa, Aa, Aa, Aa, Aa, Aa, Tyb, Tyb, Aa, Tyb, Tyb, Aa, Aa, Aa, Aa^Vaa, Aa, Aa, Tyb, Aa, Aa, Aa, Aa, Aa, Aa, Qxua, Aa, Aa, Aa, Aa, Aa, Aa, Ms
Tyb, Tyb, Aa, Tyb, Aa, Aa, Tyb, Aa, Aa, Aa, Tyb, Aa, Aa, Aa, Ms, Ms, Ms, Ms, Ms, Aa, Aa, Tyb, Aa, Qxua, Aa, Tyb, Aa, Aa, Aa, Aa, Aa, Aa, Aa, Aa, Tyb, Aa, Aa, Aa, Aa, Aa, Aa, Aa, Aa^Vaa, Aa, Tyb, Aa, Aa, Aa, Aa, Tyb, Tyb, Aa, Aa, Aa, Aa, Aa, Aa, Aa, Aa, Tyb, Aa, Tyb, Aa, Aa, Aa, Qxua, Qxua, Aa, Aa, Aa, Aa, Aa
Aa, Aa, Tyb, Tyb, Aa, Aa, Aa, Tyb, Aa, Tyb, Aa, Aa, Aa, Tyb, Aa, Ms, Aa, Aa, Tyb, Tyb, Tyb, Aa, Qxua, Qxua, Aa, Aa, Aa, Tyb, Aa, Aa, Aa, Tyb, Tyb, Aa, Aa, Aa, Aa, Aa, Tyb, Aa, Aa, Aa, Aa, Aa, Tyb, Aa, Tyb, Aa, Aa, Aa, Aa, Aa, Aa, Tyb, Aa, Tyb, Aa, Tyb, Aa, Aa, Aa, Aa, Aa, Aa, Aa, Aa, Aa, Qxua, Qxua, Aa, Qxua, Aa
Tyb, Tyb, Aa, Aa, Ms, Ms, Ms, Aa, Aa, Aa, Tyb, Aa, Ms, Aa, Aa, Tyb, Tyb, Tyb, Aa, Aa, Aa, Aa, Qxua, Aa, Aa, Aa, Aa, Tyb, Aa, Aa, Aa, Aa, Aa, Aa, Tyb, Aa, Aa, Aa, Aa, Tyb, Tyb, Aa, Aa, Aa, Tyb, Tyb, Aa, Aa, Aa, Aa, Aa, Tyb, Aa, Aa, Tyb, Tyb, Aa, Aa, Aa, Tyb, Aa, Tyb, Tyb, Aa, Tyb, Aa, Tyb, Aa, Aa, Qxua, Qxua, Qxua
Aa, Aa, Aa, Aa, Ms, Ms, Ms, Aa, Aa, Tyb, Aa, Aa, Aa, Ms, Ms, Aa, Aa, Aa, Ms, Aa, Aa, Aa, Aa, Aa, Aa, Aa, Ms, Aa, Tyb, Aa, Ms, Aa, Aa, Aa, Aa, Aa, Aa, Aa, Aa, Aa, Tyb, Aa, Ms, Aa, Aa, Aa, Aa, Aa, Ms, Aa, Aa, Aa, Aa, Aa, Aa, Tyb, Aa, Aa, Aa, Aa, Aa, Aa, Tyb, Aa, Aa, Tyb, Aa, Tyb, Tyb, Aa, Aa, Aa
Tyb, Aa, Aa, Aa, Ms, Ms, Ms, Ms^Xm, Ms^Xm, Aa, Aa, Tyb, Aa, Ms, Ms, Ms, Ms, Ms, Ms, Ms, Ms, Aa, Qxua, Aa, Aa, Ms, Ms, Aa, Tyb, Aa, Ms, Ms, Aa, Aa, Aa, Tyb, Aa, Aa, Tyb, Tyb, Ms, Ms, Ms, Ms, Ms, Aa, Ms, Ms, Ms, Ms, Aa, Aa, Tyb, Aa, Tyb, Aa, Tyb, Tyb, Tyb, Aa, Tyb, Aa, Tyb, Tyb, Aa, Aa, Tyb, Tyb, Aa, Aa, Aa, Aa
Tyb, Aa, Tyb, Aa, Aa, Ms, Ms, Ms, Ms^Xm, Ms, Ms, Aa, Tyb, Aa, Ms, Ms, Ms, Ms, Aa, Aa, Aa, Aa, Qxua, Aa, Ms, Ms, Aa, Aa, Tyb, Aa, Aa, Ms, Aa, Aa, Tyb, Aa, Aa, Tyb, Aa, Aa, Ms, Ms, Ms, Ms, Ms, Ms, Ms, Ms, Ms, Ms, Tyb, Tyb, Aa, Aa, Aa, Aa, Tyb, Aa, Aa, Aa, Aa, Tyb, Tyb, Aa, Aa, Aa, Aa, Aa, Ms, Ms, Ms, Aa
Aa, Tyb, Tyb, Tyb, Aa, Aa, Aa, Ms, Ms, Ms, Ms, Aa, Tyb, Aa, Aa, Aa, Aa, Aa, Tyb, Tyb, Aa, Qxua, Aa, Aa, Ms, Ms, Ms, Aa, Aa, Aa, Ms, Ms, Aa, Aa, Aa, Aa, Tyb, Aa, Aa, Ms, Ms, Ms, Ms, Ms, Ms, Ms, Ms, Ms, Aa, Aa, Tyb, Aa, Ms, Aa, Aa, Aa, Aa, Aa, Aa, Tyb, Aa, Aa, Tyb, Tyb, Aa, Aa, Aa, Aa, Ms, Ms, Ms, Ms
Ms, Aa, Aa, Tyb, Tyb, Aa, Aa, Aa, Ms, Ms, Ms, Aa, Aa, Tyb, Tyb, Aa, Tyb, Tyb, Aa, Aa, Aa, Qxua, Aa, Aa, Aa, Ms, Ms, Ms, Ms, Ms, Ms, Aa, Aa, Aa, Aa, Aa, Tyb, Aa, Aa, Ms, Ms, Ms, Aa, Aa, Aa, Ms, Aa, Aa, Aa, Aa, Ms, Ms, Ms, Ms, Ms, Ms, Ms, Aa, Aa, Aa, Aa, Aa, Tyb, Aa, Aa, Aa, Ms, Ms, Ms, Ms, Ms^Xm, Ms
Ms, Ms, Aa, Aa, Tyb, Tyb, Aa, Aa, Ms, Ms^Xm, Ms, Ms, Ms, Aa, Ms, Aa, Aa, Tyb, Aa, Ms, Ms^Xm, Aa, Aa, Qxua, Qxua, Aa, Aa, Ms, Aa, Ms, Aa, Aa, Aa, Tyb, Aa, Aa, Aa, Aa, Aa, Aa, Aa, Aa, Tyb, Aa, Aa, Aa, Aa, Tyb, Aa, Aa, Ms, Ms, Ms, Ms, Ms, Ms, Ms, Aa, Ms, Ms, Ms, Aa, Aa, Aa, Aa, Ms, Ms, Ms, Ms, Ms, Ms^Xm, Ms
Ms^Xm, Ms, Ms, Aa, Tyb, Aa, Aa, Tyb, Aa, Ms, Ms, Ms^Xm, Ms, Ms, Ms, Ms, Aa, Tyb, Ms, Ms, Ms, Ms, Ms^Xm, Aa, Aa, Qxua, Qxua, Aa, Aa, Aa, Tyb, Aa, Tyb, Aa, Aa, Aa, Aa, Aa, Aa, Aa, Tyb, Tyb, Aa, Tyb, Aa, Tyb, Ms, Ms, Ms, Ms, Ms, Ms, Ms, Ms, Ms, Ms, Ms, Ms, Ms, Ms, Ms, Aa, Tyb, Aa, Aa, Ms, Ms, Ms, Ms, Ms^Xm, Ms^Xm, Ms
Ms^Xm, Ms, Ms, Aa, Aa, Aa, Tyb, Tyb, Aa, Aa, Tyb, Ms, Ms, Ms, Ms, Ms, Aa, Tyb, Aa, Ms, Ms, Ms, Ms^Xm, Ms, Aa, Aa, Qxua, Aa, Aa, Tyb, Aa, Tyb, Aa, Tyb, Aa, Tyb, Tyb, Aa, Tyb, Aa, Ms, Aa, Aa, Aa, Ms, Ms, Ms, Ms, Ms, Ms, Ms, Ms, Aa, Aa, Aa, Ms, Ms, Ms, Ms, Ms, Aa, Aa, Tyb, Aa, Aa, Ms, Ms, Ms, Ms, Ms^Xm, Ms^Xm, Ms
Ms, Ms^Xm, Ms, Ms, Aa, Tyb, Aa, Aa, Ms, Aa, Aa, Aa, Tyb, Ms, Aa, Aa, Tyb, Tyb, Aa, Aa, Ms, Ms^Xm, Ms, Ms, Aa, Qxua, Aa, Aa, Ms, Aa, Ms, Aa, Aa, Aa, Aa, Aa, Tyb, Tyb, Aa, Aa, Ms, Ms, Aa, Aa, Ms, Ms, Ms, Ms, Ms, Ms, Aa, Aa, Aa, Aa, Aa, Ms, Ms, Ms, Aa, Aa, Aa, Tyb, Aa, Aa, Aa, Aa, Ms, Ms, Ms^Xm, Ms^Xm, Ms, Ms
Ms, Ms^Xm, Ms, Ms, Aa, Tyb, Aa, Ms, Ms, Ms, Ms, Aa, Aa, Tyb, Tyb, Aa, Tyb, Tyb, Aa, Aa, Ms, Ms^Xm, Ms, Ms, Aa, Qxua, Aa, Aa, Ms, Ms, Ms, Aa, Aa, Aa, Aa, Aa, Tyb, Aa, Aa, Aa, Ms, Ms, Ms, Aa, Aa, Ms, Aa, Aa, Aa, Aa, Tyb, Tyb, Tyb, Tyb, Tyb, Aa, Aa, Aa, Tyb, Tyb, Aa, Aa, Aa, Aa, Ms, Ms, Ms^Xm, Ms^Xm, Ms, Ms, Ms, Ms
Ms, Ms, Ms, Ms, Aa, Tyb, Aa, Ms, Ms, Ms, Ms, Aa, Aa, Aa, Aa, Tyb, Aa, Aa, Aa, Ms, Ms, Ms, Ms, Aa, Aa, Qxua, Aa, Ms, Ms, Ms, Ms, Ms, Aa, Aa, Aa, Aa, Tyb, Aa, Aa, Ms, Ms, Ms, Gg, Ms, Aa, Aa, Aa, Tyb, Aa, Aa, Aa, Aa, Aa, Aa, Aa, Tyb, Tyb, Aa, Tyb, Aa, Aa, Aa, Aa, Ms, Ms, Ms^Xm, Ms^Xm, Ms, Ms, Ms, Ms, Ms
