Mm^Kov, Mm^Kov, Mm^Kov, Mm^Kov, Mm^Kov, Mm^Kov, Mm^Kov, Mm^Kov, Mm^Kov, Hh^Fp, Gll, Gll, Gll^Fp, Gs, Gd, Gs, Gs, Gs, Gs, Gs, Gd, Gs, Gs^Es, Gs, Gs, Gs, Gll^Fp, Gll, Gll^Fp, Gll^Fp, Hh^Fp, Hh, Mm^Xm, Mm^Kov
Mm^Kov, Mm^Kov, Mm^Xm, Mm^Xm, Mm^Kov, Mm^Kov, Mm^Kov, Mm^Kov, Hh, Hh, Gll^Em, Gll^Fp, Gll, Gs, Gs, Gs, Gs^Cov, Gs, Gs^Cov, Gd, Gd^Cov, Gd, Gd, Gs, Gs, Gll, Gg^Fet, Hh^Fp, Hh^Fp, Hh, Mm^Kov, Mm^Kov, Mm^Kov, Mm^Kov
Mm^Kov, Mm^Xm, Mm^Kov, Mm^Kov, Mm^Kov, Mm^Kov, Hh^Fp, Hh^Fp, Gll, Gll, Gll^Fp, Gll^Fp, Gs, Gs, Gs, Gs, Gd, Gd^Cov, 1 Gs^Kov, Gs^Cov, Gd, Gs, Gs, Gll, Gll^Fp, Gll^Fp, Hh^Fp, Hh^Fp, Mm^Kov, Mm^Kov, Mm^Kov, Mm^Kov, Mm^Kov, Mm^Kov
Mm^Kov, Mm^Kov, Mm^Kov, Mm^Kov, Mm^Kov, Hh^Fp, Gll^Em, Gll^Fp, Gll^Fp, Gll^Fp, Gll, Gll^Fp, Gd, Gd, Gs^Es, Gs, Gd^Cov, Gd^Cov, Gd^Cov, Gd^Cov, Gs^Cov, Gs^Es, Gs, Gll, Gll^Fp, Gll, Hh^Fp, Hh^Fp, Mm^Kov, Mm^Xm, Mm^Xm, Mm^Kov, Mm^Kov, Mm^Kov
Mm^Kov, Mm^Kov, Mm^Kov, Mm^Kov, Hh^Fp, Hh^Fp, Gll, Gll^Fp, Gll, Gll, Gll, Gs, Gd, Gd, Gs^Es, Gs, Gd, Gs, Gd^Cov, Gd, Gd, Gs, Gs, Gll^Fp, Gll^Fp, Hh, Mm^Kov, Mm^Kov, Mm^Vov, Mm^Kov, Mm^Kov, Mm^Xm, Mm^Kov, Mm^Kov
Hh^Fp, Mm^Kov, Hh^Fp, Hh, Gll^Fp, Gll^Fp, Gll, Gll^Fp, Gll^Fp, Gll, Gll^Fp, Gs, Gd, Gs, Gs^Es, Gs, Gd, Gd, Gs, Gs, Gd, Gd^Es, Gs, Gll, Gll^Fp, Hh^Fp, Mm^Kov, Mm^Kov, Mm^Kov, Mm^Kov, Mm^Kov, Mm^Kov, Mm^Xm, Mm^Kov
Gll^Fp, Hh^Fp, Gll, Gll, Gll^Fp, Gs, Gll, Gs^Es, Gll, Gg^Fet, Gll^Fp, Gs, Gd, Gs, Gs, Gd, Gd, Gd, Gs, Gs, Gll, Gs, Gs, Gll, Gll^Fp, Hh^Fp, Hh^Fp, Mm^Kov, Mm^Kov, Mm^Xm, Mm^Kov, Mm^Kov, Mm^Kov, Mm^Kov
Gll, Gll, Gll^Fp, Gll^Fp, Gd, Gll^Em, Gll^Fp, Gs, Hh, Hh^Fp, Hh^Fp, Gs, Gs^Es, Gd, Gd, Gs^Es, Gs, Gs, Gs, Gll, Gll^Fp, Gs, Gll^Es, Gs, Gll, Gll^Fp, Gll^Fp, Hh^Fp, Hh^Fp, Mm^Kov, Hh^Fp, Hh^Fp, Mm^Kov, Mm^Kov
Gll^Fp, Gd, Gd, Gs, Gll^Fp, Gll^Fp, Hh^Fp, Hh, Mm^Kov, Mm^Vov, Mm^Kov, Hh, Gs, Gs, Gs, Gs, Gs, Gs, Gll^Fp, Gll, Hh^Fp, Gll^Fp, Gs^Em, Gd, Gs, Gll^Fp, Gll^Fp, Gll, Gll, Hh^Fp, Gll, Hh^Fp, Hh^Fp, Mm^Kov
Gll, Gll, Gs^Es, Gll, Gg^Fet, Gll, Hh^Fp, Hh^Fp, Hh^Fp, Mm^Kov, Hh^Fp, Hh, Gll, Gs, Gd^Es, Gs, Gll, Gll^Fp, Hh^Fp, Hh, Mm^Kov, Hh^Fp, Gll, Gs, Gs, Gll^Fp, Gll^Fp, Gll^Fp, Gll^Fp, Gll^Fp, Gll^Es, Gll^Fp, Gll^Fp, Hh
Gll^Fp, Gll, Gll^Fp, Gll, Gs, Gll, Gll^Fp, Hh, Gll^Fp, Hh, Gll^Fp, Gll^Fp, Gll, Gd, Gd, Gll, Gll^Fp, Hh, Mm^Kov, Mm^Vov, Mm^Kov, Hh, Gll^Fp, Gs^Es, Gd^Es, Gll^Fp, Gll, Gg^Fet, Gll, Gll, Gd, Gll, Gll^Fp, Gs
Gll^Fp, Gll^Fp, Gll, Gll^Fp, Gll^Fp, Gll, Gll, Gs, Gll, Gll, Gs, Gll, Gll^Fp, Gs, Gs, Gll, Gll^Fp, Hh^Fp, Mm^Kov, Mm^Kov, Mm^Kov, Hh^Fp, Gll^Fp, Gs, Gs, Gs, Gs, Gll, Gs, Gs^Es, Gs, Gs, Gll^Es, Gs
Gll^Fp, Gll, Gg^Fet, Gll, Gll^Fp, Gd, Gd^Es, Gs, Gll^Em, Gll^Fp, Gll, Gll^Fp, Gs, Gll^Fp, Gll^Fp, Gll, Gll, Hh^Fp, Hh^Fp, Mm^Kov, Hh^Fp, Hh^Fp, Gll^Fp, Gg^Fet, Gd, Gd^Es, Gll, Gll^Fp, Gll^Fp, Gll, Gll^Fp, Gd^Em, Gd, Gd
Gll^Fp, Gll^Fp, Gll, Gll^Em, Gs, Gs, Gs, Gs, Gll^Fp, Gll^Fp, Hh^Fp, Hh, Hh, Hh^Fp, Hh^Fp, Gll^Fp, Gll, Gll^Fp, Gll^Fp, Hh, Gll^Em, Gll^Fp, Gs, Gll, Gs, Gs, Hh, Hh^Fp, Hh^Fp, Hh, Hh^Fp, Gll^Fp, Gll, Gs^Es
Gs, Gd^Es, Gd, Gs, Gll^Fp, Gg^Fet, Gll^Fp, Gll^Fp, Hh^Fp, Hh, Mm^Kov, Mm^Kov, Mm^Xm, Mm^Kov, Mm^Kov, Hh, Gll^Fp, Gll, Gs, Gs, Gs, Gll, Gs^Es, Gs, Gll^Fp, Hh, Mm^Kov, Mm^Vov, Mm^Kov, Mm^Kov, Hh^Fp, Gll^Fp, Gll, Gs
Gll, Gll, Gll^Fp, Gll^Fp, Gll, Gll, Hh, Hh^Fp, Mm^Kov, Mm^Kov, Mm^Kov, Mm^Vov, Mm^Kov, Mm^Xm, Mm^Xm, Hh^Fp, Hh^Fp, Gll, Gll, Gd, Gs, Gs^Es, Gll, Gll^Fp, Hh^Fp, Hh^Fp, Mm^Kov, Mm^Kov, Mm^Kov, Mm^Vov, Mm^Kov, Hh, Gll^Fp, Gs
Gll^Fp, Gs, Gll, Gll^Fp, Gll^Fp, Hh^Fp, Mm^Kov, Mm^Kov, Mm^Kov, Mm^Vov, Mm^Kov, Mm^Kov, Mm^Kov, Mm^Kov, Mm^Kov, Mm^Kov, Hh, Gll^Fp, Gs, Gs, Gd, Gs, Gll, Gll^Fp, Hh^Fp, Mm^Kov, Mm^Kov, Mm^Kov, Mm^Kov, Mm^Kov, Hh^Fp, Hh^Fp, Gll, Gs
Gll, Gll^Es, Gll^Fp, Gll, Gll^Fp, Hh^Fp, Mm^Kov, Mm^Kov, Mm^Kov, Mm^Kov, Hh^Fp, Hh^Fp, Hh^Fp, Mm^Kov, Hh^Fp, Mm^Kov, Hh^Fp, Gll^Fp, Gll, Gs, Gd, Gd, Gg^Fet, Gll^Fp, Hh^Fp, Mm^Kov, Mm^Kov, Mm^Kov, Mm^Kov, Mm^Kov, Hh^Fp, Gll^Fp, Gll, Gs
Gll^Fp, Gll^Es, Gll, Gll^Fp, Gll^Fp, Hh, Hh^Fp, Mm^Kov, Hh^Fp, Hh, Hh^Fp, Gll^Fp, Gll^Fp, Hh^Fp, Hh, Hh^Fp, Gll^Fp, Gll^Fp, Gll, Gs^Es, Gs, Gd, Gll^Fp, Hh^Fp, Mm^Kov, Mm^Kov, Mm^Kov, Mm^Kov, Mm^Kov, Hh^Fp, Hh^Fp, Gll^Fp, Gd^Em, Gs^Es
Gll, Gll^Fp, Gll^Fp, Gll^Fp, Gll^Fp, Gll^Fp, Gll^Fp, Hh^Fp, Gll, Hh, Gll, Gll^Fp, Gll^Fp, Gll^Fp, Gll^Es, Gll, Gll^Fp, Gg^Fet, Gs, Gs, Gd, Gs, Gll, Hh, Mm^Kov, Mm^Kov, Mm^Kov, Mm^Kov, Hh, Hh^Fp, Gll^Fp, Gll, Gs, Gd
Gs^Es, Gll, Gs, Gll, Gll, Gll, Gll, Gll^Fp, Gll^Fp, Gll^Fp, Gll^Em, Gll^Fp, Gll^Fp, Gll, Gll^Fp, Gll^Fp, Gll, Gd, Gd, Gd^Es, Gs, Gs, Gll, Hh^Fp, Hh^Fp, Mm^Kov, Hh, Mm^Kov, Hh^Fp, Gll^Em, Gll, Gll^Fp, Gll^Fp, Gll
Gd, Gd, Ww^Kov, Gs, Ww^Kov, Gs^Es, Gs, Gs, Gll, Gll^Fp, Gll^Fp, Gll^Fp, Gll^Es, Gs, Gll^Es, Gs^Es, Ww^Kov, Gs, Ww^Kov, Gs, Gs, Gd^Es, Gs, Gll^Fp, Gll^Fp, Hh^Fp, Gll, Hh^Fp, Gll^Fp, Gll^Fp, Gll^Fp, Gll^Fp, Gll, Gll^Fp
Ww^Kov, Ww^Kov, Ww^Kov, Ww^Kov, Ww^Kov, Ww^Kov, Gd, Gd^Es, Gs, Gll^Es, Gs, Gll, Gs, Gs, Wwf, Wwf, Ww^Kov, Ww^Kov, Ww^Kov, Ww^Kov, Ww^Kov, Gd, Gd^Es, Gll, Gs, Gll^Fp, Gll, Gll^Fp, Hh^Fp, Hh^Fp, Hh^Fp, Hh^Fp, Hh^Fp, Gll^Fp
Ww^Kov, Ww^Kov, Ww^Kov, Ww^Kov, Ww^Kov, Ww^Kov, Ww^Kov, Gd, Gd, Gd, Ww^Kov, Ww^Kov, Gd, Gd^Es, Wwf, Wwf, Ww^Kov, Ww^Kov, Wo, Ww^Kov, Ww^Kov, Gs, Gs, Gs, Gd, Gll^Es, Gs, Gll^Fp, Gll^Fp, Hh^Fp, Hh, Hh^Fp, Hh^Fp, Hh^Fp
Gs, Gd, Gll^Fp, Gd, Gs, Ww^Kov, Wwf, Wwf, Ww^Kov, Ww^Kov, Ww^Kov, Ww^Kov, Ww^Kov, Ww^Kov, Ww^Kov, Wwf, Ww^Kov, Wo, Wo, Wo, Ww^Kov, Wwf, Wwf, Ww^Kov, Ww^Kov, Gs, Gll, Gll^Fp, Gg^Fet, Hh^Fp, Hh^Fp, Hh^Fp, Hh, Hh^Fp
Gll^Fp, Gll^Fp, Hh^Fp, Gll^Fp, Hh^Fp, Gll^Fp, Gll^Fp, Ww^Kov, Ww^Kov, Ww^Kov, Ww^Kov, Wo, Wo, Ww^Kov, Ww^Kov, Wwf, Ww^Kov, Ww^Kov, Ww^Kov, Ww^Kov, Ww^Kov, Ww^Kov, Wwf, Ww^Kov, Ww^Kov, Gd^Es, Gll, Gll^Fp, Gll^Fp, Gll, Hh^Fp, Hh^Fp, Hh^Fp, Hh^Fp
Hh, Hh^Fp, Mm^Kov, Hh, Mm^Kov, Hh^Fp, Hh, Gs, Gs^Es, Ww^Kov, Ww^Kov, Wo, Wo, Ww^Kov, Ww^Kov, Wwf, Wwf, Ww^Kov, Gll^Fp, Ww^Kov, Ww^Kov, Ww^Kov, Wwf, Ww^Kov, Ww^Kov, Gd, Gd, Gll, Gll^Fp, Gll^Fp, Gll, Hh^Fp, Hh, Hh^Fp
Mm^Kov, Mm^Kov, Mm^Kov, Mm^Kov, Mm^Kov, Mm^Kov, Hh^Fp, Gll^Fp, Gll, Gd, Gd^Es, Ww^Kov, Ww^Kov, Ww^Kov, Ww^Kov, Ww^Kov, Ww^Kov, Gll^Em, Gll^Fp, Gll^Fp, Gll^Es, Wwf, Ww^Kov, Ww^Kov, Ww^Kov, Ww^Kov, Gs, Gs^Es, Gll^Fp, Gll^Em, Hh^Fp, Hh^Fp, Hh^Fp, Hh^Fp
Mm^Kov, Mm^Kov, Mm^Kov, Mm^Vov, Mm^Kov, Mm^Kov, Hh^Fp, Gll, Gll^Fp, Gll^Fp, Gll, Gs^Es, Gs, Ww^Kov, Ww^Kov, Ww^Kov, Gll^Fp, Gll^Fp, Gg^Fet, Gll^Em, Gll^Fp, Ww^Kov, Ww^Kov, Ww^Kov, Ww^Kov, Ww^Kov, Ww^Kov, Gs, Gll, Gll^Fp, Hh^Fp, Hh, Hh^Fp, Hh^Fp
Mm^Kov, Mm^Kov, Mm^Kov, Mm^Kov, Hh, Hh^Fp, Gll^Fp, Gll^Fp, Gg^Fet, Gll^Fp, Gll, Gs, Ww^Kov, Ww^Kov, Ww^Kov, Ww^Kov, Gll^Em, Gll^Fp, Gll^Fp, Gll^Fp, Gll^Fp, Ww^Kov, Ww^Kov, Ww^Kov, Ww^Kov, Ww^Kov, Gs, Gd, Gll^Fp, Gll^Fp, Gll, Hh^Fp, Gll, Gll
Mm^Kov, Mm^Kov, Mm^Kov, Hh, Gll^Fp, Gll, Gll, Gs, Gd^Es, Gll, Gd, Gd^Es, Ww^Kov, Ww^Kov, Ww^Kov, Wwf, Ww^Kov, Gll^Fp, Gll^Fp, Gll^Es, Wwf, Wwf, Ww^Kov, Ww^Kov, Gg^Fet, Gs, Gs, Gd^Es, Gs^Es, Gll, Gll^Fp, Gll^Fp, Gll^Fp, Gll^Fp
Mm^Kov, Mm^Kov, Hh^Fp, Hh^Fp, Gs, Gll^Fp, Ww^Kov, Ww^Kov, Ww^Kov, Gs, Ww^Kov, Ww^Kov, Ww^Kov, Ww^Kov, Wwf, Wwf, Ww^Kov, Ww^Kov, Ww^Kov, Ww^Kov, Ww^Kov, Wwf, Wwf, Ww^Kov, Ww^Kov, Gs^Es, Gd, Gs, Gs, Gs, Gll^Es, Gll^Em, Gll^Es, Gll
Mm^Kov, Hh^Fp, Hh, Gll^Fp, Ww^Kov, Ww^Kov, Ww^Kov, Ww^Kov, Ww^Kov, Wwf, Ww^Kov, Ww^Kov, Ww^Kov, Wwf, Ww^Kov, Ww^Kov, Ww^Kov, Wo, Wo, Ww^Kov, Ww^Kov, Ww^Kov, Wwf, Ww^Kov, Wwf, Ww^Kov, Gd, Gs, Gll^Fp, Gll, Gll^Fp, Gll^Es, Gll^Fp, Gll
Hh^Fp, Hh^Fp, Gll^Fp, Gll^Fp, Ww^Kov, Ww^Kov, Gs, Gd, Gs, Gd, Gll^Fp, Ww^Kov, Gd^Es, Wwf, Ww^Kov, Ww^Kov, Ww^Kov, Wo, Ww^Kov, Ww^Kov, Ww^Kov, Wwf, Ww^Kov, Wwf, Ww^Kov, Gs, Gs^Es, Gll, Gll^Fp, Gs, Gll^Fp, Gll^Fp, Gll^Fp, Gll^Fp
Gll^Fp, Gll^Fp, Gll, Ww^Kov, Ww^Kov, Ww^Kov, Gll^Fp, Gll, Gll^Fp, Gll^Fp, Gll^Fp, Gs, Gll^Fp, Gd^Es, Gs^Es, Ww^Kov, Ww^Kov, Ww^Kov, Gs, Ww^Kov, Gd, Wwf, Ww^Kov, Ww^Kov, Gd, Gs, Gs^Es, Gll, Gll^Fp, Gg^Fet, Gll, Hh^Fp, Hh^Fp, Hh^Fp
Gg^Fet, Gll^Fp, Ww^Kov, Ww^Kov, Ww^Kov, Gll^Fp, Gll^Fp, Gll, Hh, Hh^Fp, Hh^Fp, Gg^Fet, Gs, Gll^Fp, Gs, Gs, Gd, Ww^Kov, Gd, Gs, Gs^Es, Gs, Ww^Kov, Ww^Kov, Ww^Kov, Gs^Es, Gll, Gll^Fp, Gll^Fp, Hh^Fp, Hh^Fp, Hh, Mm^Xm, Mm^Kov
Gs, Gll, Ww^Kov, Ww^Kov, Gll^Es, Gll, Gll^Fp, Hh^Fp, Mm^Kov, Mm^Kov, Mm^Kov, Hh, Hh, Gll^Fp, Gll^Fp, Gd, Gs, Gd, Gs, Gd, Gg^Fet, Gd, Gs, Ww^Kov, Ww^Kov, Gll, Gll^Fp, Gll^Fp, Hh, Hh^Fp, Mm^Kov, Mm^Kov, Mm^Kov, Mm^Kov
Ww^Kov, Ww^Kov, Ww^Kov, Ww^Kov, Gll^Fp, Gll^Fp, Hh^Fp, Hh^Fp, Mm^Kov, Mm^Kov, Mm^Kov, Mm^Kov, Hh^Fp, Hh^Fp, Gll, Gll^Fp, Gll, Gs^Es, Gs^Es, Gs, Gs, Gd^Es, Wwf, Ww^Kov, Ww^Kov, Gll, Gll^Fp, Hh^Fp, Mm^Kov, Mm^Kov, Mm^Vov, Mm^Kov, Mm^Kov, Mm^Kov
Ww^Kov, Ww^Kov, Gs, Gll, Gg^Fet, Gll^Fp, Hh^Fp, Hh, Mm^Kov, Mm^Vov, Mm^Kov, Mm^Kov, Mm^Kov, Hh^Fp, Hh, Gll^Fp, Gll^Fp, Gs, Gs, Gd, Gs, Gs, Ww^Kov, Wwf, Gs, Gll^Fp, Hh^Fp, Hh^Fp, Mm^Kov, Mm^Kov, Mm^Xm, Mm^Kov, Mm^Kov, Mm^Kov
Gs, Gs, Gs, Gll^Es, Gll^Fp, Gll, Gll^Fp, Hh, Mm^Kov, Mm^Kov, Mm^Kov, Mm^Kov, Mm^Kov, Mm^Kov, Mm^Kov, Hh^Fp, Gll^Fp, Gg^Fet, Gs, Gd, Gs^Es, Gs, Ww^Kov, Ww^Kov, Gd, Gll^Fp, Gll^Fp, Hh, Hh^Fp, Mm^Kov, Mm^Kov, Mm^Xm, Mm^Xm, Mm^Kov
Gs^Es, Gd^Es, Gs, Gs, Gll, Gll, Gll^Fp, Hh^Fp, Hh^Fp, Mm^Kov, Mm^Kov, Mm^Kov, Mm^Kov, Mm^Vov, Mm^Kov, Hh^Fp, Gll^Fp, Gll, Gs, Gs, Gs^Es, Gd, Ww^Kov, Ww^Kov, Ww^Kov, Gs^Es, Gll, Gll^Fp, Hh^Fp, Hh, Mm^Kov, Mm^Kov, Mm^Kov, Mm^Kov
Gs^Es, Gd, Gd, Gs, Gs, Gll^Fp, Gll^Fp, Gg^Fet, Gll, Hh^Fp, Hh^Fp, Mm^Kov, Hh^Fp, Mm^Kov, Hh, Hh, Gll, Gll^Fp, Gs, Gs, Gs^Es, Gd, Gs, Ww^Kov, Ww^Kov, Gs, Gs^Es, Gll^Fp, Gll^Fp, Hh^Fp, Hh^Fp, Mm^Kov, Hh^Fp, Mm^Kov
Gd^Es, Gs, Gs, Gs, Gs, Gll, Gll, Gll^Fp, Gs, Gll^Fp, Gs, Hh, Gll^Fp, Hh^Fp, Gg^Fet, Gll^Fp, Gll^Fp, Gll^Fp, Gs, Gd^Es, Gs, Gd, Gd, Ww^Kov, Ww^Kov, Gs, Gd, Gd, Gs, Gll, Gll^Fp, Hh, Hh^Fp, Hh^Fp
Gs, Gd, Gs, Gs, Gd^Es, Gs, Gs, Gs, Gs^Es, Gs, Gs, Gll, Gll, Gs, Gll, Gll, Gs, Gs, Gs, Gd, Gd, Gs, Gs, Ww^Kov, Ww^Kov, Ww^Kov, Ww^Kov, Gd^Es, Gs^Es, Gs, Gll^Fp, Gll^Em, Gll^Es, Hh^Fp
Gs, Gd, Gs, Gd, Gs, Gd^Es, Gd, Gd^Es, Gs, Gd, Gll, Gs, Gll^Fp, Gs, Gll^Fp, Gs, Gs, Gs, Gs^Es, Gd^Es, Gs, Gd, Gd^Es, Gs, Gd, Ww^Kov, Ww^Kov, Ww^Kov, Ww^Kov, Gd, Gll, Gll^Fp, Gll^Fp, Gll^Fp
Gs, Gd, Gs^Es, Gs^Es, Gs, Gd, Gs, Gs, Gs^Es, Gll, Gll^Fp, Gll^Fp, Hh^Fp, Hh, Hh, Gll^Fp, Gs^Es, Gs, Gs, Gd, Gd, Gd, Hh, Gs, Gs, Gs^Es, Gs, Ww^Kov, Ww^Kov, Ww^Kov, Ww^Kov, Ww^Kov, Ww^Kov, Gll
Gs^Es, Gs, Gd, Gs, Gs, Gs, Gg^Fet, Gs, Gs, Gs, Gg^Fet, Hh^Fp, Mm^Kov, Mm^Kov, Mm^Kov, Hh^Fp, Gll, Gs, Gg^Fet, Gs, Hh^Fp, Hh^Fp, Hh, Hh^Fp, Hh^Fp, Gd, Gs, Gd^Es, Gd, Ww^Kov, Ww^Kov, Ww^Kov, Ww^Kov, Gll
Gd, Gs, Gll^Fp, Gll, Gll^Fp, Gll^Fp, Gll^Fp, Gll^Fp, Gll^Fp, Gs, Gs^Es, Hh^Fp, Hh, Mm^Kov, Hh^Fp, Hh^Fp, Gll, Gll^Fp, Hh, Hh^Fp, Mm^Kov, Mm^Kov, Mm^Kov, Mm^Kov, Mm^Kov, Hh^Fp, Hh, Gll^Fp, Gll^Fp, Gd, Gs^Es, Gs^Es, Ww^Kov, Ww^Kov
Gll, Gll, Gll^Fp, Gll^Em, Hh, Hh^Fp, Hh^Fp, Hh, Hh^Fp, Gll^Fp, Gs, Gs^Es, Gd, Hh, Gll^Fp, Gg^Fet, Gs, Hh^Fp, Mm^Kov, Mm^Kov, Mm^Kov, Mm^Kov, Mm^Kov, Mm^Xm, Mm^Xm, Hh, Hh^Fp, Gll, Gll^Fp, Gll^Fp, Gll^Fp, Gs, Gll, Ww^Kov
Gs, Gll, Gll^Fp, Hh^Fp, Mm^Kov, Mm^Vov, Mm^Xm, Mm^Xm, Mm^Kov, Hh^Fp, Gll^Fp, Gs, Gs, Gs, Gs, Gll, Gs, Hh^Fp, Mm^Kov, Mm^Kov, Mm^Xm, Mm^Xm, Mm^Kov, Mm^Kov, Mm^Kov, Mm^Xm, Mm^Kov, Hh^Fp, Gll, Gll^Es, Gll^Fp, Gg^Fet, Gll^Fp, Gll
Gll, Gg^Fet, Hh^Fp, Hh^Fp, Mm^Kov, Mm^Xm, Mm^Kov, Mm^Kov, Mm^Kov, Hh^Fp, Hh, Gll^Es, Gs, Gd, Gs, Gs, Gll^Fp, Hh, Mm^Kov, Mm^Xm, Mm^Kov, Mm^Kov, Hh^Fp, Hh, Hh^Fp, Mm^Kov, Hh, Hh^Fp, Gll, Gll^Fp, Gll^Fp, Gll^Fp, Gll^Fp, Gll^Fp
Gs, Gll, Hh^Fp, Mm^Kov, Mm^Kov, Mm^Kov, Mm^Kov, Mm^Kov, Mm^Kov, Mm^Kov, Hh^Fp, Gs, Gs, Gd, Gs^Es, Gll, Gll^Fp, Hh^Fp, Hh^Fp, Mm^Kov, Hh^Fp, Hh^Fp, Gll^Fp, Gll, Gll^Es, Hh^Fp, Hh^Fp, Hh^Fp, Gll^Fp, Gg^Fet, Hh^Fp, Gll^Em, Hh^Fp, Hh
Gll^Fp, Gll, Hh, Mm^Kov, Hh^Fp, Hh, Hh^Fp, Hh^Fp, Hh^Fp, Mm^Kov, Hh^Fp, Gs, Gd, Gd^Es, Gs, Gll, Gs, Gll^Fp, Gll, Hh, Gd, Hh^Fp, Gll, Gd^Em, Gll^Es, Gll^Fp, Gll^Fp, Gll, Gll^Es, Hh, Hh^Fp, Hh, Hh^Fp, Hh^Fp
Gll^Fp, Gll^Es, Gll, Hh^Fp, Gll^Fp, Gll^Fp, Gs, Gll^Fp, Gll^Fp, Hh^Fp, Gll^Fp, Gll, Gs^Es, Gd^Es, Gd, Gs, Gll, Gd^Es, Gll^Es, Gll^Fp, Gs, Gll^Es, Gg^Fet, Gll^Fp, Gll, Gll^Fp, Gll^Em, Gll^Fp, Hh^Fp, Hh^Fp, Hh, Hh, Mm^Kov, Hh
Hh^Fp, Gll^Fp, Gll^Fp, Gll, Gll^Fp, Gll^Em, Gs, Gll^Es, Gs, Gll^Fp, Gll, Gll, Gs, Gd, Gs, Gll^Fp, Gll^Fp, Gd, Gll^Fp, Gll, Hh^Fp, Gll^Fp, Gll, Gll^Fp, Hh^Fp, Hh^Fp, Hh^Fp, Hh^Fp, Mm^Kov, Mm^Kov, Mm^Kov, Mm^Kov, Mm^Kov, Mm^Kov
Hh^Fp, Gll^Fp, Hh^Fp, Gg^Fet, Gll^Fp, Gll^Fp, Gll^Fp, Gll, Gg^Fet, Gll, Gll^Fp, Gll, Gll^Fp, Gs^Es, Gs, Gll^Fp, Gll^Fp, Gll, Hh^Fp, Hh^Fp, Hh, Hh^Fp, Hh^Fp, Hh^Fp, Mm^Kov, Mm^Kov, Mm^Kov, Mm^Kov, Mm^Kov, Mm^Kov, Mm^Kov, Mm^Kov, Mm^Kov, Mm^Kov
Mm^Kov, Hh, Mm^Kov, Hh^Fp, Hh, Hh^Fp, Hh^Fp, Gll^Fp, Gll^Fp, Gll^Fp, Gll^Em, Gll^Fp, Gll^Fp, Gs, Gd^Es, Gll^Es, Gll^Fp, Hh^Fp, Mm^Kov, Mm^Kov, Mm^Kov, Mm^Kov, Mm^Kov, Mm^Kov, Mm^Kov, Mm^Kov, Mm^Kov, Mm^Kov, Mm^Kov, Mm^Kov, Mm^Kov, Mm^Kov, Mm^Kov, Mm^Kov
Mm^Kov, Mm^Kov, Mm^Kov, Mm^Kov, Mm^Kov, Mm^Kov, Mm^Kov, Hh^Fp, Hh, Hh^Fp, Hh^Fp, Hh^Fp, Gll^Fp, Gs, Gs, Gll, Gll, Hh^Fp, Hh^Fp, Mm^Kov, Mm^Kov, Mm^Kov, Mm^Kov, Mm^Kov, Mm^Kov, Mm^Kov, Mm^Kov, Mm^Kov, Mm^Kov, Mm^Kov, Mm^Kov, Mm^Kov, Mm^Kov, Mm^Kov
Mm^Kov, Mm^Kov, Mm^Kov, Mm^Kov, Mm^Kov, Mm^Kov, Mm^Kov, Mm^Kov, Mm^Kov, Mm^Kov, Mm^Kov, Hh, Hh^Fp, Gll, Gll^Fp, Gs, Gs, Hh^Fp, Hh, Mm^Kov, Mm^Kov, Mm^Kov, Mm^Kov, Mm^Kov, Mm^Kov, Mm^Kov, Mm^Kov, Mm^Kov, Mm^Kov, Mm^Kov, Mm^Kov, Mm^Kov, Mm^Kov, Mm^Kov
Mm^Kov, Mm^Kov, Mm^Kov, Mm^Kov, Mm^Kov, Mm^Kov, Mm^Kov, Mm^Kov, Mm^Kov, Mm^Kov, Mm^Kov, Mm^Kov, Mm^Kov, Hh^Fp, Hh^Fp, Gll, Gll^Es, Gll^Fp, Hh^Fp, Mm^Kov, Mm^Kov, Mm^Kov, Mm^Kov, Mm^Kov, Mm^Kov, Mm^Kov, Mm^Kov, Mm^Kov, Mm^Kov, Mm^Kov, Mm^Kov, Mm^Kov, Mm^Kov, Mm^Kov
Mm^Kov, Mm^Kov, Mm^Kov, Mm^Kov, Mm^Kov, Mm^Kov, Mm^Kov, Mm^Kov, Mm^Kov, Mm^Kov, Mm^Kov, Mm^Kov, Mm^Kov, Mm^Kov, Hh^Fp, Gs, Gs, Hh^Fp, Mm^Kov, Mm^Vov, Mm^Kov, Mm^Kov, Mm^Kov, Mm^Kov, Mm^Xm, Mm^Kov, Mm^Xm, Mm^Xm, Mm^Xm, Mm^Kov, Mm^Xm, Mm^Kov, Mm^Kov, Mm^Kov
Mm^Kov, Mm^Kov, Mm^Kov, Mm^Kov, Mm^Kov, Mm^Kov, Mm^Kov, Mm^Kov, Mm^Kov, Mm^Kov, Mm^Kov, Mm^Vov, Mm^Kov, Hh^Fp, Gll, Gs, Gs, Hh^Fp, Hh^Fp, Mm^Kov, Mm^Kov, Mm^Kov, Mm^Xm, Mm^Xm, Xu, Mm^Xm, Xu, Mm^Xm, Xu, Mm^Xm, Xu, Mm^Xm, Mm^Xm, Mm^Xm
Mm^Kov, Mm^Kov, Mm^Kov, Mm^Kov, Mm^Kov, Mm^Kov, Mm^Kov, Mm^Kov, Mm^Kov, Mm^Kov, Mm^Kov, Mm^Kov, Mm^Xm, Hh, Uu, Gs, Uu, Gll, Hh, Mm^Xm, Mm^Xm, Mm^Xm, Xu, Xu, Xu, Xu, Xu, Xu, Xu, Xu, Xu, Xu, Xu, Mm^Xm
Mm^Xm, Mm^Kov, Mm^Xm, Mm^Kov, Mm^Xm, Mm^Kov, Mm^Xm, Mm^Kov, Mm^Xm, Mm^Xm, Mm^Xm, Mm^Xm, Xu, Xu, Uu, Uu, Uh, Xu, Xu, Xu, Xu, Xu, Xu, Xu, Xu, Xu, Xu, Xu, Xu, Xu, Xu, Xu, Xu, Xu
Xu, Mm^Xm, Xu, Mm^Xm, Xu, Mm^Xm, Xu, Mm^Xm, Xu, Mm^Xm, Xu, Xu, Xu, Xu, Uu, Ur, Uh, Xu, Xu, Xu, Xu, Xu, Xu, Xu, Xu, Xu, Xu, Xu, Xu, Xu, Xu, Xu, Xu, Xu
Xu, Xu, Xu, Xu, Xu, Xu, Xu, Xu, Xu, Xu, Xu, Xu, Xu, Uh, Uu, Ur, Uu, Xu, Xu, Xu, Xu, Xu, Xu, Xu, Xu, Xu, Xu, Xu, Xu, Xu, Xu, Xu, Xu, Xu
Xu, Xu, Xu, Xu, Xu, Xu, Xu, Xu, Xu, Xu, Xu, Xu, Xu, Uh, Ur, Uu, Uu, Uu^Uf, Xu, Xu, Xu, Xu, Xu, Xu, Xu, Xu, Xu, Xu, Xu, Xu, Xu, Xu, Xu, Xu
Xu, Xu, Xu, Xu, Xu, Xu, Xu, Xu, Xu, Xu, Xu, Xu, Cud, Uu^Uf, Ur, Uu, Cud, Uu^Uf, Xu, Xu, Xu, Xu, Xu, Xu, Xu, Xu, Xu, Xu, Xu, Xu, Xu, Xu, Xu, Xu
Xu, Xu, Xu, Xu, Xu, Xu, Xu, Xu, Xu, Xu, Xu, Xu, Cud, Uu, Ur, Uu, Cud, Xu, Cud, Xu, Xu, Xu, Xu, Xu, Xu, Xu, Xu, Xu, Xu, Xu, Xu, Xu, Xu, Xu
Xu, Xu, Xu, Xu, Xu, Xu, Xu, Uh, Uh, Xu, Uu^Uf, Cud, Uu, Uu, Ur, Uu, Uu, Cud, Uu, Uu, Uh, Xu, Xu, Xu, Xu, Xu, Xu, Xu, Xu, Xu, Xu, Xu, Xu, Xu
Xu, Xu, Xu, Xu, Xu, Xu, Uh, Uh, Uu^Uf, Uu, Uu, Uu, Uu, Uu, Ur, Uu, Uu, Uu, Uu, Uu, Uu^Uf, Uh, Uh, Xu, Xu, Xu, Xu, Xu, Xu, Xu, Xu, Xu, Xu, Xu
Xu, Xu, Xu, Xu, Xu, Xu, Uh, Uh, Uu^Uf, Uu^Uf, Uu, Uu, Uu, Ur, Uu, Uu, Ur, Uu, Uu, Uu^Uf, Uh, Uh, Uh, Xu, Xu, Xu, Xu, Xu, Xu, Xu, Xu, Xu, Xu, Xu
Xu, Xu, Xu, Xu, Xu, Xu, Uh, Uh, Uu^Uf, Uu, Uu, Uu, Ur, Uu, Uu, Uu, Ur, Uu, Uu, Uu, Uu^Uf, Uh, Uh, Xu, Xu, Xu, Xu, Xu, Xu, Xu, Xu, Xu, Xu, Xu
Xu, Xu, Xu, Xu, Xu, Xu, Uh, Uh, Uu^Uf, Uu, Uu, Uu, Ur, Uu, Uu, Uu, Uu, Ur, Uu, Uu, Uu, Uu^Uf, Uh, Xu, Xu, Xu, Xu, Xu, Xu, Xu, Xu, Xu, Xu, Xu
Xu, Xu, Xu, Xu, Xu, Xu, Uh, Uu, Uu^Uf, Uu, Uu, Uu, Ur, Uu, Uu, Uu, Uu, Ur, Uu, Uu, Uh, Uh, Xu, Xu, Xu, Xu, Xu, Xu, Xu, Xu, Xu, Xu, Xu, Xu
