Hhd, Hhd, Hhd, Hhd, Hhd, Hhd, Hhd, Gd, Gd^Fetd, Re, Re, Gd^Fetd, Re^Es, Re, Gd^Es, Gd^Es, Gd^Es, Gd, Gd, Gd, Re, Re, Gd, Gd, Gd^Es, Gd, Gd, Gd, Re, Re^Es, Gd, Hhd, Hhd, Hhd, Hhd, Hhd, Hhd, Gd, Gd^Fetd, Re^Es, Re^Es, Gd, Re, Gd, Gd^Es, Gd^Es, Gd^Fetd, Gd^Es, Gd^Es, Gd, Gd, Gd^Fetd, Hhd, Hhd, Hhd, Hhd, Hhd, Hhd, Hhd
Hhd, Hhd, Hhd, Hhd, Hhd, Hhd, Re, Gd^Es, Re, Re, Re^Es, Gd^Fetd, Re^Es, Gd^Fetd, Re, Re, Gd, Re^Es, Gd, Gd, Re^Es, Gd^Es, Gd, Re, Gd, Re^Es, Gd, Gd^Es, Re^Es, Gd^Fetd, Re^Es, Re, Hhd, Hhd, Hhd, Hhd, Hhd, Re^Es, Gd^Fetd, Re, Gd^Es, Re, Gd^Es, Re, Re, Gd, Re, Re, Gd^Fetd, Gd^Fetd, Gd^Es, Re, Hhd, Hhd, Hhd, Hhd, Hhd, Hhd, Hhd
Hhd, Hhd, Hhd, Hhd, Hhd, Re, Re^Es, Re^Es, Gd^Xff, Gd^Xff, Gd^Xff, Re, Re, Gd, Re, Re, Gd, Re, Re, Re^Es, Re^Es, Re, Re^Es, Gd^Es, Gd, Re, Re, Re, Re, Re, Gd, Gd, Gd^Fetd, Hhd, Hhd, Hhd, Gd^Fetd, Gd^Fetd, Re^Es, Re^Es, Re, Re, Gd, Re, Gd, Re^Es, Gd^Es, Gd, Gd^Es, Gd^Es, Gg^Fet, Gd^Fetd, Gd^Fetd, Hhd, Hhd, Hhd, Hhd, Hhd, Hhd
Hhd, Hhd, Re, Hhd, Re, Re, Re^Es, Re, Ce, Re, Ce, Gd^Xff, Gd^Xff, Re, Gd^Fetd, Re^Es, Re^Es, Gd, Gd^Es, Re, Re, Gd, Gd^Es, Gd, Re, Gd, Re, Re^Es, Gd, Re^Es, Re^Es, Re^Es, Gd^Fetd, Gd, Gd^Es, Re, Re, Re^Es, Gd, Gd, Re, Gd, Hhd, Gd^Fetd, Re, Re^Es, Re, Gd^Fetd, Gg^Fet, Gg^Fet, Ce, Gg^Fet, Gg^Fet, Gd^Fetd, Gd^Fetd, Hhd, Hhd, Hhd, Hhd
Re, Hhd, Gd^Fetd, Re, Gd^Xff, Gd^Xff, Re^Es, Ce, Ke, Ce, Ce, Re, Gd^Xff, Re, Gd^Es, Re^Es, Re, Gd, Gd, Re, Re, Re, Gd^Es, Re^Es, Gd, Re, Re, Re, Gd^Es, Gd, Re, Gd^Es, Gd, Gd^Fetd, Re^Es, Re^Es, Gd, Re, Re, Re, Hhd, Hhd, Hhd, Hhd, Gd, Gd^Fetd, Re, Gd^Es, Gg^Fet, Ce, Ke, Ce, Ce, Gg^Fet, Re^Es, Re, Hhd, Hhd, Hhd
Gd, Re, Re, Re, Gd^Xff, Re, Ce, Ce, Ce, Ce, Re^Es, Re, Re^Es, Re, Gd^Es, Gd, Re, Re, Gd, Re^Es, Re, Gd^Fetd, Gd^Fetd, Re^Es, Gd^Fetd, Gd, Gd^Es, Re^Es, Gd, Gd^Es, Re^Es, Gd, Re, Re, Re^Es, Gd, Gd, Re^Es, Gd, Gd^Fetd, Hhd, Hhd, Hhd, Hhd, Gd^Fetd, Gd^Fetd, Gd^Es, Gd^Fetd, Gg^Fet, Ce, Ce, Ce, Ce, Gg^Fet, Gd^Es, Gd, Re, Hhd, Gd^Fetd
Re, Gd^Es, Gd^Es, Re^Es, Gd^Xff, Re, Re, Ce, Re, Ce, Re, Re^Es, Re, Gd, Gd^Es, Gd^Es, Gd, Re, Gd, Gd^Fetd, Gd^Fetd, Gd^Fetd, Hhd, Gd, Gd^Fetd, Gd^Fetd, Gd^Fetd, Re, Re^Es, Re^Es, Re, Re, Re^Es, Re^Es, Re, Re^Es, Gd^Es, Gd^Es, Re, Gd^Fetd, Re, Hhd, Hhd, Hhd, Gd, Re^Es, Gd^Es, Gd^Fetd, Gd^Fetd, Gg^Fet, Gg^Fet, Gg^Fet, Gg^Fet, Gg^Fet, Re^Es, Gd^Fetd, Gd^Fetd, Gd^Fetd, Gd^Es
Re^Es, Gd^Fetd, Gd, Re^Es, Re, Gd^Xff, Re, Re^Es, Gd^Xff, Gd^Xff, Gd^Xff, Re^Es, Gd^Es, Re, Gd, Re^Es, Re, Re^Es, Re, Re, Hhd, Hhd, Md, Hhd, Hhd, Gd, Gd^Fetd, Gd^Es, Re, Re, Re, Gd^Es, Re, Gd, Gd, Re^Es, Re, Re, Re^Es, Gd^Es, Gd, Gd, Re, Gd, Re^Es, Gd^Es, Gd, Re^Es, Re, Gd, Re, Gd, Gd^Fetd, Gd, Gd^Fetd, Re^Es, Gd, Re, Gd^Es
Gd^Es, Gd^Fetd, Gd^Fetd, Gd^Es, Re^Es, Gd^Es, Gd^Es, Re^Es, Re, Gd, Re, Re, Gd^Es, Gd^Es, Gd, Gd^Es, Gd, Re, Hhd, Hhd, Md, Md, Hhd, Md, Md, Hhd, Hhd, Gd, Gd, Re^Es, Re, Gd, Re, Gd^Es, Gd, Gd, Re^Es, Re, Re^Es, Gd, Re^Es, Re^Es, Re^Es, Gd, Gd^Es, Re^Es, Gd, Re^Es, Gd, Re^Es, Re^Es, Gd, Gd^Es, Gd, Re, Gd^Fetd, Gd^Fetd, Gd^Fetd, Re
Gd^Es, Re, Gd, Re, Gd^Es, Re^Es, Re, Gd, Hhd, Hhd, Hhd, Hhd, Hhd, Gd^Es, Re^Es, Re^Es, Re^Es, Gd, Hhd, Hhd, Hhd, Hhd, Gd, Hhd, Md, Md, Hhd, Re, Re, Re^Es, Re^Es, Re, Gd, Re, Gd^Es, Re^Es, Re^Es, Gd, Gd, Gd, Re^Es, Re, Gd, Gd, Gd, Re^Es, Gd, Gd^Es, Re^Es, Re^Es, Gd, Gd^Es, Re, Re^Es, Re, Gd^Es, Gd, Re, Gd^Fetd
Re, Gd^Es, Gd, Re, Gd^Es, Re^Es, Gd, Hhd, Md, Md, Hhd, Md, Hhd, Gd, Gd^Es, Gd, Gd, Re, Gd^Xff, Hhd, Gd^Xff, Gd, Gd^Xff, Hhd, Hhd, Hhd, Re, Re, Gd, Gd^Es, Re, Gd, Re^Es, Re, Re, Re, Gd, Re^Es, Gd^Es, Gd, Re, Re, Gd, Re^Es, Re^Es, Gd, Re, Re, Re, Re, Re^Es, Re, Gd, Gd, Re, Gd, Gd^Fetd, Re, Re
Gd, Re, Gd^Es, Gd, Gd, Re^Es, Gd, Hhd, Md, Hhd, Re, Hhd, Re, Re, Gd^Es, Re, Re, Re, Gd^Es, Gd^Xff, Re^Es, Re, Re, Gd^Xff, Gd^Xff, Gd^Xff, Gd, Re^Es, Re^Es, Gd^Es, Gd^Es, Gd, Re^Es, Re^Es, Re, Gd^Es, Re, Gd^Es, Re^Es, Re^Es, Gd, Re^Es, Gd^Es, Gd^Es, Gd, Re, Gd^Fetd, Gd^Fetd, Gd^Fetd, Gd, Re, Re^Es, Gd, Gd, Re, Gd^Fetd, Re^Es, Gd^Fetd, Gd^Fetd
Re, Re, Re, Gd, Gd, Re, Re, Hhd, Hhd, Hhd, Gd, Gd, Re^Es, Gd^Es, Gd, Gd, Re^Es, Gd, Re^Es, Gd^Es, Gd, Gd^Xff, Re^Es, Gd^Es, Re, Re^Es, Re, Re, Gd^Es, Re, Gd^Es, Re, Re, Gd, Rd, Re, Gd, Re, Re^Es, Gd, Gd^Es, Re, Gd, Gd, Re, Re, Hhd, Gd, Gd^Fetd, Gd^Fetd, Re, Re^Es, Re^Es, Gd^Es, Re^Es, Re^Es, Gd^Fetd, Gd, Gd^Es
Re, Gd^Es, Gd, Re^Es, Gd, Re, Re, Hhd, Gd, Re, Re, Re^Es, Re, Gd, Gd, Gd^Es, Re, Re^Es, Re, Gd^Es, Re^Es, Gd^Es, Re, Gd, Rd, Re, Gd, Re^Es, Gd, Gd^Es, Re, Gd, Rd, Rd, Uu, Rd, Rd, Gd^Es, Re^Es, Gd^Es, Re^Es, Re^Es, Re, Re, Hhd, Hhd, Md, Hhd, Hhd, Gd^Fetd, Gd, Gd^Es, Gd^Es, Gd, Gd, Re, Gd, Gd^Fetd, Gd^Fetd
Re^Es, Gd, Gd^Es, Gd, Gd, Re, Gd, Re, Gd, Re, Gd^Es, Gd, Gd, Re^Es, Re, Re, Rd, Gd, Gd, Re^Es, Re, Gd, Rd, Rd, Uu, Rd, Rd, Rd, Rd, Re, Re, Gd, Rd, Uu, Qlf, Uu, Rd, Re, Re^Es, Re, Gd^Es, Gd, Gd^Xff, Re, Hhd, Hhd, Md, Md, Hhd, Hhd, Re, Gd, Re^Es, Gd^Es, Re, Gd^Es, Gd, Gd^Es, Gd
Gd^Es, Re^Es, Re, Gd^Es, Re, Gd^Es, Gd, Gd, Gd^Es, Gd^Es, Rd, Rd, Rd, Gd, Rd, Rd, Uu, Rd, Rd, Re, Gd, Re, Rd, Uu, Qlf, Uu, Uu, Uu, Uu, Rd, Rd, Rd, Uu, Uu, Qlf, Uu, Rd, Re^Es, Re^Es, Gd, Gd, Re^Es, Gd, Gd^Xff, Hhd, Hhd, Hhd, Md, Hhd, Hhd, Re, Gd^Es, Gd, Re^Es, Re^Es, Re, Re, Re, Re
Re^Es, Gd, Gd, Gd, Gd, Re^Es, Re, Re, Gd, Rd, Uu, Uu, Uu, Rd, Rd, Uu, Qlf, Uu, Uu, Rd, Hhd, Gd, Hhd, Uu, Uu, Qlf, Uu, Qlf, Uu, Rd, Uu, Uu, Uu, Qlf, Uu, Uu, Rd, Gd, Re, Gd, Gd^Es, Gd^Es, Re^Es, Gd^Xff, Re, Gd, Gd, Hhd, Hhd, Hhd, Gd, Re^Es, Gd, Gd, Re, Gd, Gd^Es, Gd, Re
Re^Es, Re, Gd^Es, Gd^Es, Gd, Re, Re, Re^Es, Rd, Rd, Uu, Qlf, Uu, Rd, Rd, Uu, Uu, Qlf, Uu, Hhd, Md, Hhd, Md, Hhd, Uh, Qlf, Qlf, Qlf, Uu, Rd, Uu, Qlf, Qlf, Qlf, Qlf, Uu, Rd, Re, Rd, Rd^Es, Rd, Rd, Rd, Re^Es, Re, Gd^Xff, Gd^Xff, Gd^Xff, Gd^Xff, Hhd, Gd, Re, Re, Re, Gd^Es, Gd, Gd^Es, Re^Es, Gd^Es
Gd, Gd^Es, Re, Re^Es, Gd^Es, Gd^Es, Re^Es, Gd^Es, Rd, Uu, Qlf, Qlf, Qlf, Uu, Uu, Uu, Qlf, Qlf, Uh, Uh, Md, Md, Md, Md, Uh, Uu, Qlf, Uu, Rd, Rd, Rd, Uu, Uu, Uu, Qlf, Uu, Uu, Rd, Uu, Uu, Uu, Uu, Uu, Rd, Rd, Re^Es, Gd, Gd^Xff, Re, Re, Gd, Gd^Es, Re, Re, Gd^Es, Re, Re, Re^Es, Gd
Re^Es, Gd, Re, Gd, Gd^Es, Re, Gd, Gd, Rd, Uu, Uu, Uu, Qlf, Uu, Qlf, Uu, Qlf, Uu, Qlf, Md, Mv, Md, Hhd, Hhd, Uu, Uu, Qlf, Uu, Rd, Gd, Gd^Cov, Rd, Uu, Uu, Uh, Qlf, Uh, Uu, Qlf, Qlf, Qlf, Qlf, Qlf, Uu, Rd, Re^Es, Re, Gd^Xff, Gd, Gd^Es, Re^Es, Gd^Es, Gd^Es, Gd^Es, Re^Es, Gd^Es, Re, Re, Gd
Re^Es, Gd, Gd, Re, Re, Re, Gd^Es, Gd^Es, Re, Rd, Rd, Uu, Uu, Qlf, Uu, Qlf, Uu, Qlf, Uh, Md, Md, Md, Uh, Uu^Xsf, Qlf, Qlf, Uu, Uu, Rd^Cov, Rd, Rd^Cov, Rd, Uh^Cov, Hhd, Md, Qlf, Mv, Qlf, Uh, Uu, Uu, Uu, Uu, Uu, Rd, Gd^Es, Re, Gd, Gd^Es, Gd, Gd^Es, Gd^Es, Re, Re^Es, Gd, Gd, Re, Gd^Es, Re
Re, Re^Es, Gd^Es, Re^Es, Gd^Es, Re, Re, Re^Es, Gd, Re, Rd, Uu, Qlf, Qlf, Uu, Uu, Rd, Uu, Hhd, Md, Md, Qlf, Qsr, Qsr, Uu^Xsf, Uu, Hhd, Rd, Uu, Uu^Cov, Uu^Kov, Hhd^Cov, Hhd, Md, Md, Md, Md, Md, Hhd, Uu, Rd, Rd, Rd, Rd, Gd^Es, Re^Es, Re^Es, Gd, Re^Es, Re, Gd, Re, Re, Gd, Gd, Re, Re^Es, Re^Es, Gd
Gd^Es, Gd, Gd^Es, Re, Re, Gd^Es, Gd^Es, Re^Es, Re^Es, Gd, Rd, Uu, Uu, Uu, Rd, Rd, Re^Es, Rd, Rd, Hhd, Uu^Xsf, Uh, Qsr, Qsr, Uh, Uh, Md, Uh, Hhd, Hhd^Cov, Uh^Cov, Uh^Cov, Hhd, Md, Md, Md, Md, Md, Md, Hhd, Rd, Rd, Uu, Rd, Rd, Re^Es, Gd, Re^Es, Gd^Es, Re, Re, Re, Hhd, Hhd, Hhd, Re, Re, Re, Gd
Re^Es, Gd, Re^Es, Re, Gd, Gd, Re, Re, Gd^Es, Re, Gd^Es, Rd, Rd, Rd, Re, Gd, Rd, Rd, Uu, Uu, Uu^Xsf, Qsr, Uu, Qsr, Qsr, Md, Md, Md, Md, Md, Hhd, Hhd, Hhd, Md, Qsr, Qsr, Mv, Qsr, Qsr, Uu^Xsf, Rd, Uu, Qlf, Uu, Rd, Gd^Es, Gd^Es, Gd^Es, Re, Gd, Hhd, Hhd, Md, Hhd, Md, Hhd, Re, Gd, Gd
Re, Re, Gd^Es, Re^Es, Re^Es, Gd^Es, Re, Gd, Gd, Re, Gd, Gd^Es, Gd^Es, Gd^Es, Gd^Es, Re, Rd, Uu, Qlf, Qlf, Qlf, Qsr, Uu^Xsf, Uh, Md, Mv, Md, Md, Md, Md, Uu^Xsf, Hhd, Hhd, Uu^Xsf, Uu^Xsf, Md, Md, Md, Md, Uu^Xsf, Uu, Uu, Qlf, Uu, Rd, Gd, Re^Es, Re, Gd^Es, Gd, Hhd, Hhd, Md, Md, Md, Hhd, Hhd, Re, Gd^Es
Gd^Es, Gd, Re^Es, Re, Gd, Gd^Es, Re^Es, Gd^Es, Re, Re, Hhd, Hhd, Hhd, Re, Gd, Gd^Es, Rd, Uu, Uu, Uu, Qlf, Uu^Xsf, Rd, Uh, Md, Md, Md, Md, Qsr, Qsr, Qsr, Uu^Xsf, Hhd, Hhd, Hhd, Md, Qsr, Qsr, Md, Uh, Uu, Qlf, Uu^Xsf, Uu, Rd, Re, Gd^Es, Re, Re, Gd, Gd, Hhd, Hhd, Hhd, Hhd, Hhd, Hhd, Re^Es, Gd^Es
Re^Es, Re^Es, Gd^Es, Gd^Fetd, Gd^Es, Re, Re, Gd, Re^Es, Re, Hhd, Md, Md, Hhd, Hhd, Gd^Es, Re, Rd, Rd, Uu, Qlf, Uu, Rd^Es, Hhd, Hhd, Md, Md, Uu^Xsf, Hhd, Qsr^Cov, Md^Cov, Qsr^Cov, Mv^Cov, Hhd^Cov, Hhd, Md, Md, Md, Uh, Uu^Xsf, Uu, Qsr, Uu^Xsf, Rd, Uu, Rd, Rd, Gd^Es, Gd, Re, Gd^Es, Re, Gd^Es, Gd, Re, Hhd, Re, Gd, Gd^Es
Re, Gd^Es, Re, Gd^Fetd, Gd^Fetd, Gd^Fetd, Gd, Re^Es, Re, Gd, Hhd, Md, Hhd, Md, Hhd, Re^Es, Re^Es, Gd, Rd, Uu, Uu, Uu, Rd^Es, Gd, Hhd, Md, Md, Uu^Xsf, Hhd, Md, Md^Cov, 2 Md^Kov, Md^Cov, Md, Uu^Xsf, Uh, Uh, Uh, Qsr, Uu, Qsr, Qsr, Qsr, Uu^Xsf, Qlf, Uu, Uu, Rd, Gd, Re^Es, Gd, Re^Es, Re, Gd, Re^Es, Re, Gd, Gd^Es, Gd^Es
Re, Gd^Es, Gd, Gd^Fetd, Gd^Es, Gd^Fetd, Gd, Re, Re, Re, Gd, Hhd, Re, Hhd, Hhd, Gd^Es, Re, Re, Hhd, Rd, Rd^Es, Rd, Gd^Es, Hhd, Hhd, Hhd, Hhd, Hhd, Uu^Xsf, Md^Cov, Md, Mv^Cov, Md, Qsr^Cov, Qsr, Qsr, Qsr, Uu^Xsf, Uu^Xsf, Qsr, Uu, Uu^Xsf, Uu, Qlf, Uu, Qlf, Uu, Rd, Gd, Gd^Es, Re, Gd^Es, Re, Re, Re^Es, Gd^Es, Re^Es, Gd^Es, Gd^Es
Gd^Es, Re, Ce, Gd, Ce, Gd, Gd, Re^Es, Gd^Es, Gd, Re, Gd, Gd^Es, Gd, Re, Re, Gd^Es, Hhd, Hhd, Hhd, Re^Es, Re^Es, Gd^Es, Gd, Hhd, Hhd, Hhd, Hhd, Qxua, Qsr, Qsr, Md^Cov, Uh, Uh, Md, Md, Md, Md, Md, Uh, Hhd, Rd, Rd, Uu, Uu, Qlf, Uu, Rd, Re^Es, Re^Es, Gd, Re^Es, Gd^Es, Re, Gd, Re^Es, Re, Re, Gd
Gd^Es, Gd, Gd^Es, Ce, Re^Es, Gd^Es, Re^Es, Gd, Re^Es, Re, Gd, Re^Es, Gd, Gd, Rd, Gd, Gd^Es, Hhd, Hhd, Hhd, Gd, Gd^Es, Gd, Hhd, Hhd, Hhd, Md, Md, Qsr, Qxua, Qxua, Uu^Xsf, Hhd, Hhd, Md, Md, Md, Md, Md, Hhd, Hhd, Gd, Rd, Uu, Qlf, Qlf, Uu, Rd, Re^Es, Gd, Re, Gd^Es, Ce, Ce, Ce, Gd^Es, Ce, Re, Gd
Gd^Es, Re, Ce, Ce, Ce, Ce, Ce, Re, Re, Gd^Es, Re^Es, Gd^Es, Rd, Rd, Uu, Rd, Rd, Re, Re, Re, Re^Es, Re^Es, Rd, Hhd, Uh, Md, Md, Mv, Md, Qsr, Hhd, Uu^Xsf, Hhd, Hhd, Md, Md, Mv, Md, Md, Hhd, Uh, Uu^Xsf, Uu^Xsf, Uu, Uu, Uu, Rd, Rd, Gd, Re^Es, Re^Es, Gd^Es, Ce, Re^Es, Ce, Ce, Ce, Gd^Es, Gd
Gd^Es, Re^Es, Ce, Ke, Ce, Re, Ce, Ce, Gd^Es, Re, Re, Gd, Rd, Uu, Qlf, Uu, Uu, Rd, Gd^Es, Re^Es, Gd, Rd, Uu, Uh, Qsr, Qsr, Md, Md, Md, Qsr, Uu^Xsf, Hhd, Md, Hhd, Md, Md, Md, Md, Md, Md, Qsr, Qsr, Uu^Xsf, Rd, Rd, Rd, Gd, Gd^Es, Re^Es, Re^Es, Gd^Es, Re, Gd^Es, Ce, Ce, Ke, Ce, Ce, Gd
Gd, Re, Re^Es, Ce, Gd^Es, Ce, Gd, Gd, Re, Re, Rd, Rd, Rd, Uu, Uu, Qlf, Uu, Rd^Es, Rd, Gd, Hhd, Hhd, Uh, Uu^Xsf, Qsr, Uh, Uh, Md, Hhd, Uu^Xsf, Hd, Md, Md, Md, Md, Md, Md, Qsr, Qsr, Uh, Qsr, Uu, Rd, Rd, Hhd, Rd, Rd, Re^Es, Gd, Re^Es, Gd, Gd, Re, Re, Ce, Ce, Ce, Gd, Gd
Gd, Gd, Ce, Ce, Ce, Re, Re, Re, Rd, Rd, Uu, Uu, Uu, Rd, Uu, Qlf, Uu, Rd, Uu, Hhd, Md, Md, Md, Uh, Qlf, Uu^Xsf, Uu, Hhd, Re, Hhd, Hd, Md, Md^Cov, Md, Md, Md, Hhd, Uu^Xsf, Qsr, Qsr, Uu^Xsf, Uu, Hhd, Hhd, Md, Hhd, Rd, Re^Es, Gd, Re, Gd^Es, Re^Es, Re, Gd, Ce, Re, Ce, Re^Es, Gd
Hhd, Gd, Re, Re, Gd^Es, Gd^Es, Re, Gd, Rd, Uu, Qlf, Qlf, Qlf, Uu, Qlf, Qlf, Qlf, Uu, Uu, Uh, Md, Md, Ql, Qlf, Uh, Uh, Hhd, Re, Re^Es, Ds, Ds, Hd^Cov, Hhd^Kov, Md^Cov, Hhd, Md, Uh, Uh, Qsr, Uu^Xsf, Rd, Rd, Hhd, Md, Md, Hhd, Rd, Gd^Es, Re^Es, Gd, Re, Gd, Gd^Xff, Gd^Es, Re, Ce, Gd^Es, Gd^Es, Gd
Hhd, Re, Re, Gd^Es, Re, Gd, Re^Es, Re, Rd, Uu, Uu, Uu, Uu, Qlf, Uu, Uu, Qlf, Uu, Uu, Uh, Md, Mv, Md, Ql, Md, Md, Md, Hhd, Gd^Es, Ds, Ds^Cov, Ds^Cov, Rd^Cov, Hhd^Cov, Hhd^Cov, Uh, Uu^Xsf, Qsr, Uu^Xsf, Uu, Hhd, Hhd, Md, Md, Md, Hhd, Rd, Rd, Rd, Gd^Es, Gd, Gd^Xff, Re, Gd, Gd^Xff, Re, Gd^Es, Re, Gd
Hhd, Hhd, Hhd, Re, Gd, Gd^Es, Re, Gd^Es, Gd, Rd, Rd, Rd, Uu, Qlf, Uu, Uu, Uu, Qlf, Qlf, Qlf, Qlf, Md, Md, Ql, Md, Md, Hhd, Hhd, Re^Es, Re, Sm, Ds, Rd^Cov, Rd, Rd, Rd, Rd, Uu^Xsf, Rd, Rd, Uh, Md, Md, Md, Hhd, Hhd, Uu, Uu, Uu, Rd, Re, Re, Gd^Es, Gd^Xff, Gd, Gd^Es, Re^Es, Re, Gd
Hhd, Hhd, Hhd, Gd, Re, Gd^Es, Gd, Re, Re, Re^Es, Gd^Es, Rd, Rd, Uu, Rd, Rd, Uu, Uu, Qlf, Uu, Qlf, Uh, Uh, Uh, Hhd, Hhd, Gd, Gd, Re^Es, Re, Sm, Sm, Re, Re, Gd^Es, Rd, Rd, Uu, Uu, Uh, Md, Mv, Md, Md, Uh, Uu, Uu, Qlf, Uu, Rd, Re^Es, Gd^Xff, Gd^Xff, Re^Es, Re, Gd^Es, Re, Gd^Es, Gd
Hhd, Hhd, Hhd, Gd, Re, Re, Re^Es, Gd, Gd, Gd, Re, Re^Es, Re^Es, Rd, Rd, Rd, Uu, Qlf, Uu, Uu, Qlf, Uu, Uu, Uu, Rd, Gd^Es, Re^Es, Re^Es, Re^Es, Gd, Sm, Sm, Gd, Re, Rd, Rd, Rd, Uu, Qlf, Qlf, Uh, Md, Md, Qlf, Qlf, Qlf, Qlf, Qlf, Uu, Rd, Re^Es, Gd, Re, Re^Es, Re^Es, Re^Es, Gd, Re, Re
Hhd, Hhd, Hhd, Hhd, Hhd, Re, Re^Es, Re, Re^Es, Gd^Es, Re^Es, Re^Es, Re, Rd, Uu, Uu, Qlf, Qlf, Qlf, Uu, Uu, Uu, Rd, Rd, Gd^Es, Re^Es, Re, Re, Wwf, Wwf, Wwf, Sm, Re, Re, Gd^Es, Gd, Gd, Uu, Uu, Qlf, Qlf, Uh, Hhd, Uh, Uu, Uu, Qlf, Uu, Rd, Rd, Gd^Es, Re, Gd, Gd, Re, Gd, Gd, Gd, Gd^Es
Hhd, Hhd, Hhd, Hhd, Hhd, Gd, Gd, Re^Es, Gd, Re^Es, Gd, Gd, Gd, Rd, Uu, Qlf, Uu, Uu, Uu, Qlf, Uu, Uu, Uu, Rd, Re, Re, Re, Wwf, Wwf, Wwf, Gd, Re, Gd, Re, Gd^Es, Rd, Rd, Rd, Rd, Uu, Uu, Uu, Rd, Uu, Uu, Uu, Qlf, Uu, Uu, Rd, Rd, Gd^Es, Re, Gd^Es, Re, Gd^Es, Gd, Re^Es, Gd^Es
Hhd, Hhd, Hhd, Hhd, Re, Gd, Re, Gd^Es, Re, Re, Gd^Es, Gd, Gd^Es, Rd, Rd, Uu, Rd, Uu, Qlf, Qlf, Qlf, Qlf, Uu, Rd, Re, Re^Es, Wwf, Wwf, Wwf, Re, Re, Gd^Es, Re, Re^Es, Gd, Rd, Rd, Rd, Rd, Gd, Gd, Uu, Rd, Rd, Uu, Qlf, Uu, Qlf, Qlf, Uu, Rd, Re^Es, Hhd, Gd, Hhd, Re^Es, Re^Es, Re, Gd^Es
Hhd, Hhd, Re, Gd, Gd, Re^Es, Gd, Re^Es, Gd^Es, Re^Es, Gd^Es, Re, Re^Es, Gd^Es, Gd^Es, Rd, Rd, Uu, Qlf, Uu, Uu, Uu, Rd, Rd, Gd, Re^Es, Wwf, Wwf, Wwf, Re, Re^Es, Re^Es, Re, Gd, Gd, Rd, Gd, Gd, Rd, Rd, Gd, Gd, Uu, Rd, Uu, Qlf, Uu, Uu, Qlf, Uu, Rd, Re^Es, Hhd, Hhd, Hhd, Gd, Re, Gd^Es, Gd^Es
Re, Hhd, Gd, Gd^Es, Gd^Es, Gd^Es, Gd^Es, Re^Es, Gd, Gd, Re^Es, Re^Es, Re, Re^Es, Re^Es, Gd, Rd, Uu, Uu, Uu, Rd, Rd, Re^Es, Gd^Es, Re^Es, Re^Es, Wwf, Wwf, Wwf, Gd, Gd, Re, Re^Es, Gd, Rd, Rd, Rd, Gd, Gd, Rd, Rd, Gd, Gd, Rd, Rd^Es, Uu, Rd, Uu, Uu, Uu, Rd, Gd^Es, Hhd, Hhd, Hhd, Hhd, Gd, Gd, Gd
Gd, Re, Re, Gd^Es, Re, Re, Gd, Gd, Gd, Re, Re, Gd, Re, Re, Re, Re, Gd, Rd, Rd, Rd^Es, Re, Re^Es, Re^Es, Re, Gd, Re, Wwf, Wwf, Wwf, Re, Gd^Es, Re, Re, Re^Es, Gd^Es, Gd, Rd, Rd, Gd, Gd, Rd, Rd, Rd, Gd, Re^Es, Rd, Gd, Rd, Rd, Rd, Gd^Es, Gd, Hhd, Hhd, Hhd, Hhd, Re, Gd, Re
Re, Re, Gd, Re, Re, Gd^Es, Gd, Re, Gd, Gd, Gd^Es, Gd^Es, Re, Gd^Es, Re, Re, Re, Gd, Gd, Gd^Es, Re^Es, Re, Gd^Es, Gd^Es, Gd^Es, Re, Wwg, Wwf, Wwg, Re, Re^Es, Gd^Es, Re^Es, Re, Re^Es, Gd^Es, Gd, Re, Gd^Xff, Re, Gd, Rd, Gd, Gd^Es, Gd, Gd^Es, Re^Es, Re, Re^Es, Gd, Re, Re, Hhd, Hhd, Re^Es, Re, Re^Es, Re, Gd^Es
Re, Gd^Es, Re, Re, Gd, Gd, Re, Gd^Es, Re^Es, Gd^Es, Gd^Es, Gd, Re^Es, Re^Es, Gd, Gd^Es, Gd, Re^Es, Gd^Es, Re, Gd^Es, Gd^Es, Wwg, Wwg, Wwg, Wwf, Wwg, Wwg, Gd, Gd, Gd^Es, Gd, Gd^Es, Re^Es, Gd, Re, Re, Gd^Xff, Gd, Gd^Xff, Re^Es, Re, Re^Es, Re^Es, Re^Es, Re, Re, Gd^Es, Gd, Re, Hhd, Gd, Re^Es, Gd^Es, Gd^Es, Re^Es, Re^Es, Gd, Gd
Gd, Re, Gd, Gd, Re, Gd^Es, Gd^Fetd, Gd, Gd^Fetd, Re, Gd^Es, Gd^Fetd, Re, Re, Gd^Fetd, Gd^Es, Gd^Es, Gd^Fetd, Re, Gd, Wwf, Wwg, Wwf, Wwf, Wwf, Wwf, Re, Re, Re, Gd, Gd^Es, Re, Re^Es, Re^Es, Re, Gd^Es, Gd, Gd^Es, Re^Es, Gd^Es, Re, Gd, Re, Gd, Re, Re, Re, Re, Hhd, Hhd, Hhd, Re^Es, Re, Gd, Re^Es, Re, Gd^Es, Re, Gd
Re, Gd^Es, Re, Re, Re^Es, Gd, Gd^Fetd, Gd, Gd, Gd, Gd^Fetd, Gd, Re, Re, Re, Gd^Fetd, Gd^Fetd, Re, Wwg, Wwf, Wwg, Wwg, Re, Re, Gd, Re, Gd, Re, Re^Es, Re^Es, Re, Re, Re, Gd, Gd, Re, Re, Gd^Es, Re, Re, Gd, Re, Re, Re, Gd^Es, Re, Gd, Hhd, Hhd, Hhd, Hhd, Gd, Re^Es, Re^Es, Re^Es, Gd, Gd^Es, Re^Es, Gd^Es
Re, Gd, Re, Gd^Es, Gd, Re, Gd^Fetd, Gd^Fetd, Re, Gd^Fetd, Wwg, Wwg, Wwg, Wwg, Wwg, Gd^Fetd, Re, Gd^Es, Wwg, Wwg, Wwf, Gd, Gd^Fetd, Gd^Es, Re, Gd^Es, Re, Gd, Re, Re, Gd, Gd, Re, Re^Es, Re, Re, Gd^Es, Re^Es, Re, Gd, Gd, Re^Es, Re, Re^Es, Re, Gd, Re, Gd, Hhd, Hhd, Gd, Re, Gd, Gd, Gd^Es, Re, Re^Es, Re, Gd^Es
Re, Gd^Es, Gd^Fetd, Gd, Gd, Re, Gd, Re, Wwg, Wwg, Wwg, Wwg, Wwg, Wwg, Wwg, Wwg, Wwg, Wwf, Wwg, Wwg, Re, Gd^Fetd, Gd^Es, Gd^Fetd, Gd^Es, Re^Es, Gd, Hhd, Hhd, Hhd, Hhd, Hhd, Hhd, Re^Es, Gd, Re^Es, Gd, Re, Re^Es, Re^Es, Gd, Re, Re, Gd^Es, Re^Es, Gd, Gd^Es, Gd, Re, Re, Re, Re, Re^Es, Re^Es, Gd, Re, Gd, Re, Gd
Gd, Gd^Fetd, Re, Gd^Es, Gd^Fetd, Gd, Gd^Fetd, Gd, Wwg, Wwg, Wwg, Wwg, Wwg, Wwg, Wwg, Wwg, Wwg, Wwg, Wwg, Wwf, Gd^Fetd, Re, Re^Es, Gd^Fetd, Re, Re, Gd, Hhd, Hhd, Hhd, Hhd, Hhd, Hhd, Re, Re, Gd, Re^Es, Re, Re, Gd, Gd, Re, Gd, Gd, Re^Es, Gd, Re, Re, Gd^Es, Re, Gd^Es, Gd, Gd^Es, Re, Gd^Es, Re, Re, Re, Gd
Gd^Fetd, Gd, Gd^Es, Gd, Gd, Re, Wwg, Wwg, Wwg, Wwg, Re, Re, Re, Gd, Re, Wwg, Gd, Wwg, Gd, Gd, Re, Gd^Es, Re, Re^Es, Gd^Es, Re, Re, Hhd, Gd, Hhd, Gd, Hhd, Gd, Hhd, Gd, Re, Re, Gd^Es, Gd, Gd, Hhd, Re, Hhd, Gd, Re^Es, Re, Gd, Gd, Re, Gd, Re, Re, Re, Gd, Gd, Re, Re, Re^Es, Gd
Re^Es, Re, Gd, Re, Wwg, Wwg, Wwg, Wwg, Ce, Wwg, Gd^Fetd, Gd^Fetd, Re^Es, Gd^Fetd, Re, Gd^Fetd, Re, Re, Re, Gd, Re^Es, Re, Gd^Es, Re^Es, Re, Gd, Gd, Hhd, Re, Re, Gd, Gd, Gd^Es, Gd, Re^Es, Gd^Es, Gd, Re, Re, Hhd, Hhd, Hhd, Hhd, Gd, Gd, Re^Es, Re, Gd, Re^Es, Gd, Re^Es, Re, Re, Re, Re, Gd^Es, Gd^Es, Gd, Gd
Re^Es, Gd, Gd^Fetd, Gd, Wwg, Wwg, Ce, Wwg, Ce, Re, Gd, Gd^Fetd, Gd, Gd^Fetd, Gd, Gd, Gd, Re^Es, Gd^Es, Gd^Es, Gd, Gd^Es, Re^Es, Re^Es, Gd^Es, Re, Gd, Re, Re, Re, Re^Es, Re^Es, Re, Re^Es, Gd, Gd^Es, Re^Es, Re, Gd, Hhd, Hhd, Hhd, Hhd, Gd, Gd^Es, Re^Es, Gd, Re^Es, Gd, Re, Gd, Gd^Es, Re, Gd, Ce, Re^Es, Gd^Fetd, Re, Gd^Fetd
Gd^Fetd, Gd^Es, Gd^Fetd, Re^Es, Wwg, Wwg, Wwg, Ce, Ke, Ce, Re^Es, Re^Es, Gd^Es, Re^Es, Gd, Re, Re^Es, Re^Es, Re, Re^Es, Gd, Gd, Gd, Re, Gd, Gd^Es, Ce, Ce, Ce, Ce, Ce, Re, Re, Re^Es, Re, Gd, Re, Re, Gd, Re, Hhd, Hhd, Hhd, Re, Gd, Re, Gd, Re, Re, Gd, Re, Gd^Es, Re, Ce, Re^Es, Ce, Gd^Fetd, Gd^Fetd, Gd^Es
Gd, Re^Es, Gd, Gd, Re, Wwg, Ce, Ce, Ce, Ce, Re, Gd, Gd, Gd, Gd^Es, Gd^Es, Re, Re, Hhd, Re, Gd, Re^Es, Gd^Es, Re, Gd, Re, Ce, Gd^Es, Ce, Re, Ce, Gd, Re, Re^Es, Gd^Es, Re, Re, Re, Re, Gd, Gd, Re, Re, Re, Gd, Re^Es, Re, Re, Re^Es, Re, Ce, Re, Re^Es, Ce, Ce, Ce, Gd^Fetd, Gd^Fetd, Gd^Fetd
Gd, Re^Es, Gd, Re^Es, Gd^Es, Wwg, Wwg, Gd, Re, Re^Es, Gd, Re, Re, Re^Es, Gd^Es, Re, Re, Hhd, Hhd, Hhd, Hhd, Gd, Gd, Gd, Re, Ce, Re^Es, Ce, Ke, Ce, Gd, Ce, Re, Re, Gd^Fetd, Gd^Fetd, Gd, Re^Es, Gd, Re^Es, Gd^Es, Gd, Gd, Re, Gd, Gd, Re^Es, Re, Re^Es, Ce, Gd^Es, Ce, Ce, Ce, Ce, Gd, Hhd, Re, Gd
Gd, Re, Wwg, Gd, Wwg, Wwg, Wwg, Re, Re, Re^Es, Re, Gd, Gd, Re, Re^Es, Gd, Gd, Hhd, Hhd, Hhd, Hhd, Re, Gd, Gd^Es, Re, Ce, Ce, Ce, Ce, Ce, Ce, Ce, Re, Re, Gd^Fetd, Gd^Fetd, Gd^Fetd, Re^Es, Gd, Re, Re, Re, Gd^Es, Re, Re, Gd, Re^Es, Gd^Es, Gd^Es, Ce, Ce, Ce, Ce, Ke, Ce, Hhd, Hhd, Hhd, Hhd
Wwg, Wwg, Wwg, Wwg, Wwg, Wwg, Gd^Fetd, Gd, Gd^Fetd, Re, Gd, Re^Es, Gd^Es, Gd^Es, Gd, Gd, Gd, Hhd, Hhd, Hhd, Gd, Gd, Gd, Gd^Es, Re, Gd^Es, Ce, Gd^Es, Ce, Gd, Ce, Re, Re, Gd, Gd^Es, Gd^Fetd, Re, Gd^Es, Re^Es, Gd, Re^Es, Gd, Re, Gd, Re^Es, Re, Re^Es, Gd, Re^Es, Re^Es, Re, Re, Hhd, Ce, Hhd, Hhd, Hhd, Hhd, Hhd
Wwg, Wwg, Gd, Wwg, Re, Re, Gd^Fetd, Re^Es, Gd^Fetd, Gd, Re, Gd, Gd, Re^Es, Re^Es, Gd, Re, Hhd, Re, Hhd, Gd, Re, Gd^Es, Gd, Gd, Gd, Re, Ce, 1 Gd^Es, Ce, Re, Re, Gd^Es, Re, Gd^Es, Gd, Gd, Re, Re, Gd, Gd^Es, Re, Gd, Gd^Es, Re, Re, Gd, Re, Gd, Gd^Fetd, Gd, Re, Hhd, Hhd, Hhd, Hhd, Hhd, Hhd, Hhd
Re, Gd, Gd^Es, Gd, Re, Gd^Fetd, Gd^Fetd, Gd^Es, Re^Es, Re, Gd^Es, Gd, Gd, Re, Gd, Re, Re, Re, Gd, Gd, Gd^Es, Re, Re, Re, Gd, Gd, Re^Es, Re, Gd, Gd, Re, Gd, Gd^Es, Gd, Gd, Re, Re, Gd, Re, Re, Gd^Es, Gd, Gd^Es, Gd^Es, Re^Es, Gd, Gd, Gd^Fetd, Gd^Fetd, Gd^Fetd, Re, Hhd, Hhd, Hhd, Hhd, Hhd, Hhd, Hhd, Hhd
Gd, Gd^Fetd, Re, Re, Gd, Re^Es, Re, Gd^Fetd, Gd, Gd, Gd, Gd, Gd^Es, Gd^Es, Gd, Gd^Es, Gd, Gd^Es, Gd^Es, Gd, Gd, Gd, Gd, Gd, Gd, Gd^Es, Gd^Es, Gd, Re, Re^Es, Gd, Gd^Es, Gd, Gd, Gd, Re^Es, Gd^Es, Gd, Gd, Gd^Es, Re^Es, Gd^Es, Re, Gd, Gd, Gd^Es, Gd, Gd^Fetd, Gd, Gd^Fetd, Gd, Hhd, Hhd, Hhd, Re, Hhd, Hhd, Hhd, Gd
