Xoi, Xoi, Xoi, Xoi, Xoi, Irs, Irs, Irs, Irs, Irs, Irs, Irs, Irs, Irs, Xoi, Xoi, Xoi, Xoi, Xoi, Xoi, Xoi
Xoi, Xoi, Xoi, Xoi, Xoi, Irs, Irs, Irs, Irs, Irs, Irs, Irs, Irs, Irs, Xoi, Xoi, Xoi, Xoi, Xoi, Xoi, Xoi
Xoi, Xoi, Xoi, Xoi, Xoi, Irs, Irs, 1 Irs, Irs, Irs, Irs, Irs, Irs, Irs, Xoi, Xoi, Xoi, Xoi, Xoi, Xoi, Xoi
Xoi, Xoi, Xoi, Xoi, Xoi, Xoi, Xoi, Irs, Irs, Irs, Irs, Irs, Xoi, Xoi, Xoi, Xoi, Xoi, Xoi, Xoi, Xoi, Xoi
Xoi, Xoi, Xoi, Irs, Irs, Irs, Xoi, Irs, Irs, Irs, Irs, Irs, Xoi, Irs, Irs, Irs, Xoi, Xoi, Xoi, Xoi, Xoi
Xoi, Xoi, Xoi, Irs, Irs^Ii, Irs, Xoi, Irs, Irs, Irs, Irs, Irs, Xoi, Irs, Irs^Ii, Irs, Xoi, Xoi, Xoi, Xoi, Xoi
Xoi, Xoi, Xoi, Irs, Rrc^Gms, Irs, Xoi^Efs, Irs, Irs, Irs, Irs, Irs, Xoi^Efs, Irs, Rrc^Gmfs, Irs, Xoi, Xoi, Xoi, Xoi, Xoi
Xoi, Xoi, Xoi, Irs, Irs^Ii, Irs, Irs, Irs, Irs, Irs, Irs, Irs, Irs, Irs, Irs^Ii, Irs, Xoi, Xoi, Xoi, Xoi, Xoi
Xoi, Xoi, Xoi, Irs, Irs, Irs, Irs, Irs, Irs^Ii, Irs^Ii, Irs^Ii, Irs, Irs, Irs, Irs, Irs, Xoi, Xoi, Xoi, Xoi, Xoi
Xoi, Xoi, Xoi, Irs, Irs^Ii, Irs, Irs, Irs, Irs, Irs, Irs, Irs, Irs, Irs, Irs^Ii, Irs, Xoi, Xoi, Xoi, Xoi, Xoi
Xoi, Xoi, Xoi, Irs, Rrc^Gmfs, Irs, Irs, Irs^Ii, Irs^Ii, Irs, Irs^Ii, Irs^Ii, Irs, Irs, Rrc^Gms, Irs, Xoi, Xoi, Xoi, Xoi, Xoi
Xoi, Xoi, Xoi, Irs, Irs^Ii, Irs, Irs^Ii, Irs, Irs, Irs^Ii, Irs, Irs, Irs^Ii, Irs, Irs^Ii, Irs, Xoi, Xoi, Xoi, Xoi, Xoi
Xoi, Xoi, Xoi, Irs, Irs, Irs^Ii, Irs, Rrc^Gmfs, Irs, Irs, Irs, Rrc^Gms, Irs, Irs^Ii, Irs, Irs, Xoi, Xoi, Xoi, Xoi, Xoi
Xoi, Xoi, Xoi, Irs, Xoi, Irs, Xoi, Irs, Irs, Rrc^Delf, Irs, Irs, Xoi, Irs, Xoi, Irs, Xoi, Xoi, Xoi, Xoi, Xoi
Xoi, Xoi, Xoi, Xoi, Xoi, Xoi, Xoi, Xoi, Xoi, Irs, Xoi, Xoi, Xoi, Xoi, Xoi, Xoi, Xoi, Xoi, Xoi, Xoi, Xoi
Xoi, Xoi, Xoi, Xoi, Xoi, Xoi, Xoi, Xoi, Xoi, Xoi, Xoi, Xoi, Xoi, Xoi, Xoi, Xoi, Xoi, Xoi, Xoi, Xoi, Xoi
