Gs^Fms, Gs^Fms, Gll, Gll, Gs^Fms, Gs^Fct, Gs^Fct, Gs^Fms, Gs^Fct, Gs^Fms, Gs^Fms, Gs^Fms, Gs^Fms, Gs^Fct, Gs^Fct, Gs^Fct, Gs^Fct, Gs^Fms, Gs^Fms, Gs^Fct, Gs^Fct, Gs^Fms, Gs^Fms, Gs^Fms, Gs^Fms, Gs^Fms, Gs^Fct, Gs^Fms, Gs^Fct, Gs^Fct, Gs^Fms, Gs^Fms, Gs^Fct, Gs^Fms, Gs^Fms, Gs^Fms, Gs^Fct, Gs^Fms, Gs^Fms, Gs^Fms
Gs^Fct, Gs^Fct, Gs^Fms, Gs^Fct, Gs^Fms, Gs^Fms, Gll, Gll, Gs^Fct, Gs^Fct, Gs^Fct, Gll, Gll, Gs^Fct, Gll, Gll, Gs^Fct, Gs^Fct, Gs^Fct, Gs^Fct, Gs^Fct, Gs^Fms, Gll, Gs^Fct, Gs^Fct, Gll, Gs^Fct, Gs^Fms, Gs^Fct, Gs^Fms, Gll, Gs^Fms, Gs^Fms, Gs^Fct, Gs^Fms, Gs^Fms, Gs^Fms, Gs^Fms, Gs^Fct, Gs^Fms
Gs^Fct, Gll, Gs^Fct, Gs^Fct, Gs^Fct, Gs^Fms, Gs^Fct, Gs^Fct, Gs^Fms, Gs^Fms, Gs^Fms, Gs^Fct, Gs^Fms, Gll, Gs^Fct, Gs^Fct, Gs^Fct, Gs^Fct, Gll, Gll, Gs^Fms, Gs^Fct, Gs^Fct, Gs^Fms, Gs^Fct, Gll, Gs^Fct, Gs^Fms, Gll, Gs^Fct, Gs^Fct, Gs^Fms, Gs^Fms, Gll, Gs^Fms, Gs^Fms, Gs^Fct, Gs^Fct, Gs^Fms, Gs^Fct
Gs^Fct, Gll, Gs^Fms, Gs^Fms, Gs^Fct, Gs^Fms, Gs^Fms, Gs^Fct, Gll, Gll, Gs^Fct, Gs^Fms, Gs^Fct, Gs^Fms, Gs^Fct, Gs^Fct, Gs^Fms, Gs^Fms, Gs^Fct, Gs^Fct, Gs^Fms, Gs^Fms, Gs^Fms, Gs^Fms, Gs^Fct, Gs^Fms, Gs^Fct, Gs^Fms, Gs^Fms, Gs^Fms, Gs^Fct, Gs^Fms, Gll, Gs^Fct, Gs^Fct, Gs^Fct, Gll, Gs^Fms, Gs^Fct, Gs^Fms
Gs^Fct, Gs^Fms, Gs^Fms, Gs^Fct, Gs^Fms, Gs^Fms, Gs^Fct, Gs^Fct, Gll, Gs^Fct, Gs^Fms, Gs^Fms, Gs^Fms, Gs^Fct, Qxe, Gs^Fms, Cvr, Gs^Fms, Gg^Bsb|, Gs^Fms, Cvr^Dr, Gs^Fms, Qxe, Gs^Fms, Gs^Fms, Gs^Fct, Gs^Fct, Gs^Fms, Gs^Fct, Gll, Gll, Gs^Fct, Gll, Gs^Fct, Gs^Fct, Gs^Fct, Gs^Fct, Gll, Gs^Fms, Gs^Fms
Gs^Fms, Gs^Fct, Gs^Fms, Gs^Fms, Gs^Fct, Gs^Fms, Gs^Fct, Gs^Fct, Gs^Fct, Gs^Fct, Gs^Fms, Gs^Fms, Qxe, Qxe, Cvr^Dr, Qxe, Cvr^Dr, Ww^Bsb|, Rb, Ww^Bsb|, Cvr^Dr, Qxe, Cvr^Dr, Qxe, Qxe, Gs^Fms, Gs^Fms, Gs^Fct, Gs^Fct, Gs^Fms, Gs^Fct, Gs^Fct, Gs^Fms, Gll, Gs^Fct, Gs^Fms, Gs^Fct, Gs^Fct, Gs^Fms, Gs^Fms
Gs^Fms, Gs^Fct, Gll, Gll, Gs^Fct, Gs^Fms, Gs^Fms, Gs^Fct, Gs^Fct, Gs^Fms, Qxe, Qxe, Cvr^Dr, Cvr, Gs^Fms, Cvr, Gs^Fms, Gs^Fct, Cvr^Dr, Gs^Fms, Rb, Cvr, Gs^Fct, Cvr, Cvr, Qxe, Qxe, Gs^Fms, Gs^Fms, Gs^Fct, Gs^Fms, Gs^Fms, Gs^Fct, Gs^Fct, Gll, Gs^Fms, Gs^Fms, Gs^Fms, Gs^Fms, Gs^Fms
Gs^Fms, Gs^Fct, Gs^Fms, Gs^Fct, Gs^Fms, Gs^Fct, Gs^Fms, Gs^Fct, Qxe, Qxe, Cvr, Cvr^Dr, Rb, Gs^Fms, Cvr^Dr, Rb, Rb, Cvr^Dr, Kvr, Cvr, Gs^Fct, Gs^Fms, Cvr^Dr, Gs^Fct, Gs^Fct, Cvr^Dr, Cvr, Qxe, Qxe, Gs^Fct, Gs^Fms, Gs^Fms, Gs^Fct, Gs^Fct, Gs^Fms, Gs^Fms, Gs^Fms, Gs^Fms, Gs^Fct, Gs^Fms
Gs^Fms, Gs^Fms, Gs^Fct, Gs^Fct, Gs^Fms, Gs^Fms, Qxe, Qxe, Cvr^Dr, Cvr, Gs^Fct, Gs^Fct, Cvr, Kvr, Gs^Fms, Kvr, Gs^Fct, Cvr^Dr, Cvr^Dr, Cvr^Dr, Gs^Fct, Kvr^Dr, Gs^Fms, Kvr^Dr, Cvr^Dr, Gs^Fct, Gs^Fms, Cvr^Dr, Cvr^Dr, Qxe, Qxe, Gs^Fms, Gs^Fms, Gs^Fct, Gll, Gs^Fct, Gll, Gs^Fct, Gs^Fct, Gs^Fct
Gs^Fms, Gs^Fct, Gs^Fms, Gs^Fms, Gs^Fms, Qxe, Qxe, Cvr, Gs^Fms, Rb, Cvr, Kvr, Rr^Dr, Gs^Fct, Gs^Fms, Gs^Fms, Rr, Gs^Fct, Rr, Cvr^Dr, Rr, Gs^Fct, Gs^Fms, Rr^Dr, Gs^Fct, Kvr, Cvr^Dr, Gs^Fms, Gs^Fct, Cvr^Dr, Qxe, Qxe, Gs^Fms, Gs^Fms, Gs^Fct, Gs^Fms, Gs^Fms, Gs^Fms, Gll, Gll
Gs^Fms, Gs^Fms, Gs^Fct, Gs^Fct, Gs^Fct, Qxe, Cvr^Dr, Cvr^Dr, Gs^Fms, Kvr, Rr^Dr, Rr^Dr, Gs^Fms, Gs^Fct, Kvr, Cvr, Kvr, Gs^Fms, Gs^Fct, Rr, Kvr, Cvr, Kvr, Gs^Fct, Gs^Fct, Gs^Fct, Rr^Dr, Kvr, Gs^Fms, Cvr, Cvr^Dr, Qxe, Gs^Fms, Gs^Fms, Gs^Fct, Gs^Fms, Gs^Fms, Gs^Fct, Gs^Fct, Gs^Fms
Gs^Fct, Gs^Fct, Gs^Fms, Gs^Fms, Gs^Fct, Gs^Fct, Cvr^Dr, Gs^Fct, Kvr, Cvr^Dr, Rr^Dr, Gs^Fct, Cvr^Dr, Kvr, Rr, Rr, Rr, Rr, Gs^Fct, Rr, Rr, Rr, Rr, Kvr, Cvr, Gs^Fct, Gs^Fms, Cvr^Dr, Kvr, Gs^Fct, Cvr, Rp, Gs^Fms, Rp, Rp, Gs^Fms, Gs^Fms, Gs^Fct, Gs^Fms, Gs^Fms
Gs^Fms, Gs^Fms, Gs^Fct, Gs^Fct, Gs^Fms, Gg^Bsb\, Gs^Fct, Gs^Fct, Rr, Rr, Rr^Dr, Gs^Fct, Kvr, Gs^Fms, Gs^Fct, Rr, Kvr, Gs^Fct, Cvr^Dr, Rr, Kvr, Rr, Gs^Fms, Rr, Kvr, Gs^Fct, Gs^Fms, Rr^Dr, Rr^Dr, Gs^Fct, Gs^Fms, Gg^Bsb/, Rp, Gs^Fms, Gs^Fms, Gs^Fms, Gs^Fct, Gs^Fct, Rp, Gs^Fms
Gs^Fms, Gs^Fct, Gs^Fms, Gs^Fms, Cvr^Dr, Cvr^Dr, Gs^Fct, Rb, Cvr^Dr, Cvr^Dr, Kvr, Rr, Gs^Fct, Rr, Gs^Fct, Rr, Cvr^Dr, Cvr, Kvr, Cvr^Dr, Cvr^Dr, Gs^Fms, Gs^Fms, Rr, Gs^Fct, Rr, Kvr, Cvr^Dr, Cvr, Gs^Fct, Gs^Fct, Cvr, Cvr^Dr, Rp, Gs^Fms, Gs^Fct, Gs^Fms, Rp, Gs^Fms, Rp
Gll, Gs^Fct, Gs^Fct, Gs^Fct, Cvr, Rb, Gs^Fms, Cvr^Dr, Cvr^Dr, Cvr, Cvr^Dr, Gs^Fms, Gs^Fct, Gs^Fct, Gs^Fms, Rr, Cvr, Gs^Fct, Gll, Gs^Fct, Cvr^Dr, Gs^Fct, Gs^Fms, Gs^Fct, Gs^Fct, Rr, Cvr^Dr, Cvr^Dr, Cvr^Dr, Cvr, Gs^Fct, Gs^Fms, Cvr^Dr, Rp, Gs^Fms, Gs^Fct, Gs^Fms, Rp, Gs^Fms, Gs^Fms
Gs^Fms, Gll, Gs^Fms, Gs^Fms, Gs^Fms, Cvr^Dr, Gs^Fms, Gs^Fct, Rr, Cvr, Rr, Gs^Fms, Kvr, Rr, Gs^Fms, Rr, Kvr, Gs^Fct, Cvr, Gs^Fct, Kvr, Gs^Fct, Gs^Fct, Rr, Kvr, Gs^Fct, Gs^Fct, Cvr, Rr^Dr, Rb, Gs^Fms, Cvr^Dr, Gs^Fms, Gs^Fms, Gs^Fms, Gs^Fct, Gs^Fms, Gs^Fms, Rp, Rp
Gs^Fct, Gs^Fct, Gll, Gs^Fms, Gs^Fms, Gg^Bsb/, Cvr, Gs^Fct, Kvr, Rr, Gs^Fct, Gs^Fms, Cvr^Dr, Rr, Rr, Gs^Fms, Rr, Rr, Gs^Fct, Rr, Rr, Rr, Rr, Rr, Cvr^Dr, Gs^Fms, Gs^Fms, Rr, Kvr, Gs^Fms, Cvr^Dr, Gg^Bsb\, Gs^Fms, Gs^Fms, Gs^Fms, Gs^Fms, Gs^Fms, Gs^Fms, Gs^Fct, Gs^Fms
Gs^Fms, Gs^Fms, Gs^Fct, Gs^Fct, Gs^Fms, Gs^Fms, Cvr^Dr, Gs^Fms, Rb, Cvr^Dr, Rr, Gs^Fct, Rr, Kvr, Kvr, Rr, Kvr, Gs^Fms, Gs^Fct, Gs^Fct, Kvr, Rr, Kvr, Kvr, Gs^Fms, Gs^Fct, Rr, Cvr^Dr, Rb, Rb, Cvr, Rp, Gll, Gs^Fms, Gs^Fct, Gs^Fct, Gs^Fms, Gs^Fms, Gs^Fms, Gs^Fct
Gs^Fct, Gs^Fms, Gs^Fct, Gs^Fct, Gs^Fms, Qxe, Qxe, Cvr, Gs^Fct, Kvr, Cvr^Dr, Rr, Gs^Fct, Gs^Fct, Gs^Fms, Cvr^Dr, Rr, Rr, Rr, Gs^Fct, Rr, Cvr^Dr, Gs^Fms, Gs^Fct, Rr, Gs^Fct, Cvr^Dr, Kvr, Gs^Fms, Cvr^Dr, Qxe, Qxe, Gs^Fms, Gll, Gs^Fms, Gs^Fms, Gs^Fct, Gs^Fms, Gs^Fct, Gs^Fms
Gs^Fct, Gs^Fct, Gs^Fms, Gs^Fms, Gs^Fms, Qxe, Qxe, Cvr^Dr, Cvr^Dr, Gs^Fct, Gs^Fct, Kvr, Cvr^Dr, Gs^Fms, Rr^Dr, Rr, Rr, Cvr, Cvr^Dr, Cvr, Rr, Rr, Gs^Fct, Gs^Fct, Cvr^Dr, Kvr, Gs^Fms, Gs^Fms, Cvr, Cvr, Qxe, Qxe, Gs^Fct, Gs^Fms, Gll, Gs^Fct, Gs^Fms, Gs^Fms, Gs^Fms, Gs^Fct
Gs^Fct, Gs^Fms, Gs^Fms, Gs^Fms, Gs^Fms, Gs^Fms, Gs^Fms, Qxe, Qxe, Cvr, Cvr^Dr, Gs^Fct, Gs^Fct, Kvr, Cvr, Kvr, Gs^Fct, Cvr^Dr, Kvr, Cvr^Dr, Gs^Fct, Kvr, Cvr^Dr, Kvr, Gs^Fms, Gs^Fct, Cvr^Dr, Cvr^Dr, Qxe, Qxe, Gs^Fms, Gs^Fms, Gs^Fct, Gs^Fct, Gs^Fms, Gll, Gs^Fms, Gs^Fms, Gs^Fms, Gs^Fms
Gs^Fms, Gs^Fct, Gs^Fct, Gs^Fms, Gs^Fct, Gs^Fct, Gs^Fct, Gs^Fct, Gs^Fms, Qxe, Qxe, Cvr^Dr, Cvr^Dr, Gs^Fct, Gs^Fct, Gs^Fct, Gs^Fms, Cvr, Cvr^Dr, Cvr, Gs^Fct, Gs^Fct, Gs^Fms, Gs^Fms, Cvr, Cvr^Dr, Qxe, Qxe, Gs^Fms, Gs^Fms, Gs^Fms, Gs^Fms, Gs^Fct, Gs^Fms, Gs^Fct, Gll, Gs^Fct, Gs^Fct, Gs^Fms, Gs^Fms
Gs^Fct, Gs^Fct, Gs^Fct, Gs^Fct, Gs^Fms, Gs^Fms, Gs^Fms, Gs^Fct, Gs^Fct, Gs^Fms, Gs^Fms, Qxe, Qxe, Cvr, Cvr, Cvr^Dr, Cvr^Dr, Gs^Fct, Rb, Gs^Fct, Cvr^Dr, Cvr, Cvr^Dr, Cvr, Qxe, Qxe, Gs^Fms, Gs^Fms, Gs^Fct, Gs^Fct, Gs^Fct, Gs^Fms, Gs^Fct, Gs^Fms, Gll, Gll, Gs^Fms, Gs^Fms, Gs^Fms, Gs^Fms
Gll, Gs^Fms, Gll, Gs^Fct, Gs^Fms, Gs^Fms, Gll, Gs^Fms, Gs^Fct, Gs^Fms, Gs^Fct, Gs^Fct, Gs^Fms, Qxe, Qxe, Qxe, Cvr, Gs^Fms, Gg^Bsb|, Gs^Fms, Cvr^Dr, Qxe, Qxe, Qxe, Gs^Fms, Gs^Fms, Gs^Fms, Gs^Fct, Gs^Fms, Gs^Fms, Gs^Fct, Gs^Fct, Gs^Fms, Gs^Fct, Gll, Gs^Fct, Gs^Fct, Gs^Fct, Gs^Fct, Gs^Fms
Gs^Fct, Gs^Fct, Gs^Fct, Gs^Fms, Gs^Fms, Gs^Fms, Gs^Fct, Gll, Gs^Fct, Gs^Fct, Gs^Fct, Gs^Fct, Gs^Fct, Gs^Fms, Gs^Fct, Gs^Fms, Gs^Fms, Gg^Bsb|, Rp, Gg^Bsb|, Gs^Fms, Gs^Fms, Gs^Fms, Gs^Fms, Gs^Fms, Gs^Fms, Gs^Fms, Gs^Fct, Gs^Fct, Gs^Fct, Gs^Fms, Gs^Fms, Gs^Fms, Gs^Fms, Gll, Gs^Fms, Gs^Fms, Gs^Fms, Gs^Fct, Gs^Fct
Gs^Fct, Gs^Fms, Gs^Fct, Gs^Fct, Gs^Fms, Gs^Fct, Gs^Fms, Gs^Fct, Gs^Fms, Gs^Fms, Gs^Fct, Gs^Fms, Gs^Fms, Gs^Fms, Gs^Fct, Gs^Fct, Gs^Fct, Gs^Fms, Gs^Fct, Rp, Gll, Gll, Gll, Gs^Fms, Gs^Fct, Gs^Fms, Gll, Gs^Fct, Gs^Fms, Gs^Fct, Gs^Fct, Gs^Fct, Gs^Fct, Gll, Gs^Fct, Gs^Fms, Gs^Fct, Gs^Fct, Gs^Fms, Gs^Fms
Gs^Fms, Gs^Fms, Gs^Fct, Gs^Fct, Gs^Fct, Gs^Fms, Gs^Fms, Gs^Fct, Gs^Fct, Gs^Fms, Gs^Fms, Gs^Fct, Gs^Fct, Gs^Fct, Gs^Fct, Gs^Fms, Gs^Fms, Gs^Fct, Gs^Fms, Gs^Fct, Gs^Fct, Gll, Gs^Fms, Gll, Gll, Gs^Fct, Gll, Gs^Fms, Gs^Fms, Gs^Fms, Gs^Fct, Gs^Fct, Gs^Fms, Gll, Gs^Fct, Gs^Fct, Gs^Fms, Gs^Fms, Gs^Fms, Gs^Fms
Gs^Fms, Gs^Fms, Gs^Fct, Gs^Fct, Gs^Fct, Gs^Fms, Gs^Fms, Gs^Fct, Gs^Fms, Gs^Fct, Gs^Fct, Gs^Fms, Gs^Fms, Gs^Fms, Gs^Fct, Gs^Fct, Gs^Fms, Rp, Gs^Fms, Rp, Gs^Fct, Gs^Fct, Gs^Fct, Gs^Fms, Gs^Fct, Gll, Gs^Fct, Gll, Gll, Gs^Fct, Gs^Fct, Gs^Fct, Gll, Gs^Fms, Gs^Fct, Gs^Fms, Gs^Fct, Gs^Fms, Gs^Fms, Gs^Fms
Gs^Fms, Gs^Fct, Gll, Gs^Fms, Gll, Gs^Fct, Gs^Fct, Gs^Fct, Gs^Fct, Gs^Fct, Gll, Gs^Fct, Gs^Fct, Gs^Fct, Gs^Fct, Gs^Fct, Gs^Fct, Rp, Gs^Fms, Gs^Fms, Gs^Fct, Gs^Fms, Gs^Fms, Gs^Fms, Gs^Fms, Gs^Fct, Gs^Fms, Gs^Fms, Gll, Gll, Gll, Gll, Gs^Fct, Gs^Fct, Gs^Fct, Gs^Fct, Gs^Fms, Gs^Fct, Gs^Fms, Gs^Fms
Gll, Gll, Gs^Fct, Gll, Gs^Fct, Gll, Gll, Gs^Fct, Gs^Fms, Gs^Fms, Gll, Gs^Fct, Gs^Fms, Gs^Fms, Gs^Fct, Gs^Fms, Gs^Fms, Gs^Fct, Gs^Fct, Rp, Gs^Fms, Gs^Fct, Gs^Fms, Gs^Fms, Gs^Fms, Gs^Fms, Gs^Fms, Gs^Fct, Gs^Fct, Gll, Gs^Fct, Gll, Gll, Gs^Fct, Gs^Fct, Gs^Fms, Gs^Fms, Gs^Fms, Gs^Fms, Gs^Fms
Gll, Gs^Fct, Gs^Fms, Gs^Fct, Gs^Fct, Gs^Fms, Gs^Fms, Gs^Fct, Gs^Fms, Gs^Fms, Gs^Fct, Gs^Fms, Gs^Fct, Gs^Fct, Gs^Fct, Gs^Fms, Gs^Fms, Gs^Fms, Gs^Fct, Gs^Fct, Gs^Fct, Gs^Fct, Gs^Fct, Gs^Fct, Gs^Fct, Gs^Fct, Gs^Fct, Gs^Fms, Gs^Fms, Gs^Fms, Gs^Fct, Gll, Gll, Gll, Gs^Fms, Gs^Fct, Gs^Fct, Gs^Fms, Gs^Fms, Gs^Fct
Gs^Fct, Gs^Fct, Gs^Fct, Gs^Fms, Gs^Fct, Gs^Fct, Gs^Fct, Gll, Gs^Fct, Gs^Fct, Gs^Fct, Gs^Fct, Gs^Fms, Gs^Fct, Gs^Fms, Gs^Fct, Gs^Fms, Rp, Gs^Fms, Rp, Gs^Fms, Gs^Fct, Gs^Fct, Gs^Fct, Gs^Fms, Gs^Fms, Gs^Fms, Gs^Fms, Gs^Fms, Gs^Fct, Gs^Fct, Gs^Fct, Gll, Gs^Fms, Gs^Fct, Gs^Fct, Gs^Fct, Gs^Fms, Gs^Fms, Gs^Fct
Gs^Fct, Gs^Fct, Gll, Gs^Fms, Gs^Fct, Gs^Fct, Gll, Gll, Gs^Fms, Gs^Fct, Gs^Fct, Gs^Fct, Gs^Fct, Gs^Fct, Gs^Fct, Gs^Fct, Gs^Fms, Gs^Fms, Gs^Fms, Gs^Fms, Gs^Fms, Gs^Fms, Gs^Fct, Gs^Fct, Gs^Fms, Gs^Fms, Gs^Fct, Gs^Fct, Gs^Fms, Gs^Fct, Gs^Fct, Gs^Fct, Gll, Gll, Gs^Fms, Gs^Fms, Gs^Fms, Gs^Fms, Gs^Fms, Gs^Fct
Gs^Fct, Gll, Gs^Fms, Gs^Fct, Gs^Fms, Gs^Fct, Gs^Fct, Gll, Gs^Fct, Gs^Fms, Gs^Fct, Gs^Fms, Gs^Fct, Gs^Fct, Gs^Fms, Gs^Fms, Rp, Gs^Fct, Gs^Fct, Rp, Gs^Fms, Gs^Fms, Gs^Fct, Gs^Fct, Gs^Fct, Gs^Fms, Gs^Fms, Gs^Fct, Gs^Fct, Gs^Fct, Gs^Fct, Gs^Fms, Gs^Fms, Gll, Gll, Gs^Fms, Gs^Fms, Gs^Fms, Gs^Fct, Gs^Fct
Gs^Fct, Gs^Fct, Gs^Fct, Gs^Fct, Gs^Fct, Gs^Fms, Gs^Fct, Gs^Fms, Gs^Fms, Gs^Fct, Gs^Fms, Gs^Fct, Gs^Fct, Gs^Fct, Rp, Rp, Gs^Fms, Gs^Fms, Gs^Fms, Rp, Gs^Fms, Gs^Fct, Gs^Fms, Gs^Fct, Gs^Fms, Gs^Fct, Gs^Fct, Gs^Fct, Gs^Fms, Gs^Fms, Gs^Fct, Gs^Fms, Gs^Fms, Gs^Fct, Gs^Fms, Gll, Gll, Gs^Fms, Gs^Fct, Gs^Fct
Gs^Fct, Gs^Fms, Gs^Fct, Gs^Fms, Gs^Fms, Gs^Fct, Gs^Fct, Gs^Fct, Gs^Fms, Gs^Fct, Gs^Fms, Gs^Fms, Gs^Fms, Gs^Fct, Gs^Fms, Gs^Fms, Gs^Fms, Gs^Fms, Gs^Fms, Gs^Fct, Gs^Fct, Gs^Fms, Gs^Fms, Gs^Fms, Gs^Fct, Gs^Fct, Gs^Fms, Gs^Fct, Gs^Fms, Gs^Fms, Gs^Fms, Gs^Fct, Gs^Fms, Gs^Fms, Gs^Fct, Gs^Fms, Gll, Gs^Fms, Gs^Fct, Gs^Fct
Gs^Fct, Gs^Fms, Rp, Gs^Fms, Re, Gs^Fms, Gs^Fms, Gs^Fms, Gs^Fct, Gs^Fct, Rp, Rp, Gs^Fct, Gs^Fct, Gs^Fms, Gs^Fms, Rp, Rp, Gs^Fms, Gs^Fct, Gs^Fms, Gs^Fct, Gs^Fms, Gs^Fms, Gs^Fms, Gs^Fms, Gs^Fms, Gs^Fct, Gs^Fct, Gs^Fms, Gs^Fms, Gs^Fct, Gs^Fms, Gs^Fct, Gs^Fct, Gs^Fms, Gll, Gll, Gll, Gll
Gs^Fct, Rp, Gs^Fms, Gs^Fms, Re, Rp, Rp, Gs^Fct, Rp, Rp, Gs^Fms, Gs^Fms, Gs^Fms, Gs^Fct, Gs^Fct, Hh, Hh, Gs^Fct, Gs^Fms, Rp, Gs^Fct, Gs^Fct, Gs^Fms, Gs^Fms, Gs^Fms, Gs^Fct, Gs^Fct, Gs^Fms, Gs^Fct, Gs^Fct, Gs^Fct, Gs^Fct, Gs^Fms, Gs^Fms, Gs^Fms, Gll, Gll, Gll, Gs^Fms, Gs^Fms
