Xoi, Xoi, Xoi, Xoi, Xoi, Xoi, Xoi, Xoi, Xoi, Xoi, Xoi, Xoi, Xoi
Xoi, Xoi, Xoi^Efs, Xoi, Irs, Xoi^Efs, Irs, Xoi^Efs, Irs, Xoi, Xoi^Efs, Xoi, Xoi
Xoi, Irs, Irs, Irs, Irs, Irs, Irs^Xo, Irs, Irs, Irs, Irs, Irs, Xoi
Xoi, Irs, Xoi^Efs, Irs, Irs, Irs^Xo, 2 Icr, Irs^Xo, Irs, Irs, Xoi^Efs, Irs, Xoi
Xoi, Irs, Irs, Irs, Irs^Xo, Irs^Xo, Icr, Irs^Xo, Irs^Xo, Irs, Irs, Irs, Xoi
Xoi, Irs, Xoi^Efs, Irs, Irs^Xo, Irs, Icr, Irs, Irs^Xo, Irs, Xoi^Efs, Irs, Xoi
Xoi, Irs, Irs, Irs, Irs^Xo, Irs, Icr^Xo, Irs, Irs^Xo, Irs, Irs, Irs, Xoi
Xoi, Irs, Xoi^Efs, Irs^Xo, Irs, Irs^Xo, Icr, Irs^Xo, Irs, Irs^Xo, Xoi^Efs, Irs, Xoi
Xoi, Irs, Irs, Irs^Xo, Irs^Xo, Irs, Icr, Irs, Irs^Xo, Irs^Xo, Irs, Irs, Xoi
Xoi, Irs, Xoi, Irs, Irs, Irs^Xo, Icr^Xo, Irs^Xo, Irs, Irs, Xoi, Irs, Xoi
Xoi, Irs, Irs, Irs, Irs, Irs, Icr, Irs, Irs, Irs, Irs, Irs, Xoi
Xoi, Xoi, Xoi, Irs, Irs, Irs, Icr, Irs, Irs, Irs, Xoi, Xoi, Xoi
Xoi, Xoi, 1 Xoi, Xoi, Xoi, Irs, Icr, Irs, Xoi, Xoi, Xoi, Xoi, Xoi
Xoi, Xoi, Xoi, Xoi, Xoi, Irs, Icr, Irs, Xoi, Xoi, Xoi, Xoi, Xoi
Xoi, Xoi, Xoi, Xoi, Xoi, Irs, Icr, Irs, Xoi, Xoi, Xoi, Xoi, Xoi
