border_size=1
usage=map

Gll, Gll, Gll, Gll, Gll, Gll, Gll, Gs^Fms, Gs^Fct, Gll, Ww, Ww, Gg, Gs, Gs^Fct, Gll, Gs^Fct, Gs^Fct, Gll, Gll, Gll, Gll, Gs^Fct, Gs, Gs, Gg, Gs, Gg^Es, Gg, Gs, Hh, Hh, Hh^Fms, Hh^Fms, Hh, Hh, Gs, Gg, Gs, Rp, Gg, Gg, Gg, Gs, Hh, Hh, Hh^Fms, Hh^Fms, Hh^Fms, Hh^Fms, Hh^Fms
Gs^Fms, Gs^Fms, Gs^Fms, Gs^Fms, Gs^Fct, Gs^Fct, Gs^Fct, Gs^Fct, Gll, Ww, Ww, Ww, Gg, Gs, Gll, Gs^Fct, Gll, Gs^Fct, Gs^Fct, Gs^Fms, Gll, Gs^Fms, Gs^Fct, Gs^Fms, Gs, Gs, Gs^Vc, Gg, Gg, Gs, Hh, Hh, Hh, Hh^Fms, Hh, Hh, Gs, Gg, Gg^Es, Rp, Gg, Gg^Es, Gg, Gs, Hh, Hh^Fms, Hh^Fms, Hh^Fms, Hh^Fms, Hh^Fms, Hh^Fms
Gll, Gll, Gs^Fms, Gs^Fct, Gll, Gs^Fms, Gll, Gll, Gs, Ww, Ww, Gg, Gs, Gll, Gs^Fct, Gs^Fct, Gll, Gll, Gs^Fms, Gll, Gs^Fms, Gs^Fct, Gs^Fct, Gs, Gg, Gs, Gg^Efm, Gg, Gs, Gs, Gs, Hh, Ch, Hh, Hh, Gs, Gs, Gg, Rp, Rp, Gs, Gg, Gg, Gs, Gs, Hh, Hh^Fms, Hh^Fms, Hh^Fms, Hh^Fms, Hh^Fms
Gll, Gs^Fms, Gll, Gll, Gs^Fct, Gll, Gs, Gs, Ww, Ww, Ww, Gs, Gs^Fct, Gll, Gs^Fct, Gll, Gs^Fms, Gll, Gs^Fct, Gs^Fms, Gs^Fct, Gs^Fct, Gg, Gg, Gg^Efm, Gg^Efm, Gs^Efm, Gg, Gs^Es, Gs, Ch, Gs, Ch, Hh, Ch, Gs, Rp, Rp, Gg, Rp, Gg, Gs^Efm, Gg^Efm, Gg, Gs, Hh, Hh, Hh^Fms, Hh^Fms, Hh^Fms, Hh^Fms
Gll, Gs^Fms, Gs^Fct, Gll, Gll, Gll, Ww, Ww, Ww, Ww, Gs, Gll, Gs^Fct, Gs^Fct, Gll, Gs^Fms, Gll, Gs^Fms, Gs^Fct, Gs^Fct, Gs^Fms, Gll, Gll, Gg, Gg, Gg, Gs^Efm, Gs^Efm, Gg, Gg, Re, Ch, Kh, Ch, Rp, Gg, Rp, Gg, Gg, Rp, Gg, Gs^Efm, Gs^Efm, Gg, Gs, Hh, Hh, Hh, Hh, Hh^Fms, Hh
Gg, Gs^Fct, Gll, Gs^Fct, Gs, Gll, Ww, Ww, Gg^Es, Gs, Gs^Fct, Gs^Fct, Gs^Fct, Gs^Fct, Gs^Fct, Gs^Fms, Gs^Fct, Gs^Fms, Gs^Fct, Gs^Fms, Gll, Gs^Fms, Gs^Fms, Gs, Gs, Gs, Gg^Efm, Gg, Re, Re, Gg^Es, Ch, Ch, Ch, Gg, Rp, Gg, Gs^Vc, Gg, Rp, Rp, Gg, Gg, Gs, Gg, Gs, Gs, Gs, Gs, Hh, Gs
Gs, Gs, Gs, Gs, Gs, Gs, Ww, Ww, Gg, Gs, Gs^Fct, Gs^Fct, Gs^Fct, Gs^Fct, Gs^Fms, Gll, Gs^Fms, Gs^Fct, Gs^Fms, Gll, Gll, Gs^Fms, Hh^Fms, Hh, Hh, Gs, Gs, Gs, Re, Gg, Gg, Gs, Gs, Gg, Gg, Gg, Gg^Es, Gs, Rp, Rp, Gs, Rp, Rp, Gs, Gs^Vc, Gg, Gs, Gs, Gg, Gs, Gg
Ww, Ww, Ww, Ww, Ww, Ww, Ww, Ww, Gs, Gg, Gll, Gs^Fms, Gll, Gll, Gs^Fms, Gll, Gll, Gll, Gs^Fct, Gs^Fms, Gll, Hh, Hh^Fms, Hh^Fms, Gs^Fms, Gs^Fms, Gs^Vc, Gs, Rb^Gvs, Gs, Gs, Gs, Gs^Vc, Gs, Gs, Gg, Gs, Rp, Gs, Gg, Gs, Gg, Gg, Rp, Rp, Gg, Gg, Gg, Gs^Es, Gg, Gg
Ww, Ww, Ww, Ww, Ww, Ww, Gs, Gg, Gg, Re, Re, Re, Re, Gs, Gs, Gs, Gg, Gll^Es, Gs, Gs^Fct, Gs^Fct, Gs^Fms, Gs, Hh, Gs^Fms, Gs^Fms, Rb^Gvs, Rb^Gvs, Rb^Gvs, Rb^Gvs, Rb^Gvs, Gs, Gg, Gg^Es, Gs, Gs, Rp, Rp, Gg, Gs, Gs, Gs, Gs, Gs, Gs^Es, Rp, Rp, Gg, Gs, Gg, Gg
Gll, Ww, Gll, Gs, Gs, Gs^Es, Gs^Fct, Gll, Gll, Gs^Fct, Gs^Fct, Gll, Gs^Fms, Re, Re, Re, Re, Gg, Gg, Gs, Gs, Gs^Es, Gg, Gs, Rb^Gvs, Rb^Gvs, Rb^Gvs, Rb^Gvs, Rb^Gvs, Rb^Gvs, Rb^Gvs, Rb^Gvs, Gg, Gg, Rp, Rp, Gg, Gg, Gs, Gs, Gs^Fms, Gs^Fct, Gs^Fct, Gs, Gg, Gg, Gg, Rp, Rp, Gg, Gg
Gs^Fct, Gll, Gs^Fct, Gll, Gs^Fct, Gll, Gs^Fct, Gs^Fms, Gll, Gs^Fms, Gs^Fct, Gs^Fct, Gll, Gs, Gs^Es, Gg, Gs, Re, Re, Gg, Gg, Gs^Vc, Rb^Gvs, Rb^Gvs, Rb^Gvs, Rb^Gvs, Rb^Gvs, Rb^Gvs, Rb^Gvs, Rb^Gvs, Gs, Gg, Rp, Rp, Gg, Gg, Gs, Gs, Gs^Fct, Gs^Fct, Hh^Fms, Hh^Fms, Hh^Fms, Gll, Gll, Gs, Gs, Gg, Re, Rp, Rp
Gll, Gs^Fct, Gll, Gs^Fct, Gs^Fct, Gs^Fct, Gs^Fct, Gs^Fms, Gs^Fct, Gs^Fms, Gs^Fct, Gll, Gs^Fms, Gs^Fms, Gs^Fms, Gll, Gs^Fct, Gs, Re, Gs, Rb^Gvs, Rb^Gvs, Rb^Gvs, Rb^Gvs, Rb^Gvs, Rb^Gvs, Rb^Gvs, Rb^Gvs, Gs, Gg, Rp, Rp, Gs, Gg, Gg^Es, Gs, Gs^Fct, Gll, Gs^Fms, Gs^Fct, Hh^Fms, Hh^Fms, Hh^Fms, Hh, Hh, Gs^Fct, Gs^Fct, Gs, Re, Gs, Gg
Gs^Fms, Gs^Fms, Gs^Fms, Gll, Gs^Fct, Gll, Gs^Fct, Gll, Gs^Fms, Gs^Fct, Gs^Fct, Gs^Fms, Gll, Gll, Gll, Gll, Gll, Gs, Gg, Re, Re, Rb^Gvs, Rb^Gvs, Rb^Gvs, Rb^Gvs, Rb^Gvs, Gs^Vc, Gs, Gg, Rp, Gs, Gg, Gs^Vc, Gs, Gg, Gll, Gs^Fct, Gs^Fms, Hh, Hh^Fms, Hh, Gs^Fms, Gs^Fct, Hh^Fms, Hh^Fms, Gs^Fct, Gll, Gs, Re, Gg^Es, Gg
Gll, Gs^Fms, Gs^Fct, Gs^Fct, Gs^Fms, Gs^Fct, Hh, Gs^Fms, Gs^Fms, Gs^Fms, Gs^Fct, Gs^Fms, Gs^Fms, Gll, Gs^Fct, Gs^Fct, Gs, Gs, Rb^Gvs, Re, Gg, Re, Re, Rb^Gvs, Gs, Gg, Gg^Es, Gg, Gg, Rp, Gg, Gg, Gg, Gg, Gs, Gll, Gs^Fct, Hh^Fms, Hh^Fms, Hh, Gll, Gll, Gs^Fct, Gs^Fms, Hh^Fms, Hh, Gs, Gg, Re, Gs, Gg
Gs^Fct, Gs^Fct, Gll, Gll, Hh, Hh^Fms, Hh^Fms, Hh^Fms, Hh, Gll, Gs^Fct, Gll, Gs^Fms, Gs^Fms, Gs, Gs, Rb^Gvs, Rb^Gvs, Rb^Gvs, Rb^Gvs, Rb^Gvs, Gg^Es, Gs, Re, Gs, Gg, Gg, Gg, Ce, Rp, Ce, Gg, Gs, Gg, Gs, Gs^Fct, Gs^Fms, Gs^Fct, Gs^Fct, Hh, Gll, Gs^Fct, Hh^Fms, Hh, Hh, Hh, Gs, Gs, Re, Gg^Es, Gg
Gs^Fms, Gs^Fms, Gs^Fms, Hh, Hh^Fms, Mm, Mm, Mm, Hh^Fms, Hh, Gs^Fms, Gs^Fct, Gs^Fct, Gs, Rb^Gvs, Rb^Gvs, Rb^Gvs, Rb^Gvs, Rb^Gvs, Rb^Gvs, Rb^Gvs, Gs^Vc, Gg, Re, Re, Gg, Gs, Ce, Re, Ce, Re, Ce, Gg, Gs, Gs^Vc, Gs, Gs, Gll, Gs, Gs^Es, Gs, Gs^Fms, Hh^Fms, Hh^Fms, Hh, Gs, Gg, Gs, Rb^Gvs, Gs, Gs
Gll, Gs^Fms, Hh, Hh^Fms, Mm, Mm, Mm, Mm, Mm, Hh^Fms, Gs^Fms, Gs^Fct, Gs^Fms, Rb^Gvs, Rb^Gvs, Rb^Gvs, Rb^Gvs, Rb^Gvs, Rb^Gvs, Rb^Gvs, Gg, Gg, Gg, Gs, Gg, Re, Re, Ce, Re, Ket, Re, Ce, Re, Gg, Gg, Gs, Re, Gg, Re, Gg, Gs, Gs^Fct, Gs^Fct, Gs^Fct, Gs, Gs, Rb^Gvs, Rb^Gvs, Rb^Gvs, Rb^Gvs, Rb^Gvs
Hh, Hh, Hh^Fms, Hh^Fms, Mm, Mm, Mm, Mm, Mm, Hh^Fms, Hh, Gll, Gs^Fct, Gs, Gg, Rb^Gvs, Rb^Gvs, Rb^Gvs, Gs, Gs, Gs^Es, Gg, Gs, Gg^Efm, Gg^Efm, Gg, Gg, Ce, Ce, Re, Ce, Ce, Gg, Re, Re, Re, Gs, Re, Gs, Re, Re, Gs, Gs, Gs, Gg^Es, Gg, Re, Rb^Gvs, Rb^Gvs, Rb^Gvs, Gg
Mm, Mm, Mm, Mm, Mm, Mm, Mm, Mm, Mm, Hh, Hh^Fms, Gll, Gs^Fct, Gs, Gg, Gg, Gs, Gs, Hh, Hh, Hh, Gs, Gs, Gs^Efm, Gg^Efm, Gg, Re, Re, Gg, Ce, Gg, Gg, Gg, Gg, Gg, Gg, Gs, Gg^Es, Gs, Gg, Gg, Re, Re, Gg, Re, Re, Gs^Fct, Gs^Vc, Gs^Fct, Gs, Gg
Mm, Mm, Mm, Mm, Mm, Mm, Mm, Mm, Mm, Hh^Fms, Gs^Fms, Gs^Fct, Gll, Gll, Gs, Gs, Hh, Hh, Hh^Fms, Hh^Fms, Hh^Fms, Hh, Gs, Gg^Efm, Gs, Gg, Re, Gs, Gs, Rp, Gs, Gs, Gg, Gg, Gs, Gs, Gs^Fct, Gll, Gs^Fct, Gs, Gs, Gs, Gg, Re, Re, Gs, Gg, Gs^Fct, Gs, Gg, Gs
Mm, Mm, Mm, Mm, Mm, Mm, Mm, Mm, Hh^Fms, Hh^Fms, Hh, Gs^Fct, Gs^Fct, Gs^Fms, Gll, Gs, Hh, Hh^Fms, Hh^Fms, Hh^Fms, Hh^Fms, Hh, Gs, Gs, Gg, Gs, Re, Gg, Gs, Rp, Gs, Gg^Efm, Gg^Efm, Gs, Gs^Fms, Gs^Fms, Gs^Fct, Gs^Fms, Hh^Fms, Gs^Fct, Gll, Gg, Gg, Gg, Gg, Re, Re, Re, Re, Re, Re
Mm, Mm, Mm, Mm, Mm, Mm, Hh^Fms, Mm, Hh^Fms, Hh, Gll, Gs^Fms, Gs^Fct, Gs^Fms, Gs^Fms, Gll, Gll, Hh, Gs^Fms, Gs^Fms, Hh^Fms, Hh, Gs, Gg, Gg, Re, Gg, Gg^Es, Gs, Rp, Gg, Gs^Efm, Gs^Fct, Gs, Gs^Fct, Gs^Fct, Hh, Hh, Mm, Hh^Fms, Hh, Gll, Gs, Gg, Gg^Es, Gg, Re, Gg, Gg, Gg, Gg
Mm, Mm, Mm, Mm, Hh^Fms, Hh^Fms, Hh, Hh^Fms, Hh, Gs^Fms, Gs^Fct, Gs^Fct, Gs^Fms, Gs^Fct, Gs^Fct, Gs^Fms, Gs^Fms, Gs^Fms, Gll, Gs^Fms, Hh, Hh, Gs, Gg, Gg, Re, Gs, Gg, Gs, Rp, Gs^Fct, Gs^Fct, Gs^Fct, Gs^Fct, Gs^Fms, Hh^Fms, Mm, Mm, Mm, Mm, Hh^Fms, Gs^Fct, Gs^Fct, Gs, Gg, Gs, Re, Gs, Gs, Gg, Gg
Hh^Fms, Hh, Hh^Fms, Hh^Fms, Hh^Fms, Hh, Gll, Hh, Gll, Gs^Fms, Gs^Fms, Gs^Fms, Gs^Fms, Gll, Gs^Fct, Gs^Fct, Gs^Fct, Gll, Gll, Gll, Hh, Hh, Gs, Gg^Es, Gs, Re, Gg, Gs, Gs, Rp, Gg, Gs^Fct, Gs^Fct, Gs^Fct, Gs^Fms, Hh^Fms, Hh^Fms, Mm, Mm, Mm, Mm, Hh^Fms, Gs^Fct, Gs, Gg, Gs, Re, Gg, Gg, Gg^Es, Gg
Hh^Fms, Hh^Fms, Hh^Fms, Hh^Fms, Gs^Fms, Gll, Gs^Fms, Gll, Gs^Fct, Gll, Gs^Fms, Gs^Fms, Gs^Fms, Gs^Fct, Gll, Gs^Fct, Gs^Fct, Gll, Gs^Fms, Hh^Fms, Hh^Fms, Hh^Fms, Gs^Fct, Gs^Vc, Rb^Gvs, Rb^Gvs, Rb^Gvs, Gg, Gg, Rp, Gg, Gg^Efm, Gg^Efm, Gs^Fct, Gs^Fms, Gs^Fms, Hh, Mm, Mm, Mm, Hh, Hh^Fms, Gs^Fct, Gs, Gs, Gs, Rb^Gvs, Rb^Gvs, Rb^Gvs, Gs, Gs
Gs^Fms, Gs^Fms, Gs^Fct, Gs^Fct, Gs^Fct, Gs^Fct, Gs^Fct, Gs^Fms, Gs^Fct, Gs^Fms, Gs^Fct, Gs^Fct, Hh^Fms, Gs^Fms, Gs^Fct, Gll, Gs^Fct, Gs^Fct, Gs^Fct, Gs^Fms, Gs^Fms, Gs^Fms, Gs^Fct, Rb^Gvs, Rb^Gvs, Rb^Gvs, Rb^Gvs, Rb^Gvs, Gg, Rp, Gs, Gg^Efm, Gg, Gs^Fct, Gs^Fct, Gll, Gs^Fms, Hh^Fms, Hh^Fms, Hh^Fms, Gll, Gs^Fms, Gs^Fms, Gs, Gs^Vc, Rb^Gvs, Rb^Gvs, Rb^Gvs, Rb^Gvs, Rb^Gvs, Gg
Gll, Gs^Fms, Gs^Fms, Gs^Fms, Gll, Gs^Fct, Gs^Fms, Gll, Gs^Fms, Gll, Gs^Fms, Hh^Fms, Hh, Gs^Fct, Gs^Fms, Gs^Fct, Gll, Gs^Fct, Gs^Fct, Gs^Fct, Gs^Fct, Gs^Fct, Gll, Gs, Gg, Rb^Gvs, Gg, Gg, Gs, Rp, Gs, Gg, Gg, Gs, Gs, Gs^Fms, Gs^Fct, Gs^Fct, Gs^Fms, Gs^Fms, Gs^Fct, Gs^Fct, Gs^Fct, Gs, Gg, Rb^Gvs, Rb^Gvs, Rb^Gvs, Gg, Gg, Gg
Gs^Fct, Gs^Fms, Gll, Gs^Fms, Gs^Fct, Gs^Fct, Gll, Gs^Fms, Hh^Fms, Gs^Fms, Gs^Fms, Gll, Hh, Hh, Gll, Gll, Gll, Gll, Gs^Fms, Gs^Fct, Gs^Fms, Gll, Gs, Gg, Rb^Gvs, Rb^Gvs, Rb^Gvs, Gs, Gs^Vc, Rp, Rp, Gs, Gg, Gg, Gg, Gs, Gs, Gll, Gll, Gll, Gs, Gs^Fms, Gs, Gs^Es, Rb^Gvs, Rb^Gvs, Rb^Gvs, Rb^Gvs, Gs, Gs^Es, Gs
Gs^Fms, Gs^Fct, Gs^Fct, Gs^Fms, Gs^Fct, Gs^Fms, Gs^Fms, Hh^Fms, Hh, Gll, Hh^Fms, Hh^Fms, Hh, Hh^Fms, Gll, Gs^Fct, Gs^Fct, Gs^Fct, Gs^Fct, Gll, Gs^Fms, Gs^Fms, Gs^Vc, Rb^Gvs, Rb^Gvs, Rb^Gvs, Rb^Gvs, Rb^Gvs, Rb^Gvs, Gg^Es, Re, Rp, Rp, Gg, Gg, Gg, Gg, Gg, Rb^Gvs, Rb^Gvs, Rb^Gvs, Gs, Rb^Gvs, Rb^Gvs, Rb^Gvs, Rb^Gvs, Rb^Gvs, Rb^Gvs, Hh, Hh, Hh
Gll, Gs^Fms, Gs^Fms, Gs^Fct, Gs^Fms, Gll, Gs^Fms, Hh^Fms, Hh, Hh, Hh^Fms, Hh, Hh^Fms, Hh^Fms, Gs^Fms, Gs^Fct, Gs^Fms, Gll, Gs^Fms, Gs^Fms, Gll, Gll, Gg^Es, Gg, Gg, Rb^Gvs, Rb^Gvs, Rb^Gvs, Re, Re, Rb^Gvs, Gs, Gs, Rp, Rp, Gg, Gg, Rb^Gvs, Rb^Gvs, Rb^Gvs, Rb^Gvs, Rb^Gvs, Rb^Gvs, Rb^Gvs, Rb^Gvs, Rb^Gvs, Gs, Gs, Hh^Fms, Hh^Fms, Mm
Gll, Gs^Fms, Gll, Gs^Fms, Gs^Fct, Gs^Fms, Gll, Hh, Hh^Fms, Hh, Hh^Fms, Hh, Gs^Fms, Gs^Fms, Gs^Fct, Gs^Fct, Gs^Fms, Gll, Gs^Fct, Gs^Fms, Gll, Gs, Gll, Gg, Gll, Gs, Gs, Re, Rb^Gvs, Rb^Gvs, Rb^Gvs, Rb^Gvs, Rb^Gvs, Gg, Gs, Rp, Rp, Gs, Gs^Vc, Rb^Gvs, Rb^Gvs, Rb^Gvs, Rb^Gvs, Rb^Gvs, Rb^Gvs, Gs^Vc, Hh, Hh, Hh^Fms, Mm, Mm
Gs^Fct, Gs^Fms, Gs^Fms, Gs^Fms, Gll, Gs^Fct, Gs^Fms, Hh^Fms, Gs^Fms, Hh^Fms, Gs^Fct, Hh^Fms, Gs^Fct, Gs^Fct, Gll, Gs^Fct, Gll, Gs^Fct, Gs^Fct, Gs^Fct, Gs^Fms, Gll, Gs^Fms, Gll, Gs^Fms, Gs^Fms, Gll, Gg, Gs, Rb^Gvs, Rb^Gvs, Rb^Gvs, Rb^Gvs, Rb^Gvs, Rb^Gvs, Gs, Rp, Re, Re, Re, Rb^Gvs, Rb^Gvs, Rb^Gvs, Rb^Gvs, Gs, Hh, Hh^Fms, Hh^Fms, Mm, Mm, Mm
Gs^Fms, Gs^Fct, Gs^Fct, Gll, Gs^Fms, Gs^Fms, Gs^Fct, Gs^Fms, Gs^Fct, Gs^Fct, Gs^Fct, Gs^Fms, Gll, Gll, Gs^Fct, Gs^Fct, Gll, Gll, Gs^Fms, Gs^Fms, Hh^Fms, Gs^Fms, Gs^Fms, Gs^Fms, Hh^Fms, Hh^Fms, Hh, Gll, Gs^Fms, Gs, Gs, Rb^Gvs, Rb^Gvs, Rb^Gvs, Gg, Gg, Rp, Gs, Rb^Gvs, Rb^Gvs, Rb^Gvs, Rb^Gvs, Rb^Gvs, Gs, Hh, Hh, Hh^Fms, Hh^Fms, Mm, Mm, Mm
Gs^Fms, Gs^Fms, Gs^Fct, Gs^Fct, Gs^Fct, Gs^Fms, Gs^Fct, Gs^Fms, Gs^Fct, Gs^Fms, Gs^Fct, Gs^Fms, Gs^Fct, Gs^Fct, Gs^Fct, Gll, Hh, Hh, Hh^Fms, Hh^Fms, Hh^Fms, Hh^Fms, Hh^Fms, Hh^Fms, Mm, Hh^Fms, Hh^Fms, Hh, Gs^Fms, Gs^Fms, Gs^Fms, Gs^Vc, Gg^Es, Gg, Gg, Gs, Rp, Gg, Gs, Rb^Gvs, Rb^Gvs, Rb^Gvs, Gs, Hh, Hh^Fms, Hh, Mm, Mm, Mm, Mm, Mm
Gs^Fms, Gs^Fms, Gs^Fms, Gs^Fms, Gs^Fct, Gll, Gll, Gs^Fms, Gs^Fct, Gs^Fct, Gs^Fct, Gs^Fms, Gll, Gs^Fms, Gll, Gll, Hh, Hh^Fms, Hh, Hh^Fms, Mm, Mm, Hh^Fms, Hh^Fms, Mm, Mm, Mm, Hh^Fms, Hh, Gll, Gs^Fms, Gs, Gg, Gg, Gg, Gg, Rp, Gs, Gs^Es, Gs, Gs, Gg, Gs, Hh, Hh^Fms, Hh^Fms, Mm, Mm, Mm, Mm, Mm
Gs^Fms, Gs^Fms, Gs^Fct, Gll, Gll, Gs^Fms, Gs^Fct, Gll, Gs^Fms, Gs^Fct, Gs^Fct, Gll, Gs^Fms, Gll, Gs^Fms, Hh, Hh, Hh^Fms, Hh^Fms, Mm, Mm, Mm, Mm, Mm, Mm, Mm, Mm, Hh^Fms, Hh^Fms, Hh, Gs^Fms, Gll, Gll, Gg, Gs, Gg^Es, Rp, Gg, Gg, Gg, Gs, Gs, Hh, Hh^Fms, Hh^Fms, Mm, Mm, Mm, Mm, Mm, Mm
Gs^Fct, Gs^Fct, Gs^Fct, Gll, Gll, Gll, Gll, Gs^Fms, Gll, Gs^Fct, Gs^Fct, Gs^Fms, Gll, Gs^Fms, Gll, Hh^Fms, Hh^Fms, Hh^Fms, Mm, Mm, Mm, Mm, Mm, Mm, Mm, Mm, Mm, Mm, Hh^Fms, Hh, Gs^Fms, Gs^Fms, Gll, Gg, Gg, Gs, Rp, Gg, Gg, Gg, Gs, Hh, Hh^Fms, Hh^Fms, Mm, Mm, Mm, Mm, Mm, Mm, Mm
Gll, Gll, Gll, Gs^Fct, Gs^Fct, Gs^Fms, Gs^Fct, Gs^Fms, Gll, Gll, Gll, Gs^Fct, Gs^Fms, Gll, Hh, Hh^Fms, Hh, Mm, Mm, Mm, Mm, Mm, Mm, Mm, Mm, Mm, Mm, Mm, Hh, Hh^Fms, Gg, Gs^Fms, Gs, Gg, Gg, Gg, Rp, Gs, Gg, Gg, Gs, Hh^Fms, Hh, Mm, Mm, Mm, Mm, Mm, Mm, Mm, Mm
