border_size=1
usage=map

Gs, Gs^Fms, Gs^Fms, Gs^Fms, Gs^Fms, Gll, Gs^Fct, Gll, Gs^Fms, Gs^Fms, Gs^Fms, Gs, Gs^Fct, Gs^Fct, Gs^Fct, Gs^Fms, Gs^Fms, Gll, Gs^Fct, Gs^Fms, Gs^Fms, Gs^Fct, Gs^Fms, Gs^Fms, Gs^Fms
Gs^Fct, Gs^Fct, Gs^Fct, Gs^Fct, Gs^Fms, Gs^Fms, Gs^Fms, Gll, Gs^Fct, Gs^Fct, Gs^Fms, Gs^Fms, Gs^Fct, Gs^Fms, Gs^Fct, Gs^Fms, Gs^Fms, Gll, Gs^Fct, Gs^Fms, Gs^Fms, Gs^Fms, Gs^Fms, Gs^Fct, Gs^Fms
Gs^Fms, Gs^Fct, Gs^Fms, Gs^Fms, Gs^Fms, Gs^Fms, Gs^Fms, Gs^Fms, Gs^Fms, Gs^Fct, Gll, Gs^Fct, Gs^Fct, Gs^Fms, Gs^Fct, Gs^Fct, Gll, Gs^Fms, Gs^Fct, Gs^Fms, Gs^Fms, Gs^Fms, Gs^Fms, Gs^Fct, Gll
Gs^Fct, Gs^Fms, Gll, Gs^Fct, Gs^Fct, Gs^Fms, Gs^Fms, Gs^Fms, Gs^Fct, Gs^Fct, Gs^Fms, Gs^Fms, Gs^Fct, Gs^Fct, Gs^Fms, Gs^Fms, Gll, Gs^Fms, Gs^Fms, Gs^Fct, Gs^Fms, Gs^Fms, Gs^Fms, Gs^Fms, Gs^Fct
Gs^Fct, Gs^Fms, Gs^Fms, Gs^Fms, Gs^Fct, Gs^Fms, Gs^Fct, Gs^Fct, Gs^Fms, Gs^Fms, Gs^Fms, Gs^Fct, Gs^Fct, Gs^Fms, Gs^Fms, Gs^Fms, Gs^Fms, Gll, Gll, Gs^Fms, Gs^Fct, Gs^Fct, Gs^Fct, Gs^Fct, Gll
Gs^Fms, Gs^Fms, Gs^Fms, Gs^Fms, Gs^Fct, Gs^Fms, Gs^Fms, Gll, Gll, Gs^Fms, Gd^Xff, Gs^Fms, Gs^Fms, Gs^Fms, Gd^Xff, Gs^Fms, Gd^Fetd, Gs^Fms, Gs^Fms, Gs^Fms, Gs^Fct, Gs^Fct, Gs^Fms, Gll, Gll
Gs^Fms, Gs^Fms, Gs^Fms, Gs^Fct, Gs^Fms, Gs^Fms, Gs^Fms, Gll, Gd^Fetd, Gd^Fetd, Gd^Fetd, Gs^Fms, Gd^Fetd, Gd^Fetd, Gd^Fetd, Gs^Fms, Gd^Xff, Gs^Fms, Gs^Fms, Gs^Fms, Gs^Fms, Gs^Fms, Gs^Fms, Gs^Fms, Gs^Fms
Gs^Fct, Gs^Fct, Gs^Fct, Gs^Fct, Gs^Fct, Gs^Fms, Gs^Fms, Gd^Fetd, Gd^Fetd, Gd^Xff, Gs, Gd^Fetd, Gll, Gd^Xff, Gd^Xff, Gd^Fetd, Gll, Gd^Xff, Gd^Xff, Gd^Fetd, Gs^Fms, Gs^Fct, Gs^Fms, Gs^Fms, Gs^Fct
Gll, Gs^Fms, Gs^Fct, Gs^Fct, Gll, Gs^Fct, Gs^Fct, Gs^Fms, Gd^Xff, Gd^Xff, Gd^Fetd, Gll, Gd^Xfw, Gs, Gd^Xfw, Gd^Fetd, Gll, Gll, Gd^Fetd, Gd^Fetd, Gd^Fetd, Gll, Gll, Gs^Fms, Gs^Fms
Gs^Fct, Gs^Fct, Gs^Fms, Gs^Fms, Gs, Gll, Gs^Fct, Gs^Fms, Gd^Fetd, Gd^Fetd, Gd^Xfw, Gs, Rrc^Xfv, Gs, Gd^Xfw, Gs, Gll, Gd^Xff, Gd^Fetd, Gd^Xff, Gd^Fetd, Gs^Fct, Gll, Gs^Fms, Gs^Fms
Gs^Fct, Gs^Fms, Gs^Fms, Gll, Gll, Gll, Gs^Fct, Gd^Fetd, Gs^Fms, Gll, Rb, Rb, Gs, Rb, Rrc^Xfv, Gs, Gll, Gd^Xff, Gs^Fms, Gd^Fetd, Gd^Fetd, Gll, Gll, Gs^Fct, Gll
Gs^Fms, Gs^Fms, Gs^Fms, Gd^Xff, Gs^Fct, Gll, Gs^Fct, Gd^Fetd, Gd^Xff, Gd^Xfw, Rrc^Xfv, Gs, Gd, Gd, Gs, Rb, Gd^Xfw, Gd^Fetd, Gd^Fetd, Gd^Xff, Gs^Fms, Gs^Fms, Gs^Fct, Gll, Gll
Gs^Fms, Gs^Fms, Gll, Gd^Fetd, Gd^Xff, Gd^Fetd, Gd^Fetd, Gd^Xff, Gd^Fetd, Gd^Xfw, Rb, Gs, Gd, Gd^Xff, Gs, Rb, Gd^Xfw, Gll, Gll, Gd^Xff, Gd^Fetd, Gs^Fct, Gs^Fct, Gs^Fms, Gs^Fms
Gs^Fms, Gs^Fms, Gs^Fct, Gd^Fetd, Gd^Xff, Gd^Fetd, Gd^Xff, Gd^Xff, Gd^Fetd, Gs, Rrc^Xfv, Gd, Gd^Xfw, Gd, Gs, Rrc^Xfv, Gs, Rb, Rb, Gll, Gll, Gll, Gs^Fct, Gs^Fms, Gs^Fms
Gs^Fct, Gs^Fct, Gs^Fms, Gd^Fetd, Gd^Xff, Gd^Fetd, Gll, Gd^Fetd, Gd, Gd, Rb, Gs, Gs, Gs, Rb, Rb, Gs, Gd^Xff, Gll, Rb, Rb, Gll, Gs^Fct, Gs^Fms, Rb
Gs^Fct, Gs^Fms, Gs^Fms, Gd^Fetd, Gll, Gll, Gll, Gs, Gd^Fetd, Gs, Rb, Gs, Rb, Rb, Gd, Gs, Gll, Gll, Gd^Fetd, Gd^Fetd, Gs^Fms, Rb, Rb, Rb, Gs^Fct
Gs^Fms, Gs^Fms, Gs^Fms, Gs^Fms, Gs^Fms, Gd^Fetd, Gd^Xff, Gd^Xff, Gd^Fetd, Gs, Rb, 1 Gd, Rb, Gs, Gs, Rrc^Xfv, Gll, Gd^Fetd, Gd^Fetd, Gs^Fms, Gs^Fms, Gll, Gs^Fms, Gs^Fms, Gs^Fct
Gs^Fms, Gs^Fms, Gs^Fct, Gs^Fct, Gs^Fct, Gd^Fetd, Gd^Fetd, Gll, Gs, Gd, Rb, Rb, Gs, Gd, Gs, Gll, Gs^Fct, Gd^Xff, Gs^Fms, Gs^Fms, Gs^Fct, Gs^Fct, Gs^Fms, Gs^Fms, Gs^Fms
Gs^Fct, Gs^Fct, Gd^Xff, Gd^Xff, Gd^Fetd, Gd^Fetd, Gd^Fetd, Gd^Fetd, Gd^Fetd, Gd^Xfw, Rb, Gd, Gd^Xfw, Gs, Gll, Gll, Gll, Gd^Fetd, Gs^Fms, Gs^Fms, Gs^Fms, Gs^Fms, Gs^Fct, Gs^Fms, Gs
Gs^Fct, Gs^Fms, Gs^Fms, Gd^Xff, Gd^Xff, Gd^Fetd, Gd^Fetd, Gd^Xff, Gd^Xff, Gll, Rb, Gs, Gll, Gll, Gd^Xff, Gd^Fetd, Gd^Xff, Gd^Fetd, Gs^Fct, Gs^Fms, Gs^Fms, Gs^Fms, Gs^Fct, Gs, Gs
Gs^Fct, Gs^Fms, Gs^Fms, Gs^Fms, Gd^Xff, Gs^Fct, Gll, Gd^Fetd, Gll, Gs, Rb, Gs, Gll, Gd^Xff, Gd^Fetd, Gd^Fetd, Gd^Xff, Gd^Fetd, Gs^Fct, Gs^Fms, Gs^Fms, Gs^Fms, Gs^Fms, Gs, Gs
Gs^Fct, Gs^Fct, Gs^Fct, Gs^Fct, Gs^Fct, Gs^Fms, Gs^Fms, Gs^Fms, Gll, Gs, Rb, Gs, Gs^Fms, Gll, Gs^Fct, Gd^Xff, Gd^Fetd, Gd^Fetd, Gd^Fetd, Gs^Fct, Gs^Fct, Gs^Fms, Gs^Fms, Gs^Fct, Gs
