border_size=1
usage=map

Qxua, Qxua, Qxua, Qxua, Qxua, Qxua, Qxua, Qxua, Qxua, Qxua, Qxua, Qxua, Qxua, Qxua, Qxua, Qxua, Qxua, Qxua, Qxua, Qxua, Qxua, Qxua, Qxua, Qxua, Qxua, Qxua, Qxua
Qxua, Qxua, Qxua, Qxua, Qxua, Qxua, Qxua, Qxua, Qxua, Qxua, Qxua, Qxua, Qxua, Qxua, Qxua, Qxua, Qxua, Qxua, Qxua, Qxua, Qxua, Qxua, Qxua, Qxua, Qxua, Qxua, Qxua
Qxua, Qxua, Qxua, Qxua, Qxua, Qxua, Qxua, Qxua, Qxua, Qxua, Qxua, Qxua, Qxua, Qxua, Qxua, Qxua, Qxua, Qxua, Qxua, Qxua, Qxua, Qxua, Qxua, Qxua, Qxua, Qxua, Qxua
Qxua, Qxua, Qxua, Qxua, Qxua, Qxua, Qxua, Qxua, Qxua, Qxua, Qxua, Qxua, Qxua, Qxua, Qxua, Qxua, Qxua, Qxua, Qxua, Qxua, Qxua, Qxua, Qxua, Qxua, Qxua, Qxua, Qxua
Qxua, Qxua, Qxua, Qxua, Qxua, Qxua, Qxua, Qxua, Qxua, Qxua, Qxua, Qxua, Qxua, Qxua, Qxua, Qxua, Qxua, Qxua, Qxua, Qxua, Qxua, Qxua, Qxua, Qxua, Qxua, Qxua, Qxua
Qxua, Qxua, Qxua, Qxua, Qxua, Qxua, Xos^Efs, Xos^Efs, Xos^Efs, Xos^Efs, Xos^Efs, Xos^Efs, Xos^Efs, Xos^Efs, Xos^Efs, Xos^Efs, Xos^Efs, Xos^Efs, Xos^Efs, Xos^Efs, Xos^Efs, Qxua, Qxua, Qxua, Qxua, Qxua, Qxua
Qxua, Qxua, Qxua, Qxua, Qxua, Qxua, Xos^Efs, Xos^Efs, Xos^Efs, Xos^Efs, Xos^Efs, Xos^Efs, Xos^Efs, Xos^Efs, Xos^Efs, Xos^Efs, Xos^Efs, Xos^Efs, Xos^Efs, Xos^Efs, Xos^Efs, Qxua, Qxua, Qxua, Qxua, Qxua, Qxua
Qxua, Qxua, Qxua, Qxua, Qxua, Qxua, Xos^Efs, Xos^Efs, Xos^Efs, Xos^Efs, Qxua^Ii, Qxua^Ii, Qxua^Ii, Xos^Efs, Qxua^Ii, Qxua^Ii, Qxua^Ii, Xos^Efs, Xos^Efs, Xos^Efs, Xos^Efs, Qxua, Qxua, Qxua, Qxua, Qxua, Qxua
Qxua, Qxua, Qxua, Qxua, Qxua, Qxua, Xos^Efs, Xos^Efs, Qxua^Ii, Qxua^Ii, Qxua^Ii, Qxua^Ii, Gg^Efm, Rrc^Ma, Gg^Efm, Qxua^Ii, Qxua^Ii, Qxua^Ii, Qxua^Ii, Xos^Efs, Xos^Efs, Qxua, Qxua, Qxua, Qxua, Qxua, Qxua
Qxua, Qxua, Qxua, Qxua, Qxua, Qxua, Xos^Efs, Xos^Efs, Qxua^Ii, Qxua^Ii, Gg^Efm, Gg^Efm, Qxua^Ii, Gg^Efm, Qxua^Ii, Gg^Efm, Gg^Efm, Qxua^Ii, Qxua^Ii, Xos^Efs, Xos^Efs, Qxua, Qxua, Qxua, Qxua, Qxua, Qxua
Qxua, Qxua, Qxua, Qxua, Qxua, Qxua, Xos^Efs, Xos^Efs, Qxua^Ii, Gg^Efm, Qxua^Ii, Qxua^Ii, Qxua^Ii, Kw, Qxua^Ii, Qxua^Ii, Qxua^Ii, Gg^Efm, Qxua^Ii, Xos^Efs, Xos^Efs, Qxua, Qxua, Qxua, Qxua, Qxua, Qxua
Qxua, Qxua, Qxua, Qxua, Qxua, Qxua, Xos^Efs, Xos^Efs, Qxua^Ii, Gg^Efm, Qxua^Ii, Cw, Gg^Efm, Gg^Efm, Gg^Efm, Cw, Qxua^Ii, Gg^Efm, Qxua^Ii, Xos^Efs, Xos^Efs, Qxua, Qxua, Qxua, Qxua, Qxua, Qxua
Qxua, Qxua, Qxua, Qxua, Qxua, Qxua, Xos^Efs, Xos^Efs, Qxua^Ii, Gg^Efm, Qxua^Ii, Qxua^Ii, Gg^Efm, Gg^Efm, Gg^Efm, Qxua^Ii, Qxua^Ii, Gg^Efm, Qxua^Ii, Xos^Efs, Xos^Efs, Qxua, Qxua, Qxua, Qxua, Qxua, Qxua
Qxua, Qxua, Qxua, Qxua, Qxua, Qxua, Xos^Efs, Xos^Efs, Qxua^Ii, Gg^Efm, Qxua^Ii, Cw, Gg^Efm, Gg^Efm, Gg^Efm, Cw, Qxua^Ii, Gg^Efm, Qxua^Ii, Xos^Efs, Xos^Efs, Qxua, Qxua, Qxua, Qxua, Qxua, Qxua
Qxua, Qxua, Qxua, Qxua, Qxua, Qxua, Xos^Efs, Xos^Efs, Qxua^Ii, Gg^Efm, Gg^Efm, Gg^Efm, Qxua^Ii, Gg^Efm, Qxua^Ii, Gg^Efm, Gg^Efm, Gg^Efm, Qxua^Ii, Xos^Efs, Xos^Efs, Qxua, Qxua, Qxua, Qxua, Qxua, Qxua
Qxua, Qxua, Qxua, Qxua, Qxua, Qxua, Xos^Efs, Xos^Efs, Qxua^Ii, Qxua^Ii, Qxua^Ii, Qxua^Ii, Cw, Rrc, Cw, Qxua^Ii, Qxua^Ii, Qxua^Ii, Qxua^Ii, Xos^Efs, Xos^Efs, Qxua, Qxua, Qxua, Qxua, Qxua, Qxua
Qxua, Qxua, Qxua, Qxua, Qxua, Qxua, Xos^Efs, Xos^Efs, Xos^Efs, Qxua^Ii, Xos^Efs, Xos^Efs, Xos^Efs, Rrc, Xos^Efs, Xos^Efs, Xos^Efs, Qxua^Ii, Xos^Efs, Xos^Efs, Xos^Efs, Qxua, Qxua, Qxua, Qxua, Qxua, Qxua
Qxua, Qxua, Qxua, Qxua, Qxua, Qxua, Xos^Efs, Xos^Efs, Xos^Efs, Xos^Efs, Xos^Efs, Xos^Efs, Xos^Efs, Rrc, Xos^Efs, Xos^Efs, Xos^Efs, Xos^Efs, Xos^Efs, Xos^Efs, Xos^Efs, Qxua, Qxua, Qxua, Qxua, Qxua, Qxua
Qxua, Qxua, Qxua, Qxua, Qxua, Qxua, Xos^Efs, Xos^Efs, Xos^Efs, Xos^Efs, Xos^Efs, Xos^Efs, Xos^Efs, Rrc, Xos^Efs, Xos^Efs, Xos^Efs, Xos^Efs, Xos^Efs, Xos^Efs, Xos^Efs, Qxua, Qxua, Qxua, Qxua, Qxua, Qxua
Qxua, Qxua, Qxua, Qxua, Qxua, Qxua, Xos^Efs, Xos^Efs, Xos^Efs, Xos^Efs, Xos^Efs, Xos^Efs, Xos^Efs, Rrc, Xos^Efs, Xos^Efs, Xos^Efs, Xos^Efs, Xos^Efs, Xos^Efs, Xos^Efs, Qxua, Qxua, Qxua, Qxua, Qxua, Qxua
Qxua, Qxua, Qxua, Qxua, Qxua, Qxua, Qxua, Xos^Efs, Xos^Efs, Xos^Efs, Xos^Efs, Xos^Efs, Xos^Efs, Rrc, Xos^Efs, Xos^Efs, Xos^Efs, Xos^Efs, Xos^Efs, Xos^Efs, Qxua, Qxua, Qxua, Qxua, Qxua, Qxua, Qxua
